66 58 59 60 61 62 63 64 64 65 66 67 68 69 69 71 71 71 72 72 72 75 77 75 74 75 75 76 75 76 76 133
55 19 21 20 20 21 22 21 21 21 22 22 22 23 22 22 22 23 23 23 21 24 25 22 23 23 23 23 22 22 22 103
57 20 22 22 21 22 23 22 22 22 22 22 22 23 23 23 22 22 22 23 21 21 21 21 23 23 23 24 22 22 22 103
57 20 22 22 21 22 23 22 22 22 22 22 23 24 23 23 23 22 23 24 23 23 22 22 22 22 22 23 22 22 21 103
58 21 23 22 21 22 22 21 21 21 22 22 22 23 23 23 22 22 23 24 24 24 23 23 22 22 22 22 21 22 21 103
60 22 23 23 22 23 23 22 21 23 24 24 25 26 25 25 26 26 26 24 24 24 23 23 23 22 22 22 22 23 22 104
61 22 24 23 23 23 23 21 20 16 11 8 6 4 3 2 2 2 7 17 20 18 20 22 23 22 23 23 23 23 23 105
60 22 24 23 23 23 24 23 18 -21 -51 -56 -58 -60 -59 -56 -52 -50 -43 -15 -5 -6 10 23 24 23 23 23 23 23 23 105
57 14 20 24 24 24 24 26 38 -10 -32 -26 -26 -26 -27 -25 -19 -19 -25 -8 -7 -11 6 14 14 20 23 23 23 23 23 106
50 4 21 24 24 23 23 26 52 3 -4 5 5 5 4 4 8 4 -2 13 1 -26 -22 -25 -23 2 19 23 24 24 23 106
6 -26 6 18 24 24 24 29 56 7 0 7 2 1 4 6 11 8 -3 13 7 -29 -30 -27 -33 -18 8 16 16 15 16 94
-19 -53 -49 -8 20 25 24 26 56 13 7 14 5 4 7 7 13 15 6 23 20 -6 0 5 -9 -20 5 -10 -13 -16 -9 63
-7 -26 -64 -16 21 26 19 -15 20 -1 1 13 4 8 9 6 9 7 2 21 21 0 24 22 -6 -28 2 -44 -42 -44 -27 34
25 21 -27 -20 -20 -27 -4 -53 -6 -14 2 12 0 4 5 2 8 0 -7 12 22 6 42 39 1 -17 12 -26 -10 -7 16 61
45 40 16 0 -24 -39 -8 -23 16 -6 2 7 0 3 4 0 5 5 -2 20 36 18 32 35 9 13 44 42 66 56 57 86
51 41 43 40 35 31 36 33 47 7 0 0 1 4 5 1 0 1 -3 21 33 15 20 19 -5 13 23 49 57 37 21 62
43 22 22 20 20 21 21 26 36 2 0 3 5 7 9 7 1 2 -12 9 13 10 17 -3 -24 -15 -20 21 17 8 -2 53
38 11 10 13 13 12 9 13 24 -3 0 3 12 19 14 8 3 5 -11 12 13 19 4 -15 -19 -28 -19 21 14 2 0 54
39 10 6 4 2 2 2 10 23 -3 2 1 10 23 13 3 1 4 -4 -2 -2 -5 -5 8 1 -12 8 30 13 -3 6 51
31 3 6 10 12 16 19 24 34 0 4 0 0 12 3 -1 2 4 -6 -13 -12 -27 -4 14 -1 4 36 36 6 -8 9 50
44 20 21 22 19 15 11 11 29 -1 1 -3 -9 0 -4 -3 5 7 -6 -5 2 -16 16 20 10 30 43 27 2 5 17 51
40 13 9 7 3 1 2 4 22 -2 0 0 -9 -6 -7 -9 -3 5 0 4 1 -15 22 31 41 47 35 14 -5 9 16 52
30 -2 -3 0 2 4 7 5 10 -11 -3 6 -2 7 7 1 2 2 0 14 -4 -15 9 30 43 34 23 7 0 13 13 50
34 3 3 5 9 9 9 6 10 2 6 1 -14 4 3 -3 3 3 -5 4 -14 1 30 42 27 17 12 -4 4 14 17 50
34 8 12 11 12 11 14 14 11 0 -1 -5 -20 -12 -16 -21 -17 -15 -19 -9 -13 20 45 33 15 16 5 -4 12 12 17 49
33 8 12 10 7 -1 -12 -21 -20 -19 -9 -1 -2 1 -3 -5 -6 -3 -2 13 25 47 36 16 14 16 -9 -16 -2 8 14 46
32 8 8 0 -12 -24 -29 -24 -12 -7 0 4 6 13 9 6 4 8 14 33 44 41 18 12 15 9 -6 1 -1 10 9 43
30 1 -9 -20 -25 -21 -14 -6 0 2 3 2 1 9 8 7 9 13 26 45 37 21 12 13 15 -4 -5 20 23 23 10 42
15 -18 -23 -19 -12 -5 0 2 4 5 4 3 0 4 2 5 22 36 45 43 22 15 14 15 14 -6 0 15 17 11 3 37
4 -19 -13 -3 0 0 2 3 4 5 5 7 6 5 4 16 41 54 45 27 14 14 12 12 1 0 10 14 15 7 3 38
10 -5 0 4 4 2 3 5 6 5 5 7 9 15 31 42 45 37 24 15 14 14 11 10 -6 11 11 -4 -3 -1 4 43
-12 -29 -27 -27 -26 -27 -27 -27 -28 -28 -28 -28 -30 -40 -55 -71 -87 -103 -110 -112 -110 -110 -99 -87 -91 -76 -75 -79 -73 -76 -75 -28
