200 94 96 96 99 100 99 100 101 102 102 103 104 105 106 107 107 107 109 108 108 108 110 110 111 112 111 113 113 112 113 117
64 5 6 6 6 6 6 6 6 6 6 6 6 6 6 7 7 7 6 6 4 10 9 4 6 6 6 6 6 6 6 66
64 6 7 6 6 7 7 6 6 7 7 7 7 7 6 7 7 8 8 7 6 8 9 7 7 7 7 8 7 7 8 67
66 6 7 7 6 7 7 7 7 6 7 6 6 7 7 7 6 6 8 7 4 4 5 8 8 7 8 8 6 7 7 68
66 7 7 7 7 7 7 7 7 7 7 7 6 7 8 8 7 8 8 7 6 7 7 7 7 7 8 8 8 7 7 68
67 6 7 6 6 7 6 6 6 7 5 4 4 5 5 6 5 4 5 6 6 6 8 7 7 6 7 7 8 7 7 67
67 6 7 7 7 7 7 6 8 11 13 14 15 18 17 17 19 18 13 8 8 10 8 8 7 7 7 7 7 7 7 68
68 7 6 7 7 6 6 4 16 20 26 30 28 26 28 26 24 20 18 30 20 9 13 10 6 7 7 7 7 8 7 69
68 9 9 7 6 6 7 7 13 -47 -41 -23 -29 -27 -25 -20 -19 -25 -17 19 6 -3 22 21 10 8 7 7 7 7 7 68
67 0 14 8 7 7 7 9 21 -28 -12 1 2 0 -1 0 6 1 -3 0 7 17 27 25 18 18 10 7 7 7 7 70
63 16 23 9 7 6 6 8 26 -10 0 13 14 12 11 8 10 7 0 26 13 -18 1 -4 0 28 22 11 10 11 13 72
-5 40 28 30 10 8 7 10 29 -11 -6 9 3 5 8 8 11 4 -3 16 9 -24 -19 4 -5 -12 38 20 18 18 24 63
-11 -11 -29 40 28 4 18 19 43 3 5 14 5 10 10 9 15 18 13 19 16 -6 13 13 -1 -10 41 -5 19 6 17 48
3 -18 -39 29 59 33 32 -43 44 8 7 15 9 14 10 9 14 8 11 21 11 -7 32 -1 -23 0 8 -32 -15 -17 -11 28
38 5 -9 -26 -5 5 6 -31 2 15 20 12 5 8 11 9 14 6 -4 11 14 10 23 25 -14 -19 -1 -25 -14 -11 13 49
54 11 8 -29 -39 -28 -10 19 2 -2 16 12 10 7 8 9 10 19 0 17 40 3 3 33 1 22 17 53 37 29 22 56
59 27 25 30 29 27 27 29 30 -10 0 12 11 8 8 8 5 9 6 37 15 3 26 -1 19 28 12 60 21 7 -14 52
49 12 9 8 6 9 11 16 22 -1 7 11 10 6 9 12 6 8 0 9 -4 38 3 1 6 -14 10 20 11 -4 4 52
42 8 12 16 15 12 10 11 18 1 6 5 20 24 5 7 12 11 0 9 51 14 -5 3 -6 -12 7 24 14 0 13 45
49 12 5 1 0 0 0 6 21 -3 10 9 18 28 9 4 12 7 8 10 11 -5 27 36 -5 -5 19 15 2 2 16 44
26 0 5 9 11 17 19 20 26 -7 13 11 7 20 12 6 12 9 -1 0 -3 -5 34 3 -13 16 29 8 -7 2 12 45
54 21 18 20 17 9 6 8 25 8 2 10 4 10 15 15 17 12 -7 13 25 6 24 -6 14 23 7 7 3 21 9 44
49 11 10 6 2 3 6 13 30 7 7 11 -2 2 6 2 6 12 13 19 2 11 9 37 39 6 6 1 2 14 13 46
30 0 5 8 9 8 14 15 2 -2 16 17 6 27 14 11 13 5 15 32 0 -11 0 40 12 11 12 2 13 8 12 42
39 8 9 7 11 11 11 3 13 29 10 1 5 26 17 11 24 23 10 11 -9 12 47 7 2 15 3 -3 18 9 17 40
37 11 13 9 14 21 26 34 30 4 5 8 -1 -9 2 1 -4 5 -6 -14 -3 41 13 0 12 16 0 22 17 12 12 45
37 11 13 18 20 14 5 -5 -6 3 14 14 10 9 6 9 5 5 0 9 43 14 -6 12 18 10 -8 -6 1 27 10 44
39 16 21 14 2 -4 -5 6 16 14 10 13 14 21 11 8 13 0 3 41 15 -2 10 10 17 0 9 10 -7 10 12 38
46 17 2 -1 -1 8 13 12 10 11 10 9 9 15 15 9 0 -7 28 23 -3 8 10 12 10 -8 10 28 32 6 9 42
26 -1 -1 9 13 12 12 9 11 12 11 8 6 8 8 -2 7 37 16 1 10 10 11 17 4 3 10 14 10 6 5 38
2 7 13 12 10 7 10 12 10 11 11 12 10 0 -9 5 41 26 5 5 9 10 11 10 -9 26 16 14 23 10 5 41
30 25 26 25 24 22 24 27 27 25 26 29 27 39 76 88 62 59 71 67 69 65 62 43 49 68 48 21 40 49 53 66
