23 45 45 45 45 45 45 44 44 44 44 43 42 42 42 41 42 42 41 41 41 41 40 39 40 40 39 38 38 38 38 57
-67 -23 -24 -25 -27 -27 -28 -29 -31 -32 -32 -34 -36 -37 -38 -39 -39 -39 -40 -40 -42 -43 -43 -44 -44 -44 -45 -46 -46 -47 -46 43
-68 -24 -25 -26 -28 -29 -29 -31 -32 -33 -33 -35 -37 -38 -39 -40 -41 -41 -40 -41 -44 -47 -45 -44 -44 -44 -45 -46 -46 -47 -46 43
-69 -26 -27 -28 -30 -31 -31 -32 -34 -34 -35 -36 -38 -39 -39 -41 -42 -42 -41 -42 -44 -46 -46 -45 -45 -46 -47 -47 -47 -47 -47 43
-71 -27 -29 -30 -32 -33 -34 -35 -36 -37 -37 -38 -39 -40 -40 -41 -42 -42 -43 -43 -44 -45 -46 -46 -46 -47 -48 -47 -47 -47 -47 43
-73 -30 -30 -31 -34 -35 -35 -36 -38 -38 -38 -39 -40 -41 -41 -42 -42 -43 -44 -45 -45 -46 -46 -46 -46 -47 -48 -47 -47 -47 -47 43
-75 -32 -32 -33 -35 -36 -36 -37 -41 -45 -48 -50 -53 -54 -54 -56 -56 -57 -54 -50 -51 -51 -49 -47 -48 -48 -48 -48 -48 -47 -47 42
-78 -35 -36 -36 -38 -38 -37 -38 -50 -71 -79 -82 -84 -85 -84 -83 -82 -82 -77 -68 -65 -61 -52 -48 -49 -49 -49 -49 -49 -48 -48 42
-83 -42 -39 -39 -39 -39 -38 -38 -37 -45 -54 -57 -56 -57 -59 -59 -56 -57 -71 -75 -64 -61 -61 -56 -52 -50 -50 -50 -49 -49 -49 42
-87 -45 -43 -42 -41 -42 -42 -41 -12 1 -13 -20 -19 -19 -22 -26 -26 -31 -52 -59 -58 -73 -81 -76 -66 -55 -51 -51 -51 -50 -50 41
-101 -57 -54 -45 -44 -44 -45 -41 -3 13 -9 -19 -19 -17 -18 -23 -24 -28 -46 -52 -51 -69 -76 -67 -72 -71 -58 -56 -55 -54 -55 37
-97 -84 -81 -56 -47 -46 -47 -44 -3 15 -6 -17 -17 -16 -19 -24 -24 -22 -40 -47 -29 -31 -40 -41 -58 -76 -73 -70 -68 -68 -66 29
-59 -70 -84 -73 -53 -48 -59 -66 -16 10 -7 -13 -11 -13 -18 -26 -28 -28 -41 -41 -17 -10 -21 -34 -44 -74 -85 -78 -76 -74 -66 24
-14 -15 -57 -100 -89 -76 -64 -69 -35 0 -10 -13 -12 -15 -17 -26 -31 -36 -47 -40 -11 -13 -25 -18 -29 -67 -62 -45 -46 -42 -32 32
0 8 -28 -86 -93 -82 -38 -28 -30 -9 -15 -13 -12 -15 -16 -25 -29 -29 -40 -31 -7 -27 -37 -9 -12 -39 -18 8 0 -9 -13 35
-11 2 -7 -24 -32 -30 -7 -3 -10 -14 -20 -12 -10 -14 -15 -23 -29 -27 -32 -34 -27 -34 -44 -23 -13 -33 -22 -4 -13 -30 -39 26
-34 -19 -19 -18 -20 -21 -21 -21 -7 -7 -14 -10 -9 -12 -13 -18 -26 -28 -40 -55 -41 -32 -45 -31 -35 -52 -58 -56 -47 -45 -43 21
-50 -31 -31 -32 -33 -35 -37 -35 -10 0 -9 -10 -5 -6 -13 -15 -18 -23 -47 -53 -36 -42 -38 -25 -36 -49 -69 -68 -45 -32 -31 18
-51 -30 -32 -35 -36 -38 -39 -33 -8 1 -6 -10 -9 -7 -11 -14 -16 -20 -38 -54 -58 -47 -16 -7 -13 -28 -58 -61 -38 -26 -29 18
-54 -31 -30 -30 -29 -28 -28 -24 -4 1 -4 -14 -23 -15 -9 -12 -15 -19 -35 -63 -63 -32 -11 -5 1 -18 -52 -54 -32 -27 -29 20
-44 -22 -21 -21 -24 -29 -32 -29 -4 3 -8 -16 -28 -20 -6 -9 -13 -17 -30 -41 -30 -21 -20 0 11 -26 -56 -41 -19 -22 -29 20
-43 -26 -30 -32 -34 -37 -38 -33 -6 4 -4 -9 -19 -16 -6 -11 -15 -9 -12 -21 -16 -24 -19 14 2 -42 -54 -30 -18 -25 -27 20
-55 -36 -36 -35 -31 -30 -31 -32 -14 3 1 0 -3 -1 0 -6 -10 -5 -5 -13 -15 -26 -20 -8 -28 -46 -41 -22 -21 -30 -27 20
-48 -27 -28 -26 -23 -24 -28 -29 -4 10 0 0 -1 -1 0 -3 -3 -4 -14 -12 -5 -8 -22 -42 -47 -43 -33 -20 -22 -29 -27 19
-39 -19 -20 -22 -23 -23 -23 -12 1 2 -1 3 -8 -15 -6 -10 -12 -10 -20 -8 8 -6 -41 -52 -45 -40 -25 -18 -25 -29 -27 21
-38 -19 -19 -21 -27 -31 -30 -23 -13 -3 7 12 3 -2 3 0 -5 -3 1 18 11 -36 -56 -45 -41 -34 -23 -30 -33 -30 -28 21
-37 -21 -23 -27 -34 -34 -28 -16 0 9 11 15 16 15 13 12 9 9 20 18 -22 -51 -47 -42 -41 -26 -14 -25 -35 -33 -28 19
-38 -25 -30 -30 -23 -12 -2 5 11 12 11 12 11 12 14 13 12 16 12 -17 -45 -44 -40 -43 -37 -19 -8 -9 -23 -33 -26 19
-46 -28 -21 -9 1 7 8 7 9 11 11 10 6 7 12 12 21 19 -15 -40 -39 -39 -40 -40 -25 -10 -15 -20 -26 -30 -25 18
-41 -9 2 8 9 7 8 8 9 11 13 12 8 7 12 20 19 -5 -36 -39 -34 -38 -40 -37 -15 -3 -21 -33 -29 -23 -21 19
-15 8 11 10 9 8 8 9 9 10 12 12 11 16 26 13 -17 -36 -37 -34 -34 -37 -39 -27 -9 -9 -28 -39 -30 -18 -15 20
-16 -6 -7 -6 -4 -4 -7 -8 -7 -6 -6 -7 -8 -16 -37 -68 -90 -92 -87 -86 -87 -86 -75 -50 -49 -61 -56 -58 -56 -49 -51 1
