-115 -241 -242 -244 -246 -249 -251 -252 -254 -256 -257 -258 -261 -264 -266 -268 -270 -270 -270 -271 -274 -276 -277 -279 -278 -279 -279 -279 -280 -281 -282 -233
-202 -358 -359 -362 -366 -370 -373 -375 -377 -380 -382 -384 -388 -393 -395 -398 -401 -402 -402 -404 -407 -410 -414 -415 -414 -415 -415 -416 -417 -417 -417 -326
-204 -361 -363 -366 -369 -374 -377 -379 -380 -383 -385 -387 -392 -396 -399 -400 -403 -404 -404 -405 -408 -412 -417 -417 -417 -418 -418 -418 -418 -418 -418 -326
-206 -365 -368 -371 -374 -378 -381 -383 -384 -386 -388 -391 -396 -400 -403 -404 -407 -407 -407 -409 -412 -414 -417 -419 -419 -420 -421 -421 -421 -419 -418 -327
-209 -370 -372 -375 -378 -381 -384 -385 -387 -389 -392 -396 -401 -405 -406 -408 -410 -410 -411 -413 -415 -416 -418 -420 -420 -421 -422 -423 -422 -419 -418 -326
-211 -375 -377 -379 -381 -385 -388 -388 -389 -392 -396 -400 -406 -410 -411 -413 -414 -415 -416 -418 -419 -420 -420 -421 -421 -422 -422 -423 -422 -420 -419 -327
-213 -379 -382 -384 -387 -389 -391 -391 -389 -390 -391 -393 -397 -399 -400 -401 -402 -404 -409 -413 -417 -419 -419 -421 -422 -422 -422 -423 -423 -422 -421 -328
-215 -383 -386 -390 -392 -395 -396 -396 -382 -367 -343 -333 -335 -335 -335 -338 -341 -346 -358 -373 -394 -402 -406 -418 -424 -423 -424 -425 -424 -424 -423 -330
-213 -382 -387 -395 -398 -399 -401 -402 -379 -340 -275 -253 -253 -251 -251 -255 -263 -272 -289 -319 -354 -367 -382 -408 -420 -422 -425 -426 -426 -426 -426 -331
-208 -373 -382 -399 -401 -403 -406 -407 -370 -300 -208 -182 -184 -183 -185 -192 -202 -214 -241 -276 -305 -320 -339 -371 -389 -402 -420 -427 -428 -428 -428 -333
-185 -331 -366 -394 -404 -406 -410 -411 -367 -287 -190 -162 -165 -165 -169 -179 -191 -203 -225 -251 -277 -280 -283 -308 -329 -362 -399 -423 -425 -425 -422 -330
-143 -251 -314 -358 -397 -411 -414 -412 -368 -289 -192 -161 -161 -158 -163 -175 -189 -202 -223 -247 -260 -246 -232 -249 -276 -317 -357 -401 -397 -398 -392 -308
-97 -176 -236 -296 -380 -417 -405 -399 -342 -279 -192 -162 -158 -153 -159 -171 -184 -199 -222 -245 -249 -231 -215 -235 -245 -267 -307 -347 -328 -333 -328 -259
-77 -136 -173 -237 -334 -383 -373 -350 -285 -250 -189 -166 -159 -153 -159 -168 -181 -198 -219 -242 -250 -240 -238 -253 -233 -233 -262 -282 -257 -269 -274 -217
-84 -150 -169 -219 -280 -314 -305 -276 -232 -213 -178 -167 -157 -152 -157 -163 -176 -192 -213 -238 -256 -262 -265 -260 -237 -221 -246 -257 -250 -264 -271 -218
-111 -197 -209 -231 -251 -264 -259 -246 -225 -203 -169 -158 -149 -148 -152 -158 -168 -181 -207 -237 -271 -289 -277 -264 -236 -221 -257 -279 -304 -308 -304 -231
-133 -235 -242 -246 -251 -256 -262 -263 -244 -209 -161 -147 -145 -146 -150 -155 -163 -173 -200 -238 -288 -287 -276 -253 -215 -218 -262 -314 -355 -340 -310 -220
-147 -256 -263 -268 -272 -276 -280 -279 -253 -205 -151 -141 -145 -150 -155 -154 -158 -165 -192 -237 -275 -278 -265 -221 -188 -194 -242 -313 -349 -320 -277 -200
-150 -255 -258 -259 -262 -266 -270 -269 -242 -196 -145 -139 -148 -161 -165 -155 -152 -160 -182 -213 -248 -264 -236 -192 -168 -170 -223 -299 -323 -289 -253 -191
-144 -246 -249 -252 -256 -261 -265 -264 -236 -193 -140 -138 -152 -167 -168 -152 -147 -156 -169 -191 -217 -220 -192 -180 -166 -170 -235 -304 -303 -262 -237 -184
-142 -241 -245 -249 -253 -256 -260 -260 -235 -191 -139 -135 -146 -157 -156 -143 -141 -151 -160 -164 -171 -175 -173 -192 -179 -197 -270 -310 -284 -241 -230 -180
-137 -240 -246 -251 -254 -254 -255 -254 -228 -188 -140 -126 -132 -134 -134 -129 -132 -143 -148 -140 -144 -153 -176 -205 -209 -253 -302 -301 -261 -230 -232 -180
-139 -238 -240 -244 -243 -239 -237 -233 -212 -176 -131 -119 -120 -117 -122 -123 -124 -130 -136 -138 -142 -145 -179 -221 -267 -305 -311 -284 -245 -230 -233 -180
-134 -224 -221 -222 -224 -225 -225 -222 -202 -162 -126 -112 -107 -104 -116 -115 -115 -123 -131 -133 -136 -144 -191 -262 -313 -321 -300 -264 -230 -231 -232 -180
-126 -212 -209 -212 -217 -223 -225 -217 -187 -153 -125 -102 -89 -90 -100 -97 -98 -106 -115 -116 -124 -148 -228 -302 -324 -311 -284 -243 -224 -232 -232 -180
-124 -208 -209 -212 -214 -216 -209 -192 -168 -139 -108 -85 -76 -76 -78 -77 -80 -88 -97 -104 -128 -194 -280 -317 -316 -296 -257 -216 -215 -226 -232 -178
-123 -208 -210 -209 -202 -191 -176 -158 -134 -108 -87 -76 -71 -67 -68 -66 -68 -76 -92 -114 -175 -255 -300 -310 -303 -278 -233 -198 -202 -215 -227 -173
-122 -202 -197 -187 -169 -147 -126 -109 -97 -88 -80 -75 -75 -75 -76 -71 -72 -89 -115 -167 -242 -284 -298 -301 -288 -254 -204 -189 -202 -215 -221 -166
-113 -182 -167 -145 -123 -105 -94 -91 -90 -86 -80 -76 -79 -81 -81 -81 -92 -117 -165 -231 -274 -286 -294 -293 -271 -228 -190 -193 -213 -221 -212 -157
-96 -144 -124 -105 -94 -89 -88 -88 -88 -86 -81 -79 -81 -83 -85 -98 -122 -171 -232 -269 -281 -285 -290 -279 -252 -206 -191 -209 -224 -221 -204 -149
-73 -105 -96 -92 -89 -86 -85 -88 -89 -88 -85 -83 -86 -93 -105 -130 -179 -238 -273 -283 -283 -286 -282 -263 -230 -195 -198 -207 -209 -206 -194 -144
-44 -65 -66 -67 -64 -62 -61 -64 -66 -64 -63 -64 -65 -67 -80 -117 -163 -191 -200 -201 -200 -202 -198 -179 -151 -140 -149 -148 -141 -139 -135 -111
