-115 -112 -112 -114 -116 -117 -117 -118 -119 -120 -121 -122 -123 -124 -125 -126 -126 -127 -127 -127 -129 -130 -130 -130 -131 -131 -131 -132 -132 -132 -131 -31
-124 -175 -176 -178 -180 -182 -183 -185 -186 -188 -189 -191 -192 -193 -195 -197 -198 -199 -199 -200 -202 -205 -204 -204 -205 -205 -206 -206 -206 -207 -206 -87
-125 -177 -178 -180 -182 -184 -185 -187 -188 -189 -191 -193 -194 -195 -197 -198 -200 -201 -201 -201 -203 -204 -206 -207 -206 -206 -207 -206 -207 -207 -206 -87
-127 -180 -180 -182 -185 -186 -188 -189 -190 -191 -193 -194 -196 -197 -199 -200 -201 -202 -203 -203 -203 -204 -206 -207 -207 -207 -208 -208 -207 -207 -207 -87
-129 -182 -183 -185 -187 -189 -190 -191 -192 -193 -194 -196 -198 -199 -201 -201 -202 -203 -204 -204 -205 -205 -206 -207 -207 -208 -209 -209 -208 -207 -207 -87
-131 -185 -186 -187 -189 -190 -191 -193 -194 -195 -196 -198 -200 -201 -202 -203 -204 -205 -205 -206 -206 -207 -207 -208 -208 -208 -209 -209 -209 -208 -208 -87
-133 -187 -188 -190 -191 -192 -193 -194 -193 -193 -194 -195 -196 -198 -199 -200 -200 -201 -205 -205 -205 -207 -208 -208 -208 -209 -209 -209 -209 -209 -208 -87
-134 -190 -191 -193 -194 -194 -195 -195 -178 -170 -171 -171 -171 -172 -174 -176 -176 -179 -195 -200 -197 -204 -209 -209 -209 -209 -210 -210 -210 -209 -209 -88
-132 -192 -194 -195 -196 -197 -198 -196 -159 -134 -130 -128 -127 -127 -129 -134 -135 -141 -162 -174 -181 -195 -204 -207 -210 -210 -210 -211 -210 -210 -210 -88
-128 -191 -195 -197 -197 -198 -200 -196 -148 -119 -99 -90 -90 -89 -92 -97 -102 -109 -131 -141 -152 -172 -179 -191 -206 -211 -211 -211 -211 -211 -211 -89
-116 -186 -193 -198 -200 -200 -202 -197 -146 -116 -90 -80 -81 -82 -85 -91 -94 -101 -123 -133 -128 -135 -149 -162 -181 -205 -210 -210 -210 -211 -208 -89
-82 -154 -183 -202 -201 -203 -202 -198 -148 -117 -89 -77 -78 -80 -84 -91 -96 -102 -121 -125 -116 -118 -121 -132 -144 -178 -193 -200 -198 -201 -195 -88
-55 -90 -148 -194 -204 -204 -187 -192 -149 -121 -92 -76 -77 -77 -81 -90 -95 -105 -122 -120 -110 -119 -114 -108 -121 -155 -154 -168 -171 -173 -167 -82
-46 -61 -107 -151 -186 -194 -163 -161 -140 -122 -94 -77 -78 -77 -80 -89 -94 -102 -120 -123 -116 -129 -122 -103 -108 -134 -120 -137 -133 -144 -138 -66
-57 -69 -88 -104 -141 -163 -143 -142 -106 -111 -91 -76 -76 -75 -79 -86 -92 -97 -114 -127 -126 -134 -128 -114 -110 -115 -119 -132 -123 -131 -130 -56
-75 -95 -100 -101 -115 -128 -127 -131 -89 -89 -83 -76 -74 -72 -75 -80 -87 -94 -116 -130 -133 -137 -129 -121 -121 -121 -140 -156 -143 -139 -136 -62
-87 -118 -118 -122 -123 -125 -129 -126 -97 -83 -74 -74 -72 -71 -73 -75 -81 -88 -117 -129 -138 -141 -125 -110 -118 -122 -157 -170 -163 -151 -144 -70
-90 -125 -129 -131 -133 -136 -139 -134 -104 -89 -72 -72 -74 -72 -72 -74 -78 -82 -107 -123 -139 -136 -109 -102 -94 -110 -155 -161 -161 -147 -139 -61
-88 -123 -126 -128 -129 -131 -133 -128 -100 -86 -69 -72 -81 -77 -71 -73 -76 -79 -96 -114 -130 -115 -109 -89 -77 -105 -137 -147 -146 -139 -127 -56
-84 -119 -121 -122 -126 -128 -130 -126 -95 -82 -67 -71 -81 -79 -74 -72 -73 -74 -86 -98 -98 -111 -108 -81 -79 -109 -131 -133 -134 -133 -120 -55
-82 -118 -122 -123 -123 -125 -127 -124 -94 -79 -66 -66 -73 -75 -74 -72 -70 -67 -74 -82 -79 -100 -94 -82 -100 -122 -131 -129 -130 -124 -114 -53
-86 -118 -120 -121 -122 -122 -123 -123 -97 -82 -62 -59 -63 -64 -67 -67 -66 -64 -69 -70 -72 -88 -90 -104 -120 -128 -130 -130 -129 -120 -111 -52
-82 -116 -118 -118 -117 -118 -118 -113 -90 -78 -62 -52 -56 -56 -57 -59 -60 -62 -72 -62 -63 -85 -104 -132 -137 -136 -134 -127 -124 -116 -114 -52
-74 -109 -110 -111 -111 -111 -109 -102 -84 -75 -58 -47 -55 -54 -51 -55 -56 -57 -66 -57 -65 -89 -117 -140 -147 -148 -132 -126 -120 -114 -113 -52
-72 -103 -103 -105 -108 -110 -107 -97 -83 -70 -49 -40 -47 -45 -47 -49 -51 -52 -53 -50 -78 -105 -127 -137 -153 -142 -126 -122 -116 -116 -112 -51
-72 -103 -103 -104 -104 -104 -98 -90 -74 -58 -48 -38 -35 -30 -37 -37 -38 -42 -45 -58 -92 -114 -128 -150 -152 -128 -116 -115 -112 -115 -111 -53
-71 -102 -100 -99 -93 -86 -80 -71 -61 -53 -43 -35 -33 -28 -27 -29 -30 -34 -53 -77 -104 -115 -138 -153 -140 -118 -108 -98 -108 -114 -109 -52
-70 -95 -90 -83 -74 -67 -60 -54 -47 -40 -34 -34 -37 -34 -32 -31 -34 -47 -76 -99 -112 -131 -147 -144 -125 -110 -107 -99 -100 -103 -107 -49
-60 -80 -73 -65 -58 -52 -46 -42 -40 -38 -35 -34 -36 -36 -37 -40 -50 -70 -97 -109 -126 -141 -144 -135 -113 -105 -105 -105 -106 -99 -101 -48
-43 -64 -58 -51 -45 -41 -40 -40 -40 -38 -36 -35 -35 -35 -41 -57 -77 -97 -106 -121 -138 -139 -138 -123 -109 -104 -100 -105 -105 -103 -98 -46
-30 -51 -46 -41 -38 -38 -39 -40 -39 -39 -39 -38 -38 -44 -57 -78 -100 -113 -124 -134 -138 -138 -130 -112 -109 -105 -94 -100 -102 -99 -95 -43
-21 -33 -32 -32 -31 -30 -30 -32 -32 -31 -32 -32 -33 -41 -57 -72 -82 -100 -111 -111 -110 -109 -103 -89 -90 -80 -76 -76 -78 -80 -78 -45
