-106 -121 -122 -124 -126 -127 -128 -129 -131 -132 -133 -134 -135 -137 -138 -139 -140 -141 -142 -141 -142 -145 -147 -146 -146 -147 -147 -148 -148 -148 -147 -91
-23 -10 -11 -11 -11 -11 -11 -11 -11 -11 -11 -11 -12 -11 -11 -11 -11 -11 -12 -11 -11 -13 -12 -11 -11 -11 -11 -11 -10 -10 -9 15
-24 -11 -12 -12 -12 -12 -12 -12 -12 -12 -12 -12 -12 -12 -11 -11 -11 -11 -12 -12 -12 -10 -8 -10 -11 -11 -11 -11 -11 -10 -10 15
-25 -12 -12 -12 -12 -12 -12 -12 -12 -12 -12 -12 -12 -12 -12 -12 -11 -11 -12 -12 -11 -9 -9 -10 -10 -10 -10 -10 -10 -10 -9 15
-25 -12 -12 -12 -12 -12 -11 -11 -11 -11 -12 -12 -12 -12 -12 -12 -11 -12 -12 -12 -12 -11 -11 -10 -9 -10 -9 -9 -10 -10 -9 15
-25 -12 -13 -12 -13 -12 -12 -11 -11 -12 -12 -12 -12 -12 -12 -12 -12 -12 -12 -11 -11 -11 -11 -10 -10 -10 -9 -9 -9 -10 -10 15
-25 -12 -13 -13 -13 -13 -12 -11 -11 -7 -3 -1 0 2 3 3 3 3 2 -4 -7 -6 -8 -9 -10 -10 -10 -10 -10 -10 -11 14
-24 -11 -12 -12 -12 -12 -12 -12 -4 26 49 55 59 61 61 58 56 54 43 22 14 12 0 -9 -10 -10 -10 -10 -10 -10 -10 14
-21 -6 -10 -12 -12 -12 -12 -13 7 46 63 65 65 64 62 59 55 50 38 32 29 16 1 -2 -4 -8 -10 -10 -10 -10 -10 14
-11 0 -8 -11 -11 -11 -11 -10 6 18 15 11 10 9 8 7 6 4 4 8 12 18 24 29 23 5 -7 -9 -10 -10 -10 15
19 19 3 -6 -10 -11 -11 -9 2 6 1 0 2 3 0 -1 -2 -1 -2 -1 12 32 47 45 34 23 4 -4 -4 -5 -5 23
34 48 43 15 -7 -12 -11 -8 1 2 -3 -2 2 2 0 -1 -3 -6 -10 -4 10 17 13 11 17 20 12 18 20 20 21 44
19 50 54 24 -4 -11 -4 21 24 10 -2 -4 -3 -5 -4 -3 -5 -6 -10 -6 2 -5 -22 -10 11 11 28 50 55 52 50 57
-8 5 4 15 27 26 43 55 51 25 1 -1 -1 -2 -2 -2 -1 0 1 2 0 -20 -27 -11 3 12 34 43 38 30 21 23
-31 -32 -28 9 50 63 63 34 25 17 3 2 1 0 0 0 1 1 0 -3 -18 -28 -17 -9 -7 -8 -2 -26 -42 -44 -37 -10
-34 -40 -37 -20 -2 5 -2 -21 -18 0 8 7 2 0 1 2 3 2 -5 -20 -21 -14 -7 7 -4 -19 -30 -61 -65 -45 -16 12
-26 -25 -25 -26 -27 -27 -27 -25 -12 2 7 4 0 -1 -1 0 3 4 -4 -6 4 -6 6 20 10 10 -6 -16 -7 11 19 28
-14 -4 -3 -3 -2 -1 -1 1 10 9 3 1 -6 -11 -7 -1 0 0 0 9 -2 0 21 25 25 22 6 5 16 21 11 20
-10 0 0 2 3 5 5 8 11 8 2 -2 -11 -14 -6 1 0 0 2 1 7 28 25 9 9 0 -15 -4 15 14 4 17
-4 6 5 4 2 0 -3 -3 2 5 0 -3 -3 0 3 4 2 3 6 16 39 41 10 0 -3 -27 -34 -5 18 12 3 15
-8 -3 -7 -11 -12 -10 -6 -2 4 2 1 2 8 15 12 4 0 3 13 20 25 12 0 2 -22 -48 -29 4 14 0 -3 12
-18 -11 -8 -4 1 6 10 10 9 5 3 5 12 17 13 7 5 8 6 2 6 -4 -2 -22 -57 -49 -11 14 7 -4 -6 10
-3 9 11 13 13 10 6 5 15 14 4 3 7 4 4 4 5 6 -1 -1 6 3 -7 -42 -49 -25 2 14 3 -2 -3 11
0 9 8 6 3 0 -1 8 17 4 -1 7 5 -1 0 2 1 0 0 9 12 -6 -38 -37 -16 -1 12 13 -1 -4 -3 11
-6 -1 -3 -3 -3 -5 -1 2 0 0 8 15 12 17 21 17 16 14 19 27 5 -43 -49 -19 -1 7 19 7 -4 -6 -3 10
-7 -2 -5 -5 -3 3 13 19 26 26 19 10 8 13 17 15 16 18 17 1 -44 -55 -21 -1 1 13 19 11 6 -1 0 12
-8 -2 -2 3 15 31 42 43 35 20 8 1 -4 -6 -4 -2 -2 0 -12 -50 -63 -31 -4 0 5 21 18 9 5 2 2 15
-7 2 14 29 39 39 30 18 8 1 0 0 -4 -6 -6 -6 -6 -11 -42 -57 -32 -7 -1 0 14 24 8 -10 -18 -6 3 14
5 26 37 37 27 15 5 2 1 0 0 0 0 0 -1 -4 -15 -45 -58 -34 -11 -4 -2 3 19 17 -2 -17 -16 -3 5 15
23 36 26 14 6 3 2 0 0 0 -1 -2 -2 0 0 -15 -49 -65 -43 -15 -6 -5 0 11 22 2 -12 -8 0 5 6 13
14 15 5 1 1 1 0 0 -1 -1 -2 -4 -4 -6 -25 -53 -57 -35 -14 -6 -4 -2 4 20 13 -8 -10 5 13 10 1 7
17 24 24 25 24 22 21 23 23 23 22 22 21 14 10 23 52 74 81 80 81 82 86 79 57 53 61 63 64 59 52 56
