26 26 26 27 27 27 28 28 27 28 28 29 29 30 30 30 30 30 30 30 31 32 32 31 31 32 32 31 31 32 32 -11
-5 1 2 3 2 2 3 3 2 2 3 3 4 5 5 4 4 4 3 3 6 7 5 5 6 6 6 5 5 6 6 -86
-5 3 3 3 3 3 4 3 3 3 3 4 4 5 6 5 5 4 3 4 8 7 3 6 6 7 7 6 6 6 5 -86
-4 3 4 4 4 4 4 3 3 3 4 4 5 6 6 6 6 5 4 5 6 6 6 8 7 8 8 6 7 6 6 -86
-3 3 4 3 3 4 3 3 2 2 4 4 6 6 7 6 6 6 5 5 7 7 7 7 7 8 8 6 7 7 6 -87
-2 3 4 3 4 4 3 3 2 2 4 5 7 7 7 6 6 7 7 6 7 7 7 7 7 8 7 6 6 6 6 -87
-2 4 4 4 4 4 4 3 5 3 1 1 1 0 0 0 0 0 -3 0 5 5 4 6 6 7 7 7 6 6 7 -87
-1 4 4 5 4 4 4 6 11 0 -18 -22 -22 -22 -23 -22 -20 -18 -16 -10 -5 -5 -1 5 7 7 7 7 7 7 7 -87
1 1 2 5 5 5 5 9 -3 -13 -14 -14 -11 -8 -8 -8 -8 -1 13 1 -8 2 7 4 3 5 7 8 8 7 8 -87
-3 0 4 6 6 6 6 8 -24 -10 3 0 3 4 7 7 5 14 23 6 8 13 -1 -10 -10 -3 5 8 8 8 8 -88
-14 -7 -4 0 5 7 8 6 -27 -1 8 4 3 4 7 10 9 15 23 10 2 5 -10 -13 4 -1 -1 6 7 6 7 -93
-1 3 -18 -15 1 8 10 5 -28 -1 11 7 4 8 11 12 10 13 29 10 -8 3 3 8 16 8 5 0 -2 -2 -5 -104
15 1 3 -4 0 8 18 -3 -45 -10 8 3 6 12 14 14 12 12 23 5 -10 5 19 14 5 21 -6 -13 -16 -13 -20 -99
14 5 48 27 -7 -9 -23 -13 -42 -16 6 3 8 10 12 14 10 12 17 0 -10 25 19 2 12 25 -25 -10 -9 0 -6 -57
15 13 51 33 -4 -12 -49 6 -11 1 6 0 7 10 12 15 6 10 18 3 6 44 9 -8 11 20 -17 14 26 35 22 -40
14 19 27 23 16 13 1 29 11 16 3 -2 6 10 12 14 9 7 17 19 16 22 13 -12 6 21 2 28 29 29 5 -70
15 17 13 15 16 14 15 13 -4 4 3 3 7 11 12 13 13 9 27 23 -4 15 12 -14 15 5 17 13 4 -2 -4 -70
15 11 11 11 12 12 13 6 -17 0 7 5 6 15 17 11 13 13 33 5 12 23 -12 -5 7 5 30 3 -2 -7 9 -60
12 12 13 10 8 7 8 1 -15 2 7 10 12 13 13 9 12 13 28 17 19 -16 -21 3 8 26 39 13 -6 -1 9 -57
9 6 7 8 9 12 15 10 -6 5 7 17 15 1 3 7 10 16 26 21 -10 -21 0 2 4 38 46 11 -8 3 6 -53
8 13 15 16 17 17 14 6 -17 6 10 13 13 -3 -1 9 10 17 22 9 -9 11 12 -9 21 59 35 -3 -6 12 9 -49
14 14 13 11 9 6 6 2 -16 5 7 11 11 0 3 10 7 7 20 20 3 23 -2 0 52 54 13 -9 3 13 7 -49
10 5 5 3 5 7 9 9 -14 -7 4 5 6 6 10 12 10 7 20 17 8 21 1 29 42 21 0 -8 12 11 8 -49
6 7 8 6 9 12 12 3 -20 2 13 0 5 5 5 8 6 10 21 1 2 15 42 43 16 7 -5 -4 12 11 9 -48
7 9 10 10 10 13 7 0 0 8 -2 -6 13 0 -5 3 0 2 7 -14 3 46 55 17 8 3 -11 5 14 13 7 -48
8 11 10 11 11 9 0 -6 -13 -16 -10 -2 10 1 1 7 6 2 2 -1 49 69 23 7 11 -3 -5 10 2 9 5 -48
10 12 11 11 4 -7 -15 -17 -15 -1 3 2 6 7 8 7 10 6 8 37 68 30 9 13 8 -14 -2 11 15 10 4 -49
11 12 5 -4 -12 -14 -9 -2 1 5 4 5 8 5 5 6 8 8 34 57 33 9 14 14 0 -13 1 11 28 16 6 -47
7 -1 -12 -14 -7 0 4 5 3 4 4 5 10 3 3 6 4 33 62 33 13 15 15 11 -10 -3 15 18 20 6 3 -46
-6 -14 -6 0 4 4 4 4 5 4 4 5 9 6 3 9 32 57 39 13 15 15 13 4 -16 7 26 18 6 5 5 -41
-8 -1 6 6 4 5 5 5 5 4 5 7 7 3 14 45 56 29 12 12 15 14 11 -8 -4 18 23 11 -3 -1 7 -36
-3 -6 -6 -8 -9 -5 -4 -6 -7 -8 -5 -6 -5 5 16 13 -10 -26 -29 -27 -27 -29 -38 -45 -9 -13 -25 -19 -21 -18 -11 -72
