58 0 1 1 2 1 1 1 1 1 1 2 2 2 3 3 2 2 1 1 3 5 3 2 3 3 3 2 2 2 2 -104
9 -45 -45 -46 -47 -47 -48 -49 -50 -50 -51 -51 -51 -52 -53 -53 -54 -55 -55 -56 -53 -54 -58 -58 -57 -57 -57 -59 -59 -58 -59 -123
10 -45 -46 -47 -47 -47 -48 -49 -50 -51 -51 -51 -52 -53 -53 -54 -54 -55 -55 -56 -56 -58 -58 -57 -57 -57 -57 -59 -59 -58 -58 -123
10 -46 -47 -47 -47 -48 -49 -50 -51 -51 -52 -52 -53 -53 -53 -54 -55 -55 -56 -57 -57 -57 -57 -57 -57 -57 -57 -59 -59 -59 -58 -123
10 -47 -48 -49 -49 -50 -52 -52 -52 -53 -53 -53 -53 -54 -54 -55 -56 -56 -56 -57 -57 -57 -57 -58 -58 -58 -58 -59 -59 -59 -59 -123
10 -48 -48 -49 -50 -51 -53 -53 -52 -53 -53 -53 -53 -54 -55 -55 -55 -56 -57 -58 -57 -57 -57 -58 -58 -58 -58 -59 -59 -59 -59 -123
11 -48 -49 -50 -51 -53 -54 -54 -57 -61 -62 -61 -63 -63 -63 -64 -65 -64 -57 -54 -59 -59 -56 -58 -59 -58 -58 -59 -59 -59 -59 -124
10 -49 -50 -51 -53 -53 -53 -54 -84 -103 -89 -83 -84 -82 -79 -77 -79 -74 -53 -53 -67 -56 -47 -55 -59 -58 -59 -59 -59 -59 -59 -125
5 -50 -47 -52 -53 -53 -52 -55 -98 -99 -63 -53 -52 -51 -48 -45 -47 -43 -34 -47 -55 -42 -45 -58 -58 -56 -58 -59 -59 -59 -58 -125
0 -43 -45 -53 -54 -54 -53 -58 -89 -70 -30 -19 -19 -19 -18 -17 -20 -20 -17 -30 -53 -55 -60 -69 -54 -46 -54 -59 -59 -59 -59 -126
-13 -33 -41 -48 -53 -54 -54 -57 -82 -63 -24 -16 -18 -14 -12 -11 -14 -18 -10 -28 -62 -63 -53 -52 -49 -40 -47 -61 -62 -60 -65 -127
-17 -50 -37 -28 -46 -55 -57 -59 -78 -58 -22 -18 -17 -11 -10 -9 -10 -11 -9 -30 -53 -38 -21 -34 -47 -27 -53 -74 -70 -69 -76 -117
-9 -47 -16 -4 -37 -55 -87 -80 -71 -53 -22 -19 -13 -9 -10 -10 -13 -14 -13 -31 -45 -12 -11 -45 -43 -25 -74 -84 -73 -67 -72 -92
16 -12 -5 -24 -57 -72 -105 -76 -57 -36 -19 -22 -15 -11 -11 -11 -17 -22 -19 -27 -29 -2 -17 -47 -38 -31 -61 -54 -39 -31 -33 -70
32 5 -11 -44 -62 -68 -58 -35 -40 -27 -21 -22 -15 -11 -11 -13 -15 -20 -14 -8 -14 -22 -28 -43 -28 -14 -12 3 -2 -9 -23 -79
34 1 -8 -18 -22 -24 -11 -13 -37 -36 -24 -17 -12 -10 -10 -14 -15 -17 -1 -1 -31 -33 -40 -51 -17 -11 9 3 -28 -50 -53 -85
24 -18 -20 -20 -21 -21 -21 -28 -51 -41 -19 -11 -9 -8 -8 -12 -14 -15 -1 -23 -32 -30 -61 -50 -32 -24 -2 -33 -65 -71 -50 -76
12 -29 -29 -29 -31 -32 -34 -41 -54 -36 -16 -5 0 -6 -13 -13 -10 -12 -11 -14 -16 -54 -61 -43 -37 -11 -3 -38 -68 -55 -37 -72
11 -30 -32 -33 -34 -35 -35 -38 -49 -32 -12 0 3 -12 -21 -14 -10 -11 -12 -12 -45 -55 -29 -28 -22 11 5 -44 -65 -42 -33 -69
5 -29 -27 -26 -25 -24 -25 -29 -48 -31 -9 -5 -6 -19 -23 -12 -9 -14 -17 -30 -51 -24 -10 -32 -3 30 -4 -59 -60 -33 -28 -65
16 -18 -18 -20 -24 -28 -31 -34 -45 -29 -13 -12 -14 -20 -17 -7 -7 -17 -17 -16 -22 0 -14 -18 23 19 -33 -63 -42 -23 -28 -64
16 -25 -28 -33 -36 -35 -34 -32 -39 -31 -13 -13 -15 -14 -12 -9 -9 -9 -1 -8 -14 -1 -2 19 20 -18 -54 -58 -30 -22 -28 -63
2 -34 -33 -32 -30 -27 -25 -34 -47 -28 -8 -13 -5 -1 -8 -6 -8 -4 4 -15 -17 -3 21 19 -18 -43 -60 -47 -25 -24 -28 -63
5 -26 -24 -22 -21 -21 -27 -39 -32 -14 -16 -17 1 0 -9 -4 -2 -4 -6 -23 -7 32 29 -19 -42 -54 -62 -36 -21 -22 -29 -63
10 -18 -19 -19 -19 -21 -27 -28 -27 -28 -22 -13 -7 -12 -13 -10 -8 -12 -18 -13 32 49 -6 -41 -45 -61 -53 -23 -20 -23 -29 -62
12 -18 -20 -21 -26 -36 -42 -43 -41 -25 -9 -2 -2 -2 -1 -2 -1 -3 1 35 55 5 -35 -39 -47 -65 -48 -28 -17 -21 -30 -61
12 -19 -24 -34 -44 -48 -43 -30 -17 -5 0 3 9 6 3 6 6 9 36 55 14 -28 -35 -38 -56 -60 -33 -21 -14 -21 -31 -60
9 -30 -40 -45 -38 -26 -13 -5 -1 0 0 3 7 4 3 6 7 29 52 15 -23 -31 -34 -43 -63 -47 -11 0 -10 -27 -31 -56
-7 -42 -36 -24 -12 -3 0 0 0 0 0 2 2 1 2 10 31 48 19 -20 -29 -31 -35 -49 -58 -29 -3 -5 -25 -34 -30 -53
-14 -23 -10 -3 -2 0 1 1 0 1 2 4 2 0 9 36 49 18 -18 -31 -30 -33 -40 -58 -41 -10 -8 -18 -30 -34 -25 -48
2 -2 0 0 -1 0 3 2 0 1 3 3 3 17 39 40 9 -19 -31 -32 -32 -36 -48 -54 -17 -7 -28 -32 -30 -25 -15 -46
-8 -10 -10 -10 -9 -8 -9 -10 -11 -10 -10 -10 -9 -6 -16 -42 -63 -71 -75 -73 -74 -74 -73 -56 -42 -49 -54 -49 -47 -43 -42 -36
