-76 8 8 8 7 8 9 9 9 10 10 10 10 11 11 11 12 12 12 13 13 12 13 14 14 15 15 15 16 16 17 101
-127 7 6 6 4 5 6 7 6 7 8 7 7 7 8 8 9 9 9 10 8 7 11 12 10 10 11 11 11 11 12 125
-129 7 5 6 5 5 6 7 7 7 7 7 7 8 9 8 8 10 10 10 8 7 12 13 10 10 11 11 12 12 12 126
-130 6 5 7 5 5 7 8 8 7 7 8 7 8 9 9 9 9 9 10 10 8 9 10 10 11 11 12 13 12 12 126
-132 6 6 7 6 5 7 9 8 8 8 8 8 9 9 9 9 9 10 11 11 10 10 10 10 10 10 12 13 12 12 126
-134 6 6 8 6 6 8 10 8 8 8 7 7 8 9 9 9 8 8 10 11 11 10 11 11 10 10 11 12 12 12 126
-135 6 7 8 7 7 9 10 9 10 13 14 14 17 19 18 19 19 20 17 13 13 13 12 12 11 11 12 12 13 12 127
-136 8 7 8 8 9 11 10 12 26 37 38 38 38 38 37 35 33 26 20 24 22 13 11 12 11 11 12 12 13 12 128
-136 9 9 9 9 9 10 10 38 61 33 18 17 14 11 9 11 7 -12 -10 17 8 -6 8 17 13 12 12 12 12 12 128
-128 10 2 8 10 10 9 12 60 88 33 10 12 10 7 2 4 3 -12 -16 2 0 -3 17 23 16 13 12 12 13 12 129
-110 13 1 12 11 10 8 13 65 94 34 10 14 13 10 5 3 5 -11 -12 19 13 0 11 -2 -5 10 15 15 16 15 134
-97 -14 1 13 12 10 10 16 67 97 34 10 13 8 5 2 2 6 -13 -14 31 31 -8 -10 -9 -27 -14 20 25 22 26 140
-61 -20 -28 -35 0 11 12 29 78 101 40 17 17 6 4 1 0 5 -5 -3 38 32 -11 -6 9 -23 -14 34 28 26 29 127
-39 -8 -45 -82 -11 30 60 53 51 87 35 17 17 7 8 3 2 4 -5 3 37 11 -14 21 17 -19 2 40 8 4 6 84
-41 0 -23 -58 -20 20 60 51 9 44 26 23 19 5 7 4 4 9 -7 -7 15 -2 -8 42 39 -12 0 18 -19 -24 -13 81
-56 2 -2 -11 -15 -7 6 14 11 26 19 24 17 6 6 6 2 8 -3 -23 3 18 2 40 44 -4 -9 -3 -3 6 20 113
-74 6 8 12 10 10 11 14 42 52 20 15 13 7 6 7 3 3 -14 -25 15 21 19 45 28 1 -19 -18 25 43 39 103
-81 7 10 9 8 8 8 16 51 61 22 11 9 4 4 10 8 2 -17 -19 0 12 44 50 26 -4 -39 -28 32 48 33 89
-81 7 9 11 13 13 13 20 49 57 22 5 -1 7 15 13 8 4 -7 -25 1 41 59 38 19 -15 -60 -29 37 46 25 85
-77 14 14 11 9 6 5 10 42 52 19 1 -7 12 30 18 7 4 0 -9 13 40 27 31 30 -29 -63 -12 45 38 18 84
-76 4 3 3 4 5 10 19 52 56 15 7 -3 11 32 17 4 8 8 6 17 8 -4 28 10 -55 -46 22 51 22 8 80
-76 9 9 11 16 17 16 19 45 56 19 8 4 8 20 12 6 17 14 0 14 0 -7 16 -24 -50 -11 41 43 15 13 79
-75 15 15 15 16 14 12 13 40 56 22 12 10 2 7 6 1 8 8 4 12 -4 -19 -17 -22 -7 23 47 29 6 15 80
-69 13 9 10 12 10 9 20 43 39 10 17 13 3 14 12 7 6 -1 14 28 -11 -54 -45 -4 19 40 46 20 6 14 79
-64 13 8 7 8 9 13 23 29 32 28 27 7 1 23 15 8 15 11 22 15 -50 -60 -16 13 28 49 34 7 7 15 81
-63 10 9 10 7 12 21 33 47 46 33 24 10 0 9 8 0 5 10 2 -41 -76 -32 9 17 38 49 25 10 11 16 82
-63 8 8 13 20 29 35 35 33 25 16 15 11 6 6 6 2 0 0 -35 -61 -37 0 10 21 51 51 12 -6 2 20 80
-62 10 18 30 35 33 25 16 16 15 11 10 6 8 13 7 4 -1 -31 -54 -32 -1 9 10 32 56 39 11 -8 -8 18 76
-55 27 34 33 26 17 12 9 9 11 11 8 3 6 13 8 1 -27 -57 -35 0 6 8 16 45 51 11 -5 6 16 23 75
-39 32 25 16 13 10 9 8 8 10 11 8 4 4 9 -1 -30 -45 -32 -4 10 7 11 28 53 38 -3 -8 10 24 22 67
-27 15 10 9 10 9 6 6 7 9 9 7 7 6 -7 -39 -50 -21 4 12 10 10 17 42 43 13 0 3 21 32 21 62
-13 19 17 21 22 20 15 16 20 21 18 19 19 8 -2 4 21 40 54 56 54 56 68 78 53 31 51 43 34 42 39 88
