-61 -43 -44 -45 -46 -46 -47 -48 -49 -49 -50 -51 -51 -51 -51 -52 -52 -52 -53 -54 -55 -55 -54 -54 -54 -55 -55 -55 -55 -55 -54 -11
-46 -33 -34 -34 -35 -35 -36 -36 -36 -37 -38 -38 -38 -37 -37 -37 -37 -37 -38 -39 -39 -40 -38 -35 -36 -37 -37 -37 -37 -36 -36 -9
-47 -34 -35 -35 -35 -36 -37 -37 -36 -37 -38 -39 -39 -38 -37 -36 -36 -37 -38 -39 -39 -38 -36 -35 -36 -37 -37 -36 -36 -36 -36 -9
-48 -34 -35 -35 -35 -36 -38 -37 -37 -37 -39 -39 -38 -37 -36 -36 -36 -36 -38 -39 -38 -36 -35 -35 -36 -37 -36 -36 -35 -35 -35 -10
-50 -35 -36 -36 -36 -37 -38 -38 -38 -38 -39 -39 -38 -36 -36 -36 -36 -36 -38 -38 -37 -36 -36 -35 -36 -36 -36 -35 -35 -35 -36 -10
-51 -36 -37 -37 -37 -38 -38 -38 -38 -39 -39 -39 -38 -37 -36 -37 -36 -37 -38 -37 -37 -35 -35 -36 -36 -36 -36 -36 -36 -36 -36 -10
-52 -36 -38 -37 -37 -37 -38 -37 -36 -37 -37 -36 -35 -34 -34 -34 -34 -36 -37 -36 -34 -34 -35 -36 -36 -36 -36 -36 -36 -36 -36 -9
-54 -36 -37 -37 -36 -36 -37 -36 -27 -21 -21 -20 -18 -17 -18 -19 -19 -21 -29 -32 -28 -30 -35 -36 -36 -36 -36 -36 -35 -35 -35 -8
-52 -36 -37 -36 -35 -35 -36 -35 -18 4 2 0 2 2 1 -1 -2 -5 -13 -21 -18 -21 -34 -36 -35 -36 -35 -35 -35 -35 -35 -7
-50 -33 -38 -36 -35 -35 -35 -34 -19 5 1 -2 -1 0 0 -3 -5 -6 -12 -13 -9 -16 -25 -27 -33 -38 -37 -35 -35 -34 -34 -7
-43 -31 -39 -36 -35 -35 -35 -33 -20 2 0 -1 0 0 -2 -3 -3 -4 -10 -14 -3 1 -11 -13 -21 -40 -39 -34 -32 -32 -31 -6
-14 -20 -34 -41 -37 -34 -32 -32 -21 2 3 3 4 1 -1 -2 -3 -5 -7 -11 -1 5 -3 -11 -15 -31 -35 -27 -25 -26 -25 -4
0 1 -13 -45 -41 -33 -22 -26 -22 0 2 4 6 0 -2 -2 -4 -8 -9 -11 -2 -2 -8 -8 -13 -22 -24 -9 -14 -15 -18 -1
-2 3 0 -30 -36 -26 -13 0 -17 -1 2 5 6 0 0 -1 -3 -2 -6 -10 -4 -5 -17 -4 -3 -13 -10 2 -6 -12 -16 4
-15 -5 0 -3 -8 -8 -9 6 -5 -2 1 7 8 3 0 0 -1 1 -2 -14 -11 -8 -18 -8 -2 -7 -15 -8 -16 -20 -26 3
-27 -10 -9 -2 -1 -4 -9 -9 0 6 4 7 6 3 1 2 1 0 -5 -16 -16 -10 -8 -8 -4 -12 -25 -31 -28 -24 -23 4
-30 -12 -12 -13 -14 -14 -15 -13 -3 11 8 6 5 3 1 4 5 3 -5 -15 -14 -8 -4 4 1 -10 -20 -33 -19 -13 -9 8
-27 -7 -7 -8 -8 -9 -10 -9 0 12 8 3 1 3 4 5 6 4 0 -12 -8 -8 5 11 10 1 -17 -24 -12 -7 -8 11
-24 -4 -5 -7 -7 -7 -8 -7 2 13 9 4 -2 0 7 7 6 2 1 -6 -8 1 7 13 13 0 -18 -21 -10 -6 -9 13
-24 -5 -5 -5 -5 -6 -7 -6 3 14 9 7 0 0 8 8 6 4 2 6 9 8 2 7 8 -10 -22 -13 -3 -5 -10 13
-23 -6 -8 -8 -8 -9 -10 -7 2 18 11 10 7 4 8 9 6 6 9 14 17 9 -1 5 0 -21 -23 -6 -1 -5 -9 13
-27 -8 -7 -7 -5 -5 -5 -3 3 17 14 12 12 9 9 9 7 7 12 16 14 8 -8 -7 -16 -23 -13 -3 -3 -10 -8 13
-23 -2 -1 -2 -2 -3 -3 0 6 15 12 11 11 8 9 11 10 5 6 14 19 6 -14 -22 -25 -17 -7 -2 -3 -9 -7 14
-18 0 0 -3 -5 -4 -1 4 9 15 10 10 9 3 8 9 8 8 7 11 16 -1 -16 -25 -18 -11 -4 -1 -5 -8 -6 15
-18 -1 -2 -4 -6 -3 0 6 9 10 13 15 15 7 11 14 9 10 15 14 5 -16 -26 -18 -12 -6 0 0 -8 -8 -7 16
-18 -1 -3 -3 -1 1 5 7 10 15 14 14 17 16 16 17 16 14 16 5 -9 -24 -19 -12 -10 -1 5 -1 -9 -8 -5 15
-17 0 0 3 8 12 15 15 15 15 12 12 12 12 14 13 14 10 1 -10 -23 -19 -10 -11 -6 2 8 4 -4 -10 -3 15
-14 5 8 14 16 17 16 12 10 12 13 12 10 9 13 12 9 1 -11 -20 -17 -12 -10 -8 0 7 1 -5 -2 -6 -2 16
-7 13 17 17 16 13 11 10 11 11 12 11 11 11 12 8 0 -8 -18 -17 -9 -10 -9 -4 3 10 0 -9 -7 -1 0 16
3 18 17 13 12 11 11 11 11 11 10 10 11 12 10 0 -13 -21 -16 -9 -9 -9 -7 0 4 5 -1 -5 -2 2 2 17
9 13 11 10 12 12 11 10 11 11 10 9 10 6 -1 -11 -21 -18 -9 -7 -7 -7 -2 3 6 -1 1 0 -2 1 1 16
10 13 11 12 13 14 13 12 13 13 12 12 12 10 0 -2 3 7 7 8 7 8 10 15 16 8 13 17 13 12 11 12
