65 -5 -4 -4 -3 -3 -4 -3 -2 -2 -2 0 0 0 0 0 -1 -1 0 0 0 2 0 0 0 1 1 1 1 1 0 -86
45 0 0 0 0 0 0 0 0 0 1 2 2 0 0 1 0 0 1 1 2 3 0 0 0 0 1 1 0 0 0 -79
46 0 0 0 0 0 0 0 0 0 1 2 2 1 0 0 0 0 1 1 1 1 0 0 0 0 1 0 0 0 0 -79
47 0 0 0 0 0 0 0 1 1 1 2 2 0 0 0 0 0 1 1 0 0 0 0 0 0 0 0 -1 0 0 -79
48 0 0 0 1 1 0 1 1 2 1 2 1 0 0 0 0 0 1 1 0 0 0 -1 -1 -1 0 -1 -1 -1 0 -79
49 0 0 1 2 1 1 2 3 3 2 2 1 0 0 0 0 0 0 0 0 0 0 -1 0 0 0 0 0 0 0 -79
51 1 1 1 2 1 0 2 2 1 2 3 2 1 1 2 2 3 6 5 0 0 1 0 0 0 0 0 0 0 0 -79
52 2 1 1 1 1 0 1 -10 -17 -1 5 4 5 7 7 6 8 21 20 3 6 11 4 0 0 0 0 0 0 0 -80
51 4 5 1 0 0 0 -1 -32 -39 -5 5 4 4 7 10 8 10 25 20 6 15 16 5 2 2 0 0 0 0 0 -81
47 9 10 1 0 0 0 -4 -37 -34 0 9 6 5 8 10 10 10 20 14 2 10 11 5 13 15 5 0 0 0 0 -81
41 29 17 7 2 1 0 -5 -37 -31 1 8 6 8 10 12 9 8 20 15 -9 -3 9 10 18 27 17 1 0 0 -2 -81
30 31 31 33 10 1 0 -5 -34 -30 0 4 3 8 11 13 10 9 19 9 -11 -2 13 11 9 29 21 -3 0 0 -3 -70
21 9 39 58 23 0 -14 -12 -19 -21 1 2 4 8 9 13 12 13 19 6 -10 9 17 -4 3 33 5 -9 3 5 1 -49
25 4 31 44 24 5 -26 -13 -1 -2 5 0 3 7 9 14 12 10 17 9 -3 17 12 -16 -1 26 -2 -2 8 14 9 -39
35 7 13 6 7 6 -7 6 -4 5 7 -1 3 5 7 12 12 8 14 17 7 8 4 -10 -2 19 9 15 9 10 5 -51
42 9 4 -2 0 2 6 9 -16 -11 1 2 5 5 6 9 11 10 21 25 2 -2 0 -11 9 22 26 27 0 -7 -7 -51
44 7 4 5 4 4 4 0 -22 -20 0 6 7 6 6 5 7 9 26 19 0 5 -12 -13 11 17 37 20 -11 -17 -4 -39
37 1 2 1 1 1 2 -1 -20 -14 1 8 11 5 1 3 5 7 18 15 13 -5 -22 -7 0 20 43 13 -13 -12 3 -37
33 0 0 1 1 1 1 -1 -18 -12 1 11 16 3 -6 0 6 6 14 20 6 -16 -4 -5 -6 28 40 5 -17 -4 4 -37
32 0 0 1 2 3 2 -1 -20 -14 2 9 13 2 -5 1 6 5 11 9 -7 2 16 -9 0 38 27 -12 -18 3 6 -34
33 3 4 3 1 1 1 -2 -21 -15 0 3 6 1 0 5 6 0 2 6 -1 15 11 -10 19 37 5 -22 -11 8 4 -34
39 3 2 0 -1 0 0 0 -15 -15 -5 -1 0 1 3 6 5 -2 1 4 0 16 11 14 26 11 -13 -21 0 10 3 -35
31 0 1 0 0 3 4 0 -18 -12 0 -3 0 4 0 2 3 1 7 -4 -5 16 29 34 9 -7 -17 -14 4 8 4 -35
27 0 2 3 4 4 1 -8 -15 -4 -2 -5 8 9 -1 3 4 2 5 -7 -1 29 39 15 -3 -8 -18 -5 9 6 3 -37
29 2 3 4 5 2 -3 -9 -9 -8 -10 -5 7 5 1 4 7 4 -2 -4 24 48 23 -5 -3 -13 -17 4 9 6 2 -36
29 4 4 4 1 -3 -7 -9 -11 -9 0 1 2 0 3 3 4 3 2 16 45 28 -2 -1 -3 -20 -13 7 12 10 1 -34
29 2 0 -3 -9 -11 -10 -6 -3 2 3 3 5 3 0 2 4 4 19 38 29 0 -2 1 -11 -22 -7 4 14 13 1 -33
27 -4 -10 -13 -12 -5 0 4 3 1 0 2 7 4 0 3 5 15 38 28 1 0 2 -3 -19 -17 8 13 9 2 0 -31
16 -13 -12 -7 -1 3 4 2 1 0 0 2 5 3 3 8 17 31 28 3 -2 3 0 -9 -23 -8 15 17 4 -5 0 -28
4 -8 -1 2 2 2 2 2 1 1 2 3 2 0 5 22 36 25 1 -4 1 1 -3 -16 -17 4 10 7 -1 -4 1 -25
5 2 2 1 0 1 3 3 1 1 3 4 2 7 20 30 22 4 -3 -2 0 -1 -9 -20 -1 11 -1 0 2 0 4 -26
6 6 4 4 4 5 5 5 4 4 6 6 6 14 20 12 0 2 3 3 2 1 -3 -4 8 5 -2 1 4 7 7 -10
