0 0 0 0 0 0 0 0 0 0 0 0 0 0 0 44 
0 0 0 0 0 0 0 0 0 0 0 0 0 0 0 0 
0 0 0 0 0 0 0 0 0 0 0 0 0 0 0 24 
0 0 0 22 55 27 0 0 0 0 0 0 0 0 0 26 
0 0 0 58 193 187 94 67 67 69 9 0 0 0 0 43 
0 0 0 57 129 119 73 45 44 61 74 81 0 0 0 11 
14 0 0 4 81 85 45 28 33 32 23 110 15 0 0 40 
3 0 28 95 98 95 39 33 35 15 0 93 54 18 7 66 
0 0 0 15 78 112 60 52 40 0 0 72 0 0 0 0 
0 0 0 33 45 82 33 56 59 21 0 57 28 0 0 47 
0 0 6 25 46 82 43 31 37 82 0 0 0 0 0 35 
0 0 20 32 26 81 58 28 23 0 0 0 0 0 0 30 
0 10 18 13 3 60 79 73 34 0 0 0 0 24 13 20 
0 0 4 14 32 61 28 8 0 0 0 0 0 99 14 36 
0 0 4 0 0 22 5 0 0 0 0 0 45 0 0 0 
0 0 4 6 2 18 23 0 0 0 0 0 0 0 0 0 
