171 89 69 69 67 68 65 64 65 59 59 65 63 60 39 2 
147 11 25 28 25 25 19 18 17 14 15 19 16 15 0 7 
177 26 53 58 67 63 45 47 40 56 43 48 52 52 11 34 
183 31 56 28 42 28 0 0 0 0 32 80 59 46 12 33 
180 56 51 0 0 0 0 0 0 0 0 15 58 68 9 15 
0 25 86 0 0 17 0 0 0 0 0 0 0 56 0 0 
0 0 0 0 0 48 56 31 0 0 0 0 0 0 0 0 
0 0 0 0 0 47 46 19 0 0 18 0 0 0 0 0 
0 0 0 0 0 64 29 0 0 0 27 0 0 0 0 76 
93 0 0 0 0 71 23 3 0 0 0 0 0 59 76 121 
39 0 0 0 0 40 0 11 0 0 0 6 69 48 96 95 
26 0 20 0 0 0 0 0 0 0 0 0 131 72 94 71 
73 23 19 0 0 0 0 0 0 0 24 85 90 1 82 70 
101 0 0 0 0 0 0 0 0 0 159 170 0 0 0 56 
11 0 0 0 19 18 6 0 0 96 161 35 0 0 0 64 
0 9 53 69 38 0 0 0 3 112 69 0 0 0 0 32 
