0 0 0 0 0 0 0 0 0 0 0 0 0 0 0 0 
0 0 0 0 0 0 0 0 0 0 0 0 0 0 0 0 
0 0 0 0 0 0 0 0 0 0 0 0 0 0 0 0 
0 0 0 0 0 0 5 28 42 29 1 0 0 0 0 0 
0 0 0 0 0 0 0 0 0 0 34 38 0 0 0 0 
85 0 0 0 0 0 36 62 59 71 51 40 0 0 45 0 
38 0 131 154 75 0 0 16 25 69 37 120 29 62 44 0 
65 0 22 67 38 20 3 24 35 26 86 123 33 18 54 0 
37 49 61 124 73 17 6 28 25 43 137 111 47 55 93 0 
39 3 19 54 0 0 16 41 47 61 153 120 0 26 22 0 
21 3 39 101 38 33 21 44 53 68 106 0 0 23 0 0 
26 0 12 77 9 30 20 50 82 126 63 0 57 34 0 0 
30 0 51 123 90 43 15 53 62 0 0 0 88 0 28 20 
31 34 42 0 0 12 16 46 0 0 33 112 36 0 9 8 
17 0 0 0 0 0 14 0 0 0 56 20 38 55 71 0 
0 0 0 0 0 0 0 0 54 54 7 44 30 52 66 0 
