0 0 0 0 0 0 0 0 0 0 0 0 0 0 0 0 
24 76 32 36 29 26 29 31 28 33 41 45 46 44 50 0 
50 80 45 56 57 36 37 37 46 70 86 56 52 54 31 35 
66 84 41 53 10 0 0 0 0 0 38 82 74 65 28 32 
88 134 67 79 0 0 0 0 0 0 0 0 37 92 36 39 
0 20 139 227 117 0 0 0 0 0 0 0 0 71 0 2 
0 0 0 14 2 35 31 54 49 40 0 0 0 0 0 0 
0 0 0 0 0 0 42 68 70 48 0 0 0 0 0 0 
11 0 0 0 0 0 33 52 39 27 0 22 0 0 0 0 
8 0 0 30 85 0 24 35 75 10 0 0 0 54 0 0 
0 0 0 0 42 22 28 48 56 25 0 0 0 0 0 21 
0 0 0 3 0 0 0 0 0 0 0 0 0 19 43 19 
29 19 0 0 0 0 0 0 0 0 0 0 79 27 33 61 
37 0 0 0 0 0 0 0 0 0 0 54 114 0 0 31 
0 0 0 0 0 0 0 0 0 0 29 137 0 0 0 14 
0 0 0 0 31 25 0 0 0 0 54 14 0 0 0 0 
