0 0 44 45 46 47 48 50 46 42 38 40 48 53 27 8 
0 46 75 77 75 76 76 78 77 73 78 75 77 77 47 124 
0 18 48 61 41 60 56 58 70 53 43 45 49 51 20 82 
0 0 48 88 4 123 198 187 173 106 49 13 31 38 25 84 
0 0 18 71 0 0 50 87 24 0 0 37 64 0 0 77 
133 49 1 0 0 0 0 93 45 0 0 0 0 0 4 99 
0 0 0 0 0 0 0 11 0 0 0 0 0 0 0 92 
0 0 0 0 0 0 0 20 0 0 0 0 0 0 0 79 
0 79 124 145 0 0 0 0 0 0 0 0 0 0 0 29 
5 59 97 66 0 0 0 0 0 2 0 0 0 0 0 0 
0 68 103 74 0 0 0 0 0 0 0 0 0 0 0 0 
0 59 64 21 0 0 0 1 2 0 0 0 3 0 0 0 
0 36 78 102 70 0 0 0 86 0 0 0 23 0 0 22 
21 75 95 76 44 11 6 45 0 0 0 67 0 0 0 1 
13 30 0 2 37 29 24 0 0 0 31 0 0 0 0 29 
30 35 49 54 61 55 17 0 70 121 60 0 0 0 15 55 
