105 121 75 77 76 75 72 71 73 72 65 74 74 72 29 31 
69 33 0 0 0 0 0 0 0 0 0 0 4 1 0 49 
82 39 0 13 27 76 89 89 94 78 52 31 15 5 0 53 
81 63 0 0 0 0 11 3 0 0 15 57 45 31 0 51 
98 107 48 0 0 0 27 0 0 0 0 0 40 95 32 65 
0 25 144 0 0 0 26 51 23 0 0 0 0 15 28 60 
0 0 0 0 0 0 0 7 0 0 0 0 0 0 35 63 
0 0 0 0 0 0 0 0 0 0 0 0 0 0 36 4 
81 106 59 0 0 0 0 11 0 0 0 0 0 0 0 71 
106 119 88 0 0 0 0 12 0 0 0 0 0 0 0 27 
116 106 69 0 0 0 0 11 5 0 0 0 0 0 0 30 
122 119 79 0 0 0 0 62 14 0 0 0 0 0 0 39 
84 80 51 0 0 0 0 40 0 0 0 0 0 0 0 72 
51 39 16 16 5 4 0 0 0 0 0 0 0 0 0 51 
29 41 29 39 52 58 28 0 0 0 10 1 0 0 29 106 
0 0 0 1 6 26 0 0 0 0 14 0 0 0 0 74 
