0 0 43 47 47 49 47 45 44 41 27 18 25 30 94 0 
0 0 21 26 30 35 30 30 31 34 37 30 29 20 104 0 
0 0 23 0 0 0 22 21 20 0 0 0 3 23 86 0 
0 0 5 3 0 0 20 40 0 0 0 0 0 0 74 0 
0 0 0 0 0 0 0 76 54 0 0 0 0 0 0 0 
0 0 0 0 0 0 0 0 0 0 0 0 0 0 0 0 
145 0 0 0 0 0 0 0 10 0 0 0 0 0 0 0 
65 109 201 150 0 0 0 0 0 0 0 0 0 0 0 0 
0 27 123 86 0 0 0 0 5 0 0 0 0 0 0 0 
0 0 17 63 0 0 0 0 0 40 0 0 0 0 0 0 
0 0 2 42 0 0 0 0 0 0 0 0 0 0 0 0 
0 0 0 46 0 0 0 0 37 0 0 0 0 0 0 0 
0 0 8 87 69 98 26 0 24 0 0 0 0 0 0 0 
0 0 18 41 50 78 41 22 0 0 0 0 0 0 0 0 
16 0 9 0 13 62 37 1 0 0 0 0 0 0 0 0 
61 26 9 12 16 46 97 66 0 0 46 54 12 14 20 0 
