133 110 110 110 109 112 113 110 110 114 114 110 111 109 126 76 
0 0 0 0 0 0 0 0 0 0 0 0 0 0 0 0 
8 20 18 14 58 86 86 84 74 49 34 16 15 7 0 4 
0 26 25 18 57 66 31 26 0 3 10 61 46 25 0 4 
1 62 56 0 0 0 0 0 0 0 0 6 7 46 27 26 
0 2 67 0 0 0 0 0 0 0 0 0 0 0 9 30 
0 0 0 0 0 24 0 5 0 0 3 0 0 10 61 25 
0 0 0 0 0 0 17 0 0 0 6 0 39 112 127 7 
32 8 0 0 0 0 14 0 0 0 0 0 31 35 0 0 
32 36 24 0 0 5 0 0 0 0 0 6 88 18 0 0 
45 23 0 0 0 23 0 0 0 0 0 67 239 0 0 0 
0 0 0 0 14 9 0 0 0 0 22 226 113 0 0 0 
0 20 55 34 28 0 0 0 0 23 293 104 0 0 0 0 
29 57 36 0 0 0 0 0 55 347 164 0 0 42 0 0 
37 44 2 0 0 0 22 163 390 248 3 0 10 52 0 0 
0 0 0 0 0 0 68 220 102 0 0 0 0 0 0 0 
