0 0 0 0 0 0 0 0 0 0 0 0 0 0 0 0 
0 0 0 0 0 0 0 0 0 0 0 0 0 0 0 0 
6 0 0 0 0 0 0 0 0 0 0 0 0 0 0 0 
0 0 0 0 0 5 0 0 5 46 56 31 0 0 0 0 
24 0 0 0 60 0 0 0 0 0 30 42 17 10 0 0 
34 95 15 0 99 59 0 1 6 17 38 0 0 1 0 0 
0 0 0 20 150 71 24 37 34 44 81 0 0 0 0 0 
0 0 0 0 0 66 41 24 37 48 0 72 124 30 0 0 
0 0 0 0 73 92 22 3 10 12 38 132 89 0 0 99 
0 0 0 0 115 77 0 35 13 32 129 183 136 0 23 69 
0 0 0 7 138 58 1 23 20 67 75 191 91 22 32 25 
0 12 16 19 101 35 0 0 11 13 146 70 0 75 0 24 
8 14 17 32 98 20 0 0 0 204 69 0 50 95 0 10 
34 66 70 47 21 0 0 0 94 79 0 31 104 63 0 37 
78 105 11 0 0 0 0 89 58 0 0 37 144 2 0 9 
17 0 0 0 0 0 9 0 0 0 0 58 36 0 0 0 
