68 88 74 80 75 77 74 77 76 69 67 81 73 79 49 221 
45 0 0 2 0 0 0 0 0 0 0 0 0 0 0 194 
51 0 0 0 0 0 7 3 0 4 8 17 1 0 0 135 
53 0 0 0 23 0 0 0 0 0 0 0 36 10 0 132 
0 3 2 9 178 0 0 0 0 0 0 0 0 11 0 136 
0 0 0 0 201 0 0 0 0 0 0 0 0 0 0 127 
0 0 0 0 45 0 0 0 0 0 0 0 0 0 0 43 
35 22 0 0 53 0 0 0 0 0 0 0 0 0 2 78 
23 39 25 0 139 0 0 0 0 0 0 0 0 0 100 1 
14 0 0 0 130 0 0 0 0 0 0 0 0 0 37 0 
16 0 0 0 126 0 0 0 0 0 0 0 0 50 0 2 
31 0 0 0 52 0 0 0 0 0 0 0 104 28 0 44 
32 0 0 38 57 0 0 0 0 0 0 0 100 0 0 55 
45 7 0 0 42 0 23 0 0 0 24 32 14 0 0 15 
40 4 0 0 38 19 0 0 0 30 10 0 0 0 22 2 
10 0 17 3 0 0 0 0 23 34 0 0 0 0 0 45 
