135 0 0 0 0 0 0 0 0 0 0 0 0 0 0 0 
69 0 0 0 0 0 0 0 0 0 0 0 0 0 0 0 
91 0 0 0 0 0 0 0 0 0 0 0 0 0 0 0 
82 0 0 0 0 0 21 6 14 0 0 2 0 0 0 0 
0 0 0 0 6 110 78 42 37 0 0 14 0 0 0 0 
7 0 0 0 0 15 21 0 0 0 0 138 31 0 0 0 
100 0 0 0 0 0 6 17 0 0 26 5 0 0 0 0 
0 0 0 0 0 0 10 0 0 0 0 0 0 0 0 0 
0 0 0 0 0 0 16 0 0 0 0 0 9 0 0 26 
0 0 0 0 0 0 0 0 0 0 0 0 0 0 0 34 
39 0 0 0 0 0 0 0 0 0 0 0 0 0 12 0 
34 0 0 0 0 12 60 11 0 0 0 0 0 0 24 0 
25 0 0 0 0 52 67 18 0 0 0 0 0 7 0 0 
0 0 14 79 77 40 1 0 0 0 0 0 0 68 0 0 
0 22 77 40 0 0 0 0 0 0 0 0 17 0 0 0 
58 64 32 20 27 23 3 0 0 13 8 6 87 24 0 0 
