0 0 0 0 0 0 0 0 0 0 0 0 0 0 0 0 
0 0 21 20 19 20 22 22 22 15 24 25 15 14 0 0 
0 0 0 0 8 0 10 7 14 7 10 0 9 9 0 0 
0 0 0 0 70 64 76 58 60 29 9 7 0 22 0 0 
0 0 0 0 37 103 88 74 84 42 60 31 17 0 0 0 
106 0 0 0 0 0 16 5 13 0 54 83 81 30 0 0 
117 210 0 34 81 0 35 35 46 0 0 0 67 70 28 15 
0 50 22 0 69 0 36 38 49 0 0 0 8 0 0 0 
0 0 0 0 22 44 4 38 51 19 0 1 99 0 0 0 
9 17 15 0 34 36 1 24 45 52 9 0 63 0 0 0 
12 11 18 0 25 41 56 34 11 45 44 0 0 0 0 0 
4 25 21 0 23 29 64 65 55 30 72 0 0 0 0 0 
0 3 34 15 13 23 80 74 30 0 0 0 0 11 0 0 
0 0 53 41 22 0 0 0 0 0 0 0 0 52 26 0 
10 1 8 0 0 3 30 0 0 0 0 0 42 49 0 23 
7 0 0 4 7 5 10 0 0 0 0 0 0 47 63 0 
