0 0 0 0 0 0 0 0 0 0 0 0 0 0 0 27 
0 63 75 75 72 71 68 67 66 66 60 66 62 58 4 134 
0 0 18 15 12 0 0 0 0 0 0 0 1 4 0 70 
0 0 0 0 3 51 103 102 111 106 23 0 0 0 0 73 
0 0 0 0 0 95 161 132 129 83 69 52 0 0 0 49 
115 67 0 0 0 0 0 0 0 0 0 38 28 0 0 82 
8 125 76 0 11 34 0 0 0 0 0 0 0 3 14 119 
0 0 176 111 62 78 0 0 0 0 0 0 0 0 0 46 
0 0 0 0 0 1 0 0 0 0 0 37 0 0 0 73 
0 0 0 0 0 0 0 0 0 31 42 0 0 7 0 42 
0 0 0 0 0 0 0 0 0 0 50 0 0 0 0 31 
0 0 0 0 0 44 0 0 0 0 0 0 0 0 0 19 
0 0 0 28 80 76 6 29 72 101 0 0 0 1 0 0 
0 0 56 104 95 18 0 0 25 0 0 0 0 0 0 0 
0 43 25 0 0 0 0 0 0 0 0 0 0 0 0 0 
12 25 0 0 2 0 10 0 0 0 37 75 16 0 52 77 
