153 0 7 9 11 11 10 10 15 12 14 16 15 15 0 18 
183 0 6 11 14 10 11 13 16 15 8 11 5 12 0 13 
166 0 1 6 33 22 15 18 0 15 0 12 0 0 0 31 
167 0 0 0 55 0 0 0 0 0 0 26 0 0 0 31 
124 0 0 0 89 11 0 0 0 0 0 0 0 39 0 29 
0 0 0 0 201 167 61 0 0 39 35 0 0 52 0 0 
0 0 0 0 98 55 59 0 0 37 125 35 71 103 0 0 
27 0 0 0 24 0 12 0 0 77 37 51 23 148 0 2 
117 9 0 0 107 75 0 0 0 16 0 0 22 88 0 0 
100 0 0 0 133 71 0 1 0 0 0 0 0 0 0 29 
86 0 0 0 118 59 14 0 0 0 0 0 0 0 4 38 
86 0 0 0 42 0 45 0 0 0 0 0 0 9 0 38 
85 0 0 0 0 0 26 0 0 0 0 0 0 0 0 54 
72 0 0 0 0 0 39 0 0 0 0 0 0 0 0 12 
9 0 0 1 9 39 40 0 0 0 0 0 3 3 0 56 
9 0 9 12 6 6 11 0 0 0 0 0 0 0 0 0 
