0 82 14 16 15 13 14 16 16 12 14 17 14 19 51 0 
34 58 4 2 0 0 0 0 4 11 16 17 15 13 68 0 
29 66 4 0 0 0 0 0 0 0 2 17 21 17 67 0 
15 64 18 0 0 0 0 0 0 0 0 0 19 32 74 0 
2 11 39 30 0 0 0 0 0 0 0 0 0 0 66 0 
55 0 0 1 0 0 0 2 0 0 0 0 0 0 0 0 
89 10 0 0 0 0 0 43 35 0 0 0 0 0 0 0 
64 119 12 0 0 0 18 63 51 0 0 0 0 0 0 0 
31 54 35 0 0 0 23 46 75 0 0 0 0 0 0 0 
0 9 0 13 0 0 0 25 63 0 0 0 0 0 0 0 
0 0 0 0 0 0 0 2 0 0 0 0 0 0 0 0 
5 0 0 0 0 0 0 0 0 0 0 0 0 0 0 9 
19 5 0 0 0 0 0 0 0 0 0 0 0 0 0 0 
0 0 0 0 0 0 0 0 0 0 0 0 0 0 24 9 
0 0 0 0 0 1 0 0 0 0 0 0 0 0 45 0 
0 0 0 0 14 11 0 0 0 0 0 0 0 2 21 26 
