0 0 0 0 0 0 0 0 0 0 0 0 0 0 0 0 
0 0 0 0 0 0 0 0 0 0 0 0 0 0 0 48 
0 0 0 0 0 0 0 0 0 0 0 0 0 0 0 40 
0 0 0 0 0 0 0 0 0 0 0 0 0 0 0 45 
0 0 0 0 0 0 0 0 0 0 0 0 0 0 0 42 
0 0 0 0 22 128 62 60 68 37 34 0 0 0 0 70 
11 44 0 0 116 156 36 29 43 16 49 56 32 61 0 56 
89 186 101 63 105 108 40 43 18 48 103 75 69 108 7 10 
38 83 126 69 102 61 32 42 38 107 128 107 50 129 28 70 
0 32 27 0 53 53 15 49 45 90 80 83 110 80 10 100 
0 41 25 0 67 61 37 59 30 39 61 143 187 76 55 90 
3 48 41 42 80 15 0 28 38 51 100 143 99 80 66 113 
0 40 31 41 61 39 29 47 36 75 135 64 54 41 23 103 
0 33 7 0 12 28 41 29 52 130 65 87 41 57 73 93 
7 15 0 0 11 3 23 36 81 20 16 26 17 61 55 77 
16 22 15 9 0 0 46 70 12 14 40 29 100 111 74 77 
