79 73 72 72 75 77 76 78 78 84 78 79 84 78 145 0 
68 30 66 65 68 72 68 67 64 67 58 53 55 47 104 0 
59 0 41 57 35 41 11 12 19 21 18 19 23 21 69 0 
56 0 52 96 0 0 0 16 27 0 6 7 12 11 72 0 
37 0 51 111 0 0 46 84 101 4 2 0 16 0 52 0 
26 0 20 46 0 0 65 98 123 38 25 28 55 0 73 0 
57 0 0 0 0 0 14 34 68 42 0 97 123 0 162 0 
114 24 51 0 0 0 0 28 68 40 0 8 80 32 152 0 
60 44 108 85 0 8 0 14 44 3 0 0 5 0 0 0 
31 27 62 95 0 22 0 0 23 0 0 0 56 0 0 0 
57 49 63 93 0 4 0 0 9 0 0 23 36 0 0 0 
40 39 45 38 0 20 0 16 46 4 72 0 0 0 0 0 
25 6 8 0 0 5 0 60 83 66 30 0 0 0 0 0 
4 0 0 0 0 40 0 101 115 24 0 37 0 0 0 0 
0 0 0 0 0 24 0 84 20 0 10 0 0 0 0 0 
0 0 0 11 7 21 22 38 0 0 0 0 0 0 0 0 
