133 161 113 114 113 114 113 114 116 117 120 121 120 115 173 156 
54 0 0 0 0 0 0 0 0 0 0 0 0 0 0 0 
110 25 27 27 0 13 0 0 0 40 37 33 34 30 48 55 
123 26 35 113 34 19 0 20 49 57 85 26 57 28 49 55 
83 88 40 158 0 0 0 0 0 14 34 5 55 41 61 52 
29 89 95 141 0 0 0 0 16 51 33 0 81 48 68 34 
0 9 166 203 76 89 35 65 70 140 53 22 82 0 0 48 
0 0 30 26 50 68 20 63 83 167 171 118 11 0 0 54 
16 0 0 97 57 29 0 52 48 150 182 0 6 12 34 0 
26 0 2 119 28 27 17 66 55 67 102 0 80 118 41 0 
27 0 37 129 55 30 0 0 62 0 21 48 176 162 2 17 
21 12 28 89 51 0 0 0 44 30 47 132 145 20 0 32 
60 28 16 0 0 0 0 0 34 54 49 217 59 0 6 47 
79 24 0 0 0 0 0 0 0 42 164 102 0 0 45 50 
20 0 0 0 0 0 0 0 20 73 23 0 0 0 0 13 
0 0 0 27 34 40 3 57 133 80 86 119 46 71 68 39 
