39 0 2 0 1 2 4 4 4 9 16 8 11 8 0 112 
0 0 0 0 0 0 0 0 0 0 0 0 0 0 0 42 
2 0 4 12 28 15 14 7 12 2 18 18 0 0 0 26 
14 1 0 29 81 74 63 48 71 102 93 64 0 9 0 28 
54 14 11 35 183 238 163 140 184 180 154 101 59 52 0 29 
147 151 55 76 207 217 122 78 103 132 189 228 207 104 17 47 
253 308 121 183 253 149 95 60 78 135 227 222 282 200 127 98 
106 176 79 216 201 112 84 49 92 146 142 109 255 189 113 119 
0 10 39 104 152 184 92 61 96 114 66 139 266 117 0 116 
18 18 20 34 162 187 83 86 87 109 127 257 342 167 76 121 
47 37 19 56 143 174 108 104 82 130 202 241 239 74 113 71 
27 35 24 25 127 163 155 115 105 155 304 178 42 70 108 25 
35 28 10 5 77 134 145 110 111 281 336 72 16 160 89 19 
28 10 52 80 106 81 85 117 215 243 74 0 119 247 104 15 
33 74 99 64 45 45 71 162 164 23 0 63 199 186 0 18 
49 60 49 27 17 26 73 102 0 0 32 65 152 113 35 37 
