52 0 1 0 0 0 0 0 0 0 0 0 0 0 10 0 
88 0 17 12 12 15 17 13 11 17 18 10 10 11 28 0 
57 0 0 0 0 0 0 0 0 0 0 0 0 0 21 0 
60 0 0 67 6 0 0 0 28 10 0 0 0 0 21 0 
110 0 0 59 0 0 0 58 130 125 83 23 1 0 0 0 
229 34 0 0 0 0 0 32 133 88 0 0 133 0 0 0 
206 176 67 0 0 0 0 24 132 71 0 0 67 0 0 0 
78 44 73 15 0 0 0 24 151 115 0 0 15 0 0 0 
42 0 30 87 0 0 0 24 130 144 14 0 84 45 0 0 
31 0 43 65 0 0 0 0 58 160 20 0 105 59 0 0 
26 0 37 36 0 0 0 0 32 102 76 24 174 6 0 0 
16 0 39 42 0 0 0 0 46 83 131 182 68 0 0 0 
28 8 52 1 0 0 0 0 51 163 249 118 0 0 0 0 
63 0 0 0 0 0 0 0 139 342 178 17 0 0 0 0 
44 0 0 0 0 0 0 48 282 173 6 11 0 0 0 0 
26 0 14 15 6 13 60 193 199 18 22 15 0 0 0 0 
