0 0 0 0 0 0 0 0 0 0 0 0 0 0 0 0 
0 0 0 0 0 0 0 0 0 0 0 0 0 0 0 0 
0 0 0 0 0 0 0 0 0 0 0 0 0 0 0 5 
0 0 0 0 0 0 0 0 0 0 0 0 0 0 0 4 
0 0 0 0 0 0 0 0 0 0 0 0 0 0 0 0 
0 0 0 0 15 38 13 0 0 0 0 0 0 0 0 0 
0 0 0 0 0 66 52 37 14 3 8 0 0 0 0 0 
16 0 0 0 0 17 25 32 1 0 0 0 0 0 0 0 
0 0 0 0 0 46 37 35 22 0 0 0 0 0 0 0 
0 0 0 0 32 91 56 23 10 0 0 0 0 0 0 16 
0 0 0 0 0 55 27 11 0 16 41 35 0 31 44 53 
0 0 0 0 0 47 59 11 0 19 55 22 0 6 14 40 
0 0 0 0 0 0 0 0 0 38 90 0 0 37 49 33 
0 0 0 0 0 0 0 0 73 93 0 0 50 64 9 40 
0 0 24 10 6 9 18 76 111 35 0 33 88 84 0 4 
0 0 0 0 0 0 0 0 0 0 0 0 12 0 0 0 
