226 131 132 131 128 127 125 126 127 123 119 126 128 126 40 12 
231 73 101 103 102 97 93 96 96 91 82 79 79 80 6 0 
221 65 94 92 110 83 54 65 59 67 65 78 77 68 0 0 
208 79 102 53 114 135 115 117 103 111 83 93 74 64 0 0 
156 73 74 0 5 120 66 12 0 0 32 78 103 98 0 0 
79 131 83 0 0 60 55 0 0 0 0 70 11 44 0 0 
0 20 0 0 0 7 14 0 0 0 0 35 0 0 0 0 
0 0 0 0 0 33 19 0 0 0 0 5 0 0 0 0 
56 0 20 0 0 33 20 0 0 0 0 0 0 0 0 2 
49 0 0 0 0 0 0 0 0 0 0 0 0 0 0 9 
41 0 0 0 0 0 0 0 0 0 0 0 0 0 0 31 
27 0 0 0 0 0 0 0 0 0 0 0 0 0 0 8 
39 0 0 0 0 0 0 0 0 0 0 0 0 0 0 27 
8 0 0 0 3 13 0 0 0 0 0 0 0 0 0 4 
0 0 0 10 25 1 0 0 0 0 0 0 0 0 0 11 
0 1 28 47 48 16 0 0 0 0 0 0 0 0 0 0 
