0 0 0 0 0 0 0 0 0 0 0 0 0 0 0 29 
0 0 0 0 0 0 0 0 0 0 0 0 0 0 0 8 
0 0 0 0 0 0 0 0 0 0 0 0 0 0 0 46 
0 0 0 0 0 0 0 0 0 0 0 0 2 0 0 48 
0 0 0 0 41 32 17 11 19 51 0 0 0 0 0 57 
0 0 0 53 162 184 77 21 0 44 0 0 18 20 0 57 
0 0 0 0 131 185 55 0 0 0 0 45 0 0 0 94 
0 0 0 0 193 182 33 0 0 0 0 40 0 0 0 114 
0 0 0 35 145 113 29 43 0 0 0 0 0 0 22 5 
0 0 0 0 85 48 61 73 0 0 0 0 0 127 141 73 
0 0 8 4 35 0 23 21 0 0 0 0 0 107 24 90 
0 0 0 0 0 0 0 0 0 0 0 0 0 0 0 95 
0 0 0 0 0 0 0 0 0 0 0 9 0 0 50 135 
0 0 0 0 0 16 32 0 0 0 0 0 0 0 110 153 
0 0 0 5 12 0 0 0 0 0 0 0 0 0 81 99 
0 0 13 17 12 0 0 0 0 0 0 0 0 0 44 70 
