185 248 208 203 199 197 195 192 195 200 198 192 182 178 230 159 
0 23 0 0 0 0 0 0 0 0 0 0 0 0 0 0 
0 58 43 52 36 40 24 9 4 11 28 38 38 36 51 24 
0 43 47 93 47 14 0 0 0 0 23 15 39 28 42 14 
0 25 61 131 55 0 0 0 0 0 6 0 47 23 59 19 
0 13 57 115 51 8 0 0 40 19 76 0 45 51 110 64 
0 11 95 152 72 81 47 39 36 11 59 0 0 0 8 0 
0 0 21 0 0 43 20 28 14 16 50 17 23 28 29 0 
0 46 15 29 18 20 9 20 16 0 39 65 61 54 93 5 
0 22 19 20 0 62 9 20 0 11 56 0 53 0 41 6 
0 33 41 35 40 74 0 20 14 1 0 0 86 1 25 1 
0 12 21 0 7 40 0 0 0 0 3 60 15 0 0 14 
0 24 48 18 0 0 0 0 0 0 19 51 16 15 0 22 
0 30 16 0 0 0 0 0 0 0 0 0 35 72 2 22 
0 0 0 0 0 0 0 0 10 0 0 26 44 13 0 22 
0 0 0 0 0 0 0 28 0 0 0 0 0 0 0 8 
