0 9 43 44 46 45 44 39 39 40 26 26 37 37 0 0 
0 0 14 16 20 19 15 12 13 14 7 0 0 3 0 43 
0 0 26 21 28 72 65 59 43 47 22 27 28 24 0 71 
0 0 26 0 0 75 37 1 0 0 0 0 21 31 0 70 
0 0 18 0 0 155 98 42 0 0 0 0 0 0 0 63 
0 0 0 0 0 141 54 0 0 0 0 0 0 0 0 33 
0 0 0 0 0 85 25 0 0 0 0 0 0 0 0 54 
0 0 0 0 0 52 0 0 0 0 0 0 0 0 0 0 
0 0 0 0 0 26 0 0 0 0 0 0 0 0 0 13 
0 0 0 0 0 16 0 0 0 0 0 0 0 0 0 71 
0 0 0 0 0 11 0 0 0 0 0 0 0 0 0 34 
0 0 0 0 0 28 0 0 0 0 0 0 0 0 0 0 
0 0 0 0 12 34 1 0 0 0 0 0 0 0 0 2 
0 0 4 51 83 36 10 0 0 0 0 0 0 0 0 0 
0 0 90 66 45 11 0 0 0 0 0 0 0 0 0 41 
30 36 37 27 13 15 26 0 0 0 0 0 0 0 0 9 
