0 153 85 87 84 82 82 82 79 76 78 80 73 75 31 104 
0 62 0 0 0 0 0 0 0 0 0 0 0 0 0 8 
0 64 0 0 0 0 0 0 0 0 0 0 0 0 0 0 
0 54 0 0 0 0 0 8 4 0 0 0 0 0 0 0 
0 0 0 0 0 61 59 41 38 11 0 0 0 0 0 0 
0 0 0 0 0 116 61 11 0 19 13 65 0 10 0 10 
0 0 29 0 0 109 9 0 0 25 0 54 0 0 16 38 
0 24 135 58 83 113 0 0 0 0 0 0 0 0 0 41 
0 67 66 43 53 70 0 0 13 0 0 0 14 0 66 17 
0 52 13 4 7 55 31 25 9 0 39 49 0 37 54 28 
0 76 47 3 0 71 55 51 13 30 20 6 0 102 39 7 
0 74 0 0 0 13 15 40 0 38 7 0 98 37 8 0 
0 0 0 0 23 48 42 60 49 0 0 44 24 0 14 0 
0 0 18 82 80 59 19 3 0 0 70 0 0 11 0 21 
0 87 69 56 19 0 0 0 0 35 0 0 0 0 0 0 
8 91 45 12 6 7 10 57 160 134 91 106 89 125 104 58 
