0 0 0 0 0 0 0 0 0 0 0 0 0 0 0 0 
60 0 0 0 0 0 0 0 0 0 0 0 0 0 3 0 
37 0 0 0 0 0 0 0 0 0 0 0 0 0 0 0 
40 0 0 0 8 57 0 15 55 31 0 0 0 0 0 0 
33 0 0 0 51 207 160 117 161 131 77 24 11 1 0 0 
174 59 0 45 37 89 136 83 94 67 93 157 116 18 0 0 
191 100 5 0 0 0 0 0 14 3 0 30 85 19 35 0 
0 48 195 89 77 38 0 0 22 0 0 0 0 0 0 0 
0 0 11 35 15 91 22 17 28 0 0 18 74 0 46 0 
35 0 0 35 0 25 0 5 46 23 0 0 0 0 33 0 
11 0 0 12 0 14 47 24 35 55 14 0 0 0 0 0 
49 3 12 15 0 0 3 12 0 0 0 0 0 0 0 0 
39 0 0 0 0 0 45 67 54 0 0 0 0 9 0 0 
0 0 0 3 6 55 49 47 0 0 0 0 0 0 0 0 
15 0 19 64 35 37 40 0 0 0 0 0 0 0 0 0 
60 54 38 37 39 26 0 0 0 0 45 32 0 27 70 0 
