44 63 92 91 87 85 83 83 80 85 76 74 72 73 22 53 
0 0 38 38 36 35 33 32 29 27 15 13 14 13 0 0 
28 19 56 64 72 70 60 62 59 61 75 71 69 57 10 34 
27 31 58 81 92 98 101 106 111 100 75 60 79 68 13 30 
0 5 66 73 15 79 121 102 94 98 112 76 74 77 44 53 
64 10 81 122 0 0 0 0 0 1 69 126 111 84 99 90 
71 0 42 70 0 0 0 16 55 59 20 2 0 58 140 149 
0 0 12 33 0 37 22 20 54 52 9 0 0 0 71 12 
0 0 0 0 0 4 43 53 64 0 48 107 31 0 0 0 
27 40 78 84 0 8 21 24 58 63 110 154 87 55 19 0 
51 51 65 85 4 32 61 64 41 108 79 64 22 0 0 17 
21 28 77 109 60 85 59 76 97 138 134 81 0 0 0 5 
17 27 77 120 84 83 20 43 131 179 75 0 0 38 31 50 
43 76 124 126 97 58 0 37 101 64 0 0 69 47 18 7 
57 96 88 27 2 29 44 70 27 0 0 50 77 4 0 7 
64 49 30 37 47 52 56 0 0 0 81 110 27 0 27 30 
