52 0 9 6 4 4 4 3 0 0 0 0 0 0 0 0 
56 0 54 52 49 44 43 43 40 39 48 38 40 45 87 0 
35 0 30 13 7 0 0 0 0 0 0 6 10 15 38 0 
34 0 26 0 8 0 0 0 0 0 0 0 0 0 34 0 
0 0 0 0 0 0 0 0 0 0 0 0 0 0 0 0 
0 0 0 0 0 75 144 111 114 56 14 56 0 0 0 0 
13 0 0 0 0 0 29 47 65 17 0 114 76 0 0 0 
93 0 0 0 0 0 10 19 34 18 0 0 29 0 0 0 
111 0 56 0 0 34 13 9 33 12 0 0 115 135 0 0 
0 0 0 0 0 58 55 0 35 0 0 0 83 56 0 0 
0 0 0 0 0 42 20 0 0 0 0 0 120 43 0 0 
21 0 0 0 0 0 34 0 0 0 79 139 40 0 4 0 
0 0 0 0 0 0 0 0 0 0 181 138 0 0 37 0 
0 0 0 0 0 22 75 78 71 223 201 0 0 0 23 0 
0 0 0 74 53 31 0 0 64 122 0 0 0 54 0 0 
0 0 52 32 7 0 0 73 86 0 0 0 0 2 0 0 
