0 94 105 105 103 103 102 100 94 89 83 87 97 94 22 0 
0 152 84 81 78 85 81 84 74 70 66 67 68 61 49 29 
0 116 71 61 1 32 36 40 38 26 40 47 66 56 57 12 
0 96 88 0 0 0 38 22 0 0 0 0 49 50 63 13 
0 24 65 0 0 0 46 7 0 0 0 0 0 0 57 2 
0 0 0 0 0 0 11 0 0 0 0 0 0 0 0 0 
0 0 0 0 0 0 0 0 0 0 0 0 0 0 17 27 
0 0 0 0 0 30 0 0 0 0 0 0 0 0 152 9 
0 89 123 0 0 0 0 0 0 0 0 0 0 0 0 9 
0 50 41 0 0 0 0 0 0 0 0 0 0 0 11 33 
0 82 56 0 0 0 0 0 0 0 0 0 43 36 0 35 
0 43 9 0 0 0 0 0 0 0 0 50 120 0 0 27 
0 62 38 7 28 0 0 0 27 0 49 131 0 0 0 22 
0 84 71 78 88 60 3 80 0 36 187 65 0 0 0 0 
0 100 126 107 67 7 3 9 35 106 72 0 0 0 0 20 
43 114 64 51 39 27 33 71 57 56 14 0 0 0 0 18 
