187 0 0 0 0 0 0 0 0 0 0 0 0 0 0 0 
108 0 0 0 0 0 0 0 0 0 0 0 0 0 8 0 
93 0 14 25 54 41 24 20 19 4 0 18 16 19 51 0 
89 0 21 59 89 0 0 0 0 0 0 31 1 9 47 0 
148 0 15 97 144 0 0 0 0 0 27 7 0 7 46 0 
105 8 9 80 100 25 38 57 117 191 188 69 13 64 31 0 
173 22 0 19 0 0 30 51 114 184 167 117 126 157 0 0 
184 105 55 16 0 0 4 43 121 195 116 72 140 175 0 0 
82 22 11 10 58 19 30 48 99 184 97 27 59 111 0 0 
85 4 0 0 47 65 63 45 86 165 126 26 24 16 12 0 
101 0 0 28 50 57 75 19 71 153 178 99 0 0 11 7 
89 19 47 82 39 43 74 42 71 91 47 24 0 0 17 11 
74 56 84 32 0 0 40 2 43 52 0 0 0 29 24 9 
81 20 4 0 0 0 31 5 15 4 0 0 40 33 26 0 
110 0 0 4 30 63 84 11 0 0 0 73 77 72 52 0 
85 0 10 17 10 45 83 12 0 0 0 48 74 81 14 0 
