36 0 0 0 0 0 0 0 0 0 0 0 0 0 0 0 
118 44 79 78 70 63 57 58 58 61 72 81 78 82 79 68 
48 0 0 0 0 0 0 0 0 0 0 0 0 0 0 0 
66 0 0 28 14 0 0 0 0 1 0 0 0 0 0 0 
82 0 0 41 74 0 0 0 0 0 4 0 22 0 0 0 
134 48 0 40 98 0 0 0 0 38 32 0 77 0 0 0 
17 0 0 5 0 0 0 0 0 17 4 0 0 0 0 0 
0 0 0 0 0 0 0 0 17 6 0 37 23 0 0 0 
19 0 0 4 77 0 0 0 5 21 0 68 94 27 116 72 
0 0 0 0 57 0 0 26 0 0 0 49 0 0 43 0 
0 0 0 4 82 0 0 0 0 0 7 0 0 0 17 0 
0 0 0 0 0 0 0 0 0 51 0 0 0 90 0 0 
0 0 0 0 0 0 0 0 0 0 0 0 53 63 0 0 
0 0 0 0 0 0 0 0 0 0 0 37 115 8 0 0 
0 0 0 0 4 0 0 0 0 0 48 50 85 0 0 0 
0 3 31 10 3 0 1 0 0 90 46 40 63 0 0 0 
