224 130 131 130 127 125 122 125 128 123 119 124 127 125 40 12
228 72 99 101 101 96 90 94 95 89 82 79 78 79 4 0
217 64 93 90 106 84 53 62 56 66 64 78 77 68 0 0
204 78 102 51 111 133 113 114 99 109 85 91 76 65 0 0
152 71 71 0 6 117 62 8 0 0 32 75 100 97 0 0
77 129 81 0 0 60 54 0 0 0 0 67 6 40 0 0
0 20 0 0 0 7 14 0 0 0 0 36 0 0 0 0
0 0 0 0 0 30 17 0 0 0 0 5 0 0 0 0
56 0 17 0 0 35 18 0 0 0 0 0 0 0 0 3
49 0 0 0 0 0 0 0 0 0 0 0 0 0 0 6
38 0 0 0 0 0 0 0 0 0 0 0 0 0 0 31
28 0 0 0 0 0 0 0 0 0 0 0 0 0 0 8
39 0 0 0 0 0 0 0 0 0 0 0 0 0 0 28
9 0 0 0 4 11 0 0 0 0 0 0 0 0 0 4
0 0 0 10 25 0 0 0 0 0 0 0 0 0 0 13
0 3 28 44 47 13 0 0 0 0 0 0 0 0 0 0
