0 0 0 0 0 0 0 0 0 0 0 0 0 0 0 0
0 0 0 0 0 0 0 0 0 0 0 0 0 0 0 0
0 0 0 0 0 0 0 0 0 0 0 0 0 0 0 0
0 0 0 0 0 0 5 28 43 31 1 0 0 0 0 0
0 0 0 0 0 0 0 0 0 0 33 37 0 0 0 0
83 0 0 0 0 0 38 65 58 70 52 37 0 0 42 0
35 0 128 152 73 0 0 19 26 68 36 117 29 62 43 0
64 0 21 66 39 17 0 24 35 27 83 120 31 17 53 0
35 46 61 123 73 15 3 25 22 41 137 110 46 52 93 0
39 5 21 52 0 0 12 41 44 59 150 117 0 24 20 0
17 3 43 102 37 32 22 41 50 67 107 0 0 22 0 1
28 0 12 76 11 27 17 45 78 123 64 0 58 30 0 0
30 0 51 122 89 39 12 50 61 0 0 0 87 0 29 21
32 35 41 0 0 11 14 44 0 0 33 111 36 0 9 7
16 0 0 0 0 0 15 0 0 0 56 22 36 53 72 0
0 0 0 0 0 0 0 0 52 53 8 44 30 51 65 0
