0 93 102 101 101 101 98 97 94 88 80 84 94 90 21 0
0 150 80 79 78 83 78 81 74 64 62 65 68 61 49 28
0 112 68 62 0 31 37 40 36 21 40 46 66 57 55 11
0 94 88 0 0 0 38 18 0 0 0 0 50 48 61 12
0 24 64 0 0 0 44 2 0 0 0 0 0 0 54 1
0 0 0 0 0 0 6 0 0 0 0 0 0 0 0 0
0 0 0 0 0 0 0 0 0 0 0 0 0 0 15 26
0 0 0 0 0 29 0 0 0 0 0 0 0 0 151 12
0 89 118 0 0 0 0 0 0 0 0 0 0 0 0 12
0 51 39 0 0 0 0 0 0 0 0 0 0 0 14 32
0 78 54 0 0 0 0 0 0 0 0 0 43 39 0 34
0 41 7 0 0 0 0 0 0 0 0 47 117 0 0 25
0 62 38 5 25 0 0 0 22 0 48 128 0 0 0 20
0 83 69 77 85 54 0 72 0 37 185 64 0 0 0 0
0 97 124 101 59 0 0 6 36 105 69 0 0 0 0 20
43 112 61 49 38 25 32 72 58 56 12 0 0 0 0 18
