51 0 10 5 2 2 3 2 0 0 0 0 0 0 0 0
55 0 53 51 49 43 42 41 38 38 46 36 37 42 84 0
33 0 29 13 7 0 0 0 0 0 0 5 9 14 35 0
32 0 23 0 11 0 0 0 0 0 0 0 0 0 33 0
0 0 0 0 0 0 0 0 0 0 0 0 0 0 0 0
0 0 0 0 0 75 144 109 111 57 13 52 0 0 0 0
12 0 0 0 0 0 29 48 63 15 0 113 75 0 0 0
91 0 0 0 0 0 11 20 33 17 0 0 30 0 0 0
109 0 56 0 0 37 14 10 31 10 0 0 116 133 0 0
0 0 0 0 0 57 54 0 33 0 0 0 81 54 0 0
0 0 0 0 0 40 19 0 0 0 0 0 116 44 0 0
22 0 0 0 0 0 38 0 0 0 78 139 37 0 6 0
0 0 0 0 0 0 3 0 0 0 179 136 0 0 37 0
0 0 0 0 0 24 74 77 72 220 198 0 0 0 19 0
0 0 0 74 54 30 0 0 63 121 0 0 0 56 0 0
0 0 51 30 8 0 0 70 83 0 0 0 0 3 0 0
