104 120 73 76 75 75 70 70 73 70 65 73 72 72 29 30
67 32 0 0 0 0 0 0 0 0 0 1 4 0 0 47
81 37 0 10 26 76 89 90 96 76 52 30 15 4 0 52
81 62 0 0 0 0 13 6 0 0 16 57 47 32 0 52
100 107 47 0 0 0 29 0 0 0 0 0 39 94 31 67
0 26 143 0 0 0 26 50 21 0 0 0 0 13 24 61
0 0 0 0 0 0 0 8 0 0 0 0 0 0 35 63
0 0 0 0 0 0 0 0 0 0 0 0 0 0 38 5
79 105 56 0 0 0 0 10 0 0 0 0 0 0 0 71
104 117 85 0 0 0 0 9 0 0 0 0 0 0 0 26
115 105 68 0 0 0 0 11 7 0 0 0 0 0 0 32
124 119 79 0 0 0 0 59 14 0 0 0 0 0 0 41
84 82 53 0 0 0 0 40 0 0 0 0 0 0 0 73
51 39 18 16 8 5 0 1 0 0 0 0 0 0 0 51
29 38 31 37 52 54 25 0 0 0 8 0 0 0 26 106
0 0 0 1 6 25 0 0 0 0 14 0 0 0 0 73
