0 0 0 0 0 0 0 0 0 0 0 0 0 0 0 0
0 0 0 0 0 0 0 0 0 0 0 0 0 0 0 0
5 0 0 0 0 0 0 0 0 0 0 0 0 0 0 0
0 0 0 0 0 4 0 0 3 45 56 30 0 0 0 0
21 0 0 0 60 0 0 0 0 0 28 41 17 8 0 0
33 92 11 0 99 56 0 1 6 15 35 0 0 2 0 0
0 0 0 15 148 66 22 37 32 40 78 0 0 0 0 0
0 0 0 0 0 65 38 25 33 45 0 72 121 28 0 0
0 0 0 0 77 89 17 3 7 10 38 130 85 0 0 101
0 0 0 0 113 74 0 37 12 29 130 180 136 0 22 68
0 0 0 6 135 56 0 24 18 64 73 189 90 19 32 26
0 10 16 19 100 36 0 0 9 13 141 68 0 75 0 23
8 10 15 31 95 21 0 0 0 200 68 0 49 96 0 10
33 64 67 44 22 0 0 0 91 74 0 32 105 64 0 39
75 104 8 0 0 0 0 89 55 0 0 40 143 0 0 13
14 0 0 0 0 0 9 0 0 0 0 60 38 0 0 0
