0 0 0 0 0 0 0 0 0 0 0 0 0 0 0 0
0 0 0 0 0 0 0 0 0 0 0 0 0 0 0 49
0 0 0 0 0 0 0 0 0 0 0 0 0 0 0 42
0 0 0 0 0 0 0 0 0 0 0 0 0 0 0 46
0 0 0 0 0 0 0 0 0 0 0 0 0 0 0 43
0 0 0 0 18 124 62 58 68 36 34 0 0 0 0 71
12 44 0 0 110 152 37 29 45 15 49 51 29 60 0 57
87 184 97 63 105 107 44 44 19 45 101 71 63 108 10 11
36 81 124 70 102 58 34 42 36 104 126 104 47 130 30 69
0 34 27 0 53 50 16 50 45 93 80 81 109 83 12 98
0 42 27 0 66 61 37 59 30 41 61 143 185 76 51 88
4 47 42 43 80 15 0 27 37 49 98 143 94 77 60 109
0 39 33 43 66 40 28 42 35 76 133 63 52 40 21 102
2 34 8 0 11 25 35 27 54 131 64 87 40 56 71 93
10 19 0 0 9 3 24 37 81 20 17 27 14 59 56 79
19 25 15 13 0 1 50 70 10 13 41 29 97 109 76 78
