0 0 0 0 0 0 0 0 0 0 0 0 0 0 0 27
0 62 72 72 70 70 66 63 63 65 58 63 61 59 5 134
0 0 13 14 12 0 0 0 0 0 0 0 2 2 0 70
0 0 0 0 0 46 99 97 109 104 22 0 0 0 0 71
0 0 0 0 0 90 160 129 129 83 67 48 0 0 0 46
110 62 0 0 0 0 0 0 0 0 0 37 29 0 0 81
7 122 75 0 10 33 0 0 0 0 0 0 0 1 11 117
0 0 173 110 61 73 0 0 0 0 0 0 0 0 0 48
0 0 0 0 0 0 0 0 0 0 0 36 0 0 0 73
0 0 0 0 0 0 0 0 0 27 40 0 0 8 0 40
0 0 0 0 0 0 0 0 0 0 47 0 0 0 0 29
0 0 0 0 0 44 0 0 0 0 0 0 0 0 0 17
0 0 0 25 76 72 4 26 66 95 0 0 0 0 0 0
0 0 52 102 91 14 0 0 21 0 0 0 0 0 0 0
0 42 24 0 0 0 0 0 0 0 0 0 0 0 0 0
8 22 0 0 0 0 12 0 0 0 34 73 13 0 51 76
