0 0 0 0 0 0 0 0 0 0 0 0 0 0 0 0
60 0 0 0 0 0 0 0 0 0 0 0 0 0 4 0
36 0 0 0 0 0 0 0 0 0 0 0 0 0 0 0
39 0 0 0 5 56 0 14 55 29 0 0 0 0 0 0
34 0 0 0 48 205 160 115 161 130 77 21 9 2 0 0
172 55 0 43 38 87 133 82 92 68 92 154 111 16 0 0
188 96 0 0 0 0 0 0 13 2 0 32 81 15 35 0
0 46 191 86 77 35 0 0 23 0 0 0 0 0 0 0
0 0 11 37 16 88 21 15 27 0 0 13 71 0 45 0
34 0 0 33 0 22 0 2 42 20 0 0 0 0 31 0
11 0 0 12 0 12 46 22 35 52 13 0 0 0 0 0
48 4 12 15 0 0 2 8 0 0 0 0 0 0 0 0
38 0 0 0 0 0 42 65 54 0 0 0 0 6 0 0
0 0 0 1 5 49 46 45 0 0 0 0 0 0 0 0
15 0 21 63 34 36 39 0 0 0 0 0 0 0 0 0
57 50 37 34 39 26 0 0 0 0 42 30 0 25 68 0
