132 160 113 112 113 114 113 114 115 116 119 119 120 114 174 155
53 0 0 0 0 0 0 0 0 0 0 0 0 0 0 0
110 24 30 27 0 11 0 0 0 40 36 31 33 29 49 54
121 25 36 112 32 17 0 19 49 57 83 25 54 27 48 54
80 85 41 158 0 0 0 0 0 10 31 6 54 40 62 52
28 88 93 136 0 0 0 0 15 49 31 0 80 46 67 34
0 8 162 198 77 88 33 63 71 138 49 22 83 0 0 48
0 0 28 22 50 68 19 62 82 164 166 116 6 0 0 55
16 0 0 89 55 29 0 52 47 149 179 0 6 14 35 0
27 0 0 113 27 32 17 67 56 64 99 0 80 114 42 0
25 0 34 123 55 29 0 0 63 0 18 47 176 160 3 15
17 7 25 86 52 0 0 0 43 25 44 129 144 19 0 32
55 22 14 0 0 0 0 0 30 51 52 215 61 0 8 48
74 22 0 0 0 0 0 0 0 40 163 101 0 0 45 51
18 0 0 0 0 0 0 0 19 71 23 0 0 0 0 13
0 0 0 27 34 37 0 55 131 79 85 118 46 69 67 40
