0 0 0 0 0 0 0 0 0 0 0 0 0 0 0 44
0 0 0 0 0 0 0 0 0 0 0 0 0 0 0 0
0 0 0 0 0 0 0 0 0 0 0 0 0 0 0 24
0 0 0 22 56 25 0 0 0 0 0 0 0 0 0 26
0 0 0 58 193 187 94 69 68 68 10 0 0 0 0 41
0 0 0 54 124 118 74 44 45 61 73 80 0 0 0 11
13 0 0 4 78 86 48 27 33 31 24 110 16 0 0 40
4 0 29 97 95 94 40 33 36 13 0 94 54 19 4 65
0 0 0 14 75 109 57 49 38 0 0 69 0 0 0 0
0 0 0 32 41 80 31 56 55 19 0 54 28 0 0 46
0 0 4 23 45 80 41 30 36 78 0 0 0 0 0 34
0 0 22 35 28 80 56 27 22 0 0 0 0 0 0 31
0 10 19 16 5 60 78 71 34 0 0 0 0 23 12 21
0 0 3 13 32 59 29 11 0 0 0 0 0 98 12 35
0 0 3 0 0 20 1 0 0 0 0 0 44 0 0 0
0 0 4 6 1 17 24 0 0 0 0 0 0 0 0 0
