0 151 82 85 85 81 81 81 77 75 76 78 72 74 30 103
0 61 0 0 0 0 0 0 0 0 0 0 0 0 0 8
0 64 0 0 0 0 0 0 0 0 0 0 0 0 0 0
0 55 0 0 0 0 0 9 5 0 0 0 0 0 0 0
0 0 0 0 0 61 60 41 38 13 0 0 0 0 0 0
0 0 0 0 0 117 61 9 0 20 11 64 0 8 0 9
0 0 28 0 0 112 10 0 0 25 0 54 0 0 14 37
0 23 132 56 77 115 1 0 0 0 0 0 0 0 0 37
0 66 65 43 53 70 0 0 15 0 0 0 13 0 65 15
0 50 10 3 6 55 33 26 11 0 39 47 0 37 54 27
0 76 47 1 0 68 55 50 15 35 23 5 0 102 40 4
0 74 3 0 0 13 18 40 0 36 7 0 98 37 8 0
0 0 0 0 23 48 41 59 50 0 0 44 21 0 13 0
0 0 16 79 78 55 17 0 0 0 69 0 0 9 0 20
0 87 67 56 17 0 0 0 0 38 0 0 0 0 0 0
9 88 42 10 4 4 8 55 158 132 90 102 84 124 102 57
