0 0 42 44 46 48 43 40 39 39 26 17 24 30 93 0
0 0 20 21 27 36 30 29 28 33 34 29 29 22 104 0
0 0 20 0 0 0 24 21 17 0 0 0 3 26 88 0
0 0 6 0 0 0 21 39 0 0 0 0 0 0 74 0
0 0 0 0 0 0 0 73 53 0 0 0 0 0 0 0
0 0 0 0 0 0 0 0 0 0 0 0 0 0 0 0
141 0 0 0 0 0 0 0 8 0 0 0 0 0 0 0
61 104 196 149 0 0 0 0 0 0 0 0 0 0 0 0
0 25 121 81 0 0 0 0 1 0 0 0 0 0 0 0
0 0 16 62 0 0 0 0 0 42 0 0 0 0 0 0
0 0 1 42 0 0 0 0 0 0 0 0 0 0 0 0
0 0 0 47 0 0 0 0 36 0 0 0 0 0 0 0
0 0 11 87 71 97 25 0 21 0 0 0 0 0 0 0
0 0 18 40 49 73 32 16 0 0 0 0 0 0 0 0
17 1 12 0 13 61 34 0 0 0 0 0 0 0 0 0
60 28 12 13 16 48 98 66 0 0 46 53 11 12 20 0
