135 0 0 0 0 0 0 0 0 0 0 0 0 0 0 0
69 0 0 0 0 0 0 0 0 0 0 0 0 0 0 0
90 0 0 0 0 0 0 0 0 0 0 0 0 0 0 0
80 0 0 0 0 0 17 6 11 0 0 2 0 0 0 0
0 0 0 0 7 111 75 43 33 0 0 11 0 0 0 0
5 0 0 0 0 17 20 0 0 0 0 134 32 0 0 0
98 0 0 0 0 0 4 20 0 0 27 3 0 0 0 0
0 0 0 0 0 0 5 0 0 0 0 0 0 0 0 0
0 0 0 0 0 0 9 0 0 0 0 0 15 0 0 26
0 0 0 0 0 0 0 0 0 0 0 0 0 0 0 35
41 0 0 0 0 0 0 0 0 0 0 0 0 0 10 0
34 0 0 0 0 12 61 14 0 0 0 0 0 0 27 0
26 0 0 0 0 51 65 23 0 0 0 0 0 4 0 0
0 0 13 77 73 38 2 0 0 0 0 0 0 67 0 0
0 21 78 38 1 0 0 0 0 0 0 0 20 0 0 0
54 60 31 17 26 20 0 0 0 12 4 3 88 25 0 0
