43 63 91 91 87 84 84 81 78 84 77 74 71 72 23 53
0 0 38 37 34 35 33 29 28 27 13 12 15 12 0 0
26 20 54 63 70 67 58 60 60 61 73 69 69 55 9 33
26 30 56 83 91 96 100 105 111 100 75 58 76 66 12 30
0 6 66 72 16 81 124 105 96 96 108 73 73 76 42 53
64 11 83 121 0 0 0 0 0 0 65 123 110 82 96 88
71 0 43 70 0 0 0 16 55 56 17 6 0 58 137 146
0 0 15 34 0 35 19 17 53 51 12 0 0 0 70 12
0 0 0 0 0 3 43 50 63 2 49 105 30 0 0 0
28 41 78 81 0 8 22 24 55 62 108 151 84 53 20 0
53 53 66 83 1 28 62 68 44 108 80 64 23 0 0 18
20 27 76 107 56 82 60 75 94 136 131 79 0 0 0 7
18 25 74 117 81 82 21 44 130 176 75 0 0 37 31 50
40 73 121 126 96 58 3 37 99 61 0 0 68 48 19 6
55 94 84 25 2 28 41 64 24 0 0 48 76 4 0 7
63 49 29 36 46 49 53 0 0 0 78 107 24 0 23 27
