0 8 41 41 44 43 39 36 38 37 24 27 35 36 0 0
0 0 11 12 17 16 10 9 9 10 6 0 0 2 0 42
0 0 24 15 23 68 64 54 40 42 21 26 29 25 0 70
0 0 23 0 0 73 34 0 0 0 0 0 21 30 0 69
0 0 16 0 0 155 98 40 0 0 0 0 0 0 0 62
0 0 0 0 0 138 50 0 0 0 0 0 0 0 0 33
0 0 0 0 0 81 21 0 0 0 0 0 0 0 0 53
0 0 0 0 0 54 0 0 0 0 0 0 0 0 0 1
0 0 0 0 0 23 0 0 0 0 0 0 0 0 0 14
0 0 0 0 0 15 0 0 0 0 0 0 0 0 0 69
0 0 0 0 0 11 0 0 0 0 0 0 0 0 0 33
0 0 0 0 0 25 0 0 0 0 0 0 0 0 0 0
0 0 0 0 12 32 0 0 0 0 0 0 0 0 0 1
0 0 5 48 81 32 7 0 0 0 0 0 0 0 0 0
0 0 90 60 41 6 0 0 0 0 0 0 0 0 0 42
31 36 37 24 11 11 22 0 0 0 0 0 0 0 0 10
