0 0 0 0 0 0 0 0 0 0 0 0 0 0 0 0
25 78 32 35 27 24 28 30 30 34 41 42 46 45 50 0
51 81 45 55 55 34 35 34 43 68 85 52 48 54 30 34
66 81 40 55 11 0 0 0 0 0 38 81 75 66 30 29
88 131 65 77 0 0 0 0 0 0 0 0 41 93 35 37
0 18 133 224 114 0 0 0 0 0 0 0 0 72 0 2
0 0 0 12 1 38 29 53 47 38 0 0 0 0 0 0
0 0 0 0 0 0 37 66 68 51 0 0 0 0 0 0
9 0 0 0 0 0 34 54 37 26 0 19 0 0 0 0
10 0 0 28 83 0 23 35 73 7 0 0 0 52 0 0
0 0 0 0 42 20 27 46 54 24 0 0 0 0 0 23
0 0 0 0 0 0 0 0 0 0 0 0 0 20 44 19
28 13 0 0 0 0 0 0 0 0 0 0 78 28 34 63
35 0 0 0 0 0 0 0 0 0 0 55 112 0 0 32
0 0 0 0 0 0 0 0 0 0 30 137 0 0 0 14
0 0 0 0 31 25 0 0 0 0 54 16 0 0 0 0
