184 247 206 203 198 196 194 191 193 198 196 190 179 179 231 159
0 22 0 0 0 0 0 0 0 0 0 0 0 0 0 0
0 57 44 52 35 39 20 6 3 10 26 37 36 32 49 21
0 41 44 89 45 13 0 0 0 0 23 14 38 26 41 15
0 24 60 130 54 0 0 0 0 0 5 0 47 25 60 20
0 13 54 112 52 7 0 0 39 18 72 0 42 47 107 60
0 10 94 149 73 80 45 36 34 9 54 0 0 0 7 0
0 0 21 0 0 41 20 28 11 14 47 16 20 23 25 0
0 46 15 28 19 18 9 20 17 2 38 67 63 53 91 3
0 22 18 20 0 62 10 18 0 11 54 0 49 0 42 6
0 32 37 33 40 70 0 20 13 0 0 0 83 0 24 2
0 12 16 0 5 40 0 0 0 0 2 60 15 0 0 14
0 22 47 17 0 0 0 0 0 0 18 52 16 14 0 22
0 27 17 0 0 0 0 0 0 0 0 0 33 70 2 22
0 0 0 0 0 0 0 0 10 0 0 22 44 14 0 20
0 0 0 0 0 0 0 27 0 0 0 0 0 0 0 9
