0 0 43 45 45 46 47 47 45 43 38 39 46 52 27 7
0 47 72 75 75 76 76 76 76 72 76 75 78 77 49 123
0 16 45 59 40 57 56 57 68 49 42 44 50 52 21 81
0 0 47 86 1 123 197 186 169 104 46 13 33 38 24 82
0 0 18 68 0 0 51 86 20 0 0 33 65 0 0 76
130 48 1 1 0 0 0 92 42 0 0 0 0 0 2 98
0 0 0 0 0 0 0 8 0 0 0 0 0 0 0 90
0 0 0 0 0 0 0 16 0 0 0 0 0 0 0 80
0 78 123 143 0 0 0 0 0 0 0 0 0 0 0 31
8 62 98 65 0 0 0 0 0 0 0 0 0 0 0 0
0 67 102 74 0 0 0 0 0 0 0 0 0 0 0 0
1 60 63 19 0 0 0 0 2 0 0 0 2 0 0 0
0 38 79 102 68 0 0 0 83 0 0 0 23 0 0 19
21 75 95 76 44 9 3 37 0 0 0 66 0 0 0 0
16 31 1 5 36 25 17 0 0 0 32 0 0 0 0 29
34 37 51 55 61 54 15 0 70 121 60 0 0 0 15 54
