0 82 14 15 17 13 14 17 16 13 15 17 14 19 50 0
33 59 4 1 0 0 0 0 3 10 17 17 17 14 69 0
28 67 4 0 0 0 0 0 0 0 2 18 22 19 68 0
17 65 17 0 0 0 0 0 0 0 0 0 24 36 76 0
5 13 39 29 0 0 0 0 0 0 0 0 0 0 66 0
55 0 0 4 0 0 0 1 0 0 0 0 0 0 0 0
86 10 0 0 0 0 0 43 36 0 0 0 0 0 0 0
63 116 11 0 0 0 22 66 54 0 0 0 0 0 0 0
31 53 34 0 0 0 26 48 75 0 0 0 0 0 0 0
0 8 0 14 0 0 0 25 61 0 0 0 0 0 0 0
0 0 0 0 0 0 0 0 0 0 0 0 0 0 0 0
7 0 0 0 0 0 0 0 0 0 0 0 0 0 0 8
19 6 0 0 0 0 0 0 0 0 0 0 0 0 0 0
0 0 0 0 0 0 0 0 0 0 0 0 0 0 23 8
0 0 0 0 0 1 0 0 0 0 0 0 0 0 47 0
0 0 0 0 15 12 0 0 0 0 0 0 0 1 23 28
