186 0 0 0 0 0 0 0 0 0 0 0 0 0 0 0
106 0 0 0 0 0 0 0 0 0 0 0 0 0 9 0
93 0 17 26 54 41 24 19 20 5 1 18 13 17 50 0
90 0 19 58 91 0 0 0 0 0 0 32 0 8 49 0
148 0 14 98 144 0 0 0 0 0 26 10 0 7 49 0
106 10 9 79 101 25 38 58 117 188 186 68 10 63 35 0
172 22 0 19 0 0 30 51 115 182 165 116 122 154 0 0
182 104 54 17 0 0 5 45 118 192 118 73 135 171 0 0
80 21 10 11 59 22 30 50 96 178 93 25 57 107 0 0
84 4 0 0 48 68 60 46 86 159 121 26 23 16 13 0
101 0 0 25 51 56 73 21 70 149 176 100 0 0 10 9
90 21 44 78 38 42 72 41 70 93 47 25 0 0 17 12
72 55 83 31 0 0 42 2 43 52 0 0 0 27 26 10
80 20 5 0 0 0 32 5 15 3 0 0 38 31 26 0
107 0 0 5 31 62 79 9 0 0 0 75 77 71 51 0
84 0 9 17 10 46 83 10 0 0 0 48 74 81 15 0
