0 0 0 0 0 0 0 0 0 0 0 0 0 0 0 0
0 0 0 0 0 0 0 0 0 0 0 0 0 0 0 0
0 0 0 0 0 0 0 0 0 0 0 0 0 0 0 5
0 0 0 0 0 0 0 0 0 0 0 0 0 0 0 5
0 0 0 0 0 0 0 0 0 0 0 0 0 0 0 0
0 0 0 0 11 35 14 0 0 0 0 0 0 0 0 0
0 0 0 0 0 63 51 35 15 2 6 0 0 0 0 0
16 0 0 0 0 16 27 31 1 0 0 0 0 0 0 0
0 0 0 0 0 43 37 32 19 0 0 0 0 0 0 0
0 0 0 0 30 87 53 22 5 0 0 0 0 0 0 17
0 0 0 0 0 49 23 8 0 15 39 37 0 30 45 54
0 0 0 0 0 45 57 8 0 21 54 20 0 6 15 39
0 0 0 0 0 0 0 0 0 39 88 0 0 38 49 32
0 0 0 0 0 0 1 0 75 95 0 0 48 63 7 40
0 0 20 9 3 7 16 74 109 35 0 33 87 82 0 1
0 0 0 0 0 0 0 0 0 0 0 0 12 0 0 0
