153 0 6 8 9 10 10 12 15 10 14 15 16 14 0 17
182 0 6 9 12 10 11 15 16 14 9 10 4 12 0 14
164 0 1 3 34 21 14 18 0 14 0 12 0 0 0 31
164 0 0 0 56 0 0 0 0 0 0 27 0 0 0 31
121 0 0 0 90 11 0 0 0 0 0 0 0 38 0 30
0 0 0 0 203 168 62 0 0 39 36 0 0 52 0 0
0 0 0 0 99 54 60 0 0 36 125 35 69 103 0 0
28 0 0 0 24 0 15 0 0 77 40 53 23 147 0 2
115 10 0 0 107 77 0 0 0 16 0 0 20 87 0 0
99 0 0 0 133 72 0 2 0 0 0 0 0 0 0 29
84 0 0 0 119 62 14 0 0 0 0 0 0 0 5 39
86 0 0 0 43 0 47 1 0 0 0 0 0 12 1 38
84 0 0 0 0 0 29 0 0 0 0 0 0 0 0 55
71 0 0 0 0 0 43 0 0 0 0 0 0 0 0 13
6 0 0 0 10 40 41 0 0 0 0 0 3 1 0 57
8 0 6 10 6 6 12 0 0 0 0 0 0 0 0 0
