51 0 3 0 0 0 0 0 0 1 0 0 0 0 9 0
87 0 20 15 12 18 17 11 11 17 17 9 10 12 28 0
56 0 0 0 0 0 0 0 0 0 0 0 0 0 21 0
59 0 0 68 4 0 0 0 27 7 0 0 0 0 21 0
108 0 0 59 0 0 0 59 127 121 79 20 0 0 0 0
227 33 0 0 0 0 0 32 131 85 0 0 132 0 0 0
203 172 67 0 0 0 0 24 127 68 0 0 68 0 0 0
75 43 72 13 0 0 0 23 146 113 0 0 15 0 0 0
40 0 28 83 0 0 0 25 126 142 14 0 82 42 0 0
31 0 44 63 0 0 0 0 56 157 19 0 105 55 0 0
25 0 37 34 0 0 0 0 32 100 74 27 171 3 0 0
13 0 38 41 0 0 0 0 45 79 127 180 65 0 0 0
25 8 53 0 0 0 0 0 46 161 245 113 0 0 0 0
59 0 0 0 0 0 0 0 132 337 177 16 0 0 0 0
41 0 0 0 0 0 0 43 275 170 7 11 0 0 0 0
23 0 16 16 4 15 62 192 195 16 22 15 0 0 0 0
