35 0 0 0 0 0 0 0 0 0 0 0 0 0 0 0
117 44 77 76 69 59 55 55 55 61 71 77 75 78 77 66
47 0 0 0 0 0 0 0 0 0 0 0 0 0 0 0
65 0 0 26 10 0 0 0 0 2 0 0 0 0 0 0
80 0 0 39 68 0 0 0 0 0 3 0 21 0 0 0
132 45 0 37 97 0 0 0 0 36 31 0 71 0 0 0
15 0 0 1 0 0 0 0 0 16 5 0 0 0 0 0
0 0 0 0 0 0 0 0 14 1 0 32 20 0 0 0
20 0 0 1 72 0 0 0 6 18 0 66 94 26 113 69
0 0 0 0 53 0 0 24 0 0 0 47 0 0 38 0
0 0 0 2 77 0 0 0 0 0 4 0 0 0 12 0
0 0 0 0 0 0 0 0 0 48 0 0 0 89 0 0
0 0 0 0 0 0 0 0 0 0 0 0 51 61 0 0
0 0 0 0 0 0 0 0 0 0 0 35 112 6 0 0
0 0 0 0 2 0 0 0 0 0 44 47 82 0 0 0
0 0 26 6 1 0 0 0 0 86 42 37 60 0 0 0
