77 73 72 72 74 77 75 76 79 84 77 78 85 78 145 0
64 29 65 65 69 73 68 65 66 66 57 53 54 46 103 0
56 0 39 56 35 41 12 12 20 19 19 19 23 21 69 0
53 0 52 94 0 0 0 15 27 0 8 5 10 9 70 0
38 0 49 106 0 0 46 85 99 4 0 0 16 0 53 0
26 0 22 44 0 0 66 99 121 37 22 30 52 0 72 0
56 0 1 0 0 0 13 34 67 43 0 98 119 0 160 0
111 26 51 0 0 0 0 26 67 41 0 9 79 31 151 0
57 43 107 81 0 10 0 12 43 2 0 0 6 0 0 0
29 25 60 92 0 24 0 0 23 0 0 0 54 0 0 0
55 49 61 93 0 6 0 0 10 0 0 25 35 0 0 0
40 38 43 38 0 20 0 17 47 5 75 0 0 0 0 0
26 8 9 0 0 5 0 59 81 65 32 0 0 0 0 0
4 0 0 0 0 39 0 99 115 25 0 35 0 0 0 0
0 0 0 0 0 24 0 83 20 0 9 0 0 0 0 0
0 0 0 10 10 21 20 39 0 0 0 0 0 0 0 0
