170 87 68 66 65 67 64 63 65 58 58 63 62 58 37 0
145 10 23 27 24 24 20 19 19 12 13 19 15 14 0 7
176 26 52 58 67 62 46 47 42 54 44 46 51 51 11 33
180 30 55 28 43 29 0 0 0 0 33 80 59 47 11 32
177 54 51 0 0 0 0 0 0 0 0 14 55 66 9 16
0 24 83 0 0 17 0 0 0 0 0 0 0 55 0 0
0 0 0 0 0 44 52 30 0 0 0 0 0 0 0 0
0 0 0 0 0 41 40 19 0 0 20 0 0 0 0 0
0 0 0 0 0 63 26 0 0 0 24 0 0 0 0 75
94 0 0 0 0 69 23 3 0 0 0 0 0 56 78 120
36 0 0 0 0 39 0 9 0 0 0 4 66 49 99 97
23 0 17 0 0 0 0 0 0 0 0 0 130 73 96 71
67 16 14 0 0 0 0 0 0 0 25 84 90 3 82 70
96 0 0 0 0 0 0 0 0 0 158 169 0 0 0 57
9 0 0 0 18 17 5 0 0 93 159 35 0 0 0 65
0 5 51 63 35 0 0 0 2 110 68 0 0 0 0 32
