131 108 109 110 109 111 112 110 109 111 112 109 109 108 126 76
0 0 0 0 0 0 0 0 0 0 0 0 0 0 0 0
6 20 20 13 56 85 86 82 73 50 32 16 15 6 0 5
0 25 25 16 57 64 28 24 0 0 8 58 44 22 0 5
0 60 54 0 0 0 0 0 0 0 0 4 4 42 25 27
0 1 64 0 0 0 0 0 0 0 0 0 0 0 7 29
0 0 0 0 0 23 0 6 0 0 0 0 0 9 57 23
0 0 0 0 0 0 12 0 0 0 4 0 40 107 125 5
31 10 0 0 0 0 12 0 0 0 0 0 31 33 0 0
29 38 26 0 0 5 0 0 0 0 0 5 84 15 0 0
44 24 0 0 0 23 0 0 0 0 0 65 238 0 0 0
0 0 0 0 12 10 0 0 0 0 23 220 108 0 0 0
0 18 53 32 25 0 0 0 0 22 289 102 0 0 0 0
28 55 34 0 0 0 0 0 53 340 160 0 0 43 0 0
34 41 2 0 0 0 20 161 385 244 1 0 10 50 0 0
0 0 0 0 0 0 66 218 102 0 0 0 0 0 0 0
