0 0 0 0 0 0 0 0 0 0 0 0 0 0 0 0
0 0 22 20 20 20 22 21 21 17 25 25 15 14 0 0
0 0 0 0 7 0 9 6 11 6 9 0 8 9 0 0
0 0 0 0 70 64 74 56 57 26 9 5 0 21 0 0
0 0 0 0 38 102 87 73 85 39 62 31 17 0 0 0
104 0 0 0 0 0 16 5 11 0 55 81 78 31 0 0
116 206 0 32 79 0 36 35 47 0 0 0 63 68 26 14
0 48 22 0 67 0 37 39 49 0 0 0 7 0 0 0
0 0 0 0 17 41 2 36 50 18 0 0 100 0 0 0
10 17 15 0 34 36 2 24 43 50 10 0 62 1 0 0
15 14 18 0 25 39 55 36 13 43 42 0 0 0 0 0
4 26 23 0 23 28 61 64 53 28 69 0 0 0 0 0
0 2 34 16 14 22 78 74 30 0 0 0 0 10 0 0
0 0 51 38 19 0 0 0 0 0 0 0 0 51 25 0
11 1 7 0 0 3 29 0 0 0 0 0 41 48 0 23
6 0 0 7 8 4 9 0 0 0 0 0 0 46 63 0
