68 87 72 78 75 73 73 76 74 69 68 79 69 78 49 220
46 0 0 0 0 0 0 0 0 0 0 0 0 0 0 193
51 0 0 0 0 0 5 2 0 2 6 15 3 0 0 134
52 0 0 0 21 0 0 0 0 0 0 0 37 11 0 132
0 2 0 8 174 0 0 0 0 0 0 0 0 10 0 136
0 0 0 0 197 0 0 0 0 0 0 0 0 0 0 126
0 0 0 0 42 0 0 0 0 0 0 0 0 0 0 43
37 19 0 0 50 0 0 0 0 0 0 0 0 0 2 77
23 38 25 0 133 0 0 0 0 0 0 0 0 0 101 3
13 0 0 0 122 0 0 0 0 0 0 0 0 0 36 0
16 0 0 0 124 0 0 0 0 0 0 0 0 49 0 5
33 0 0 0 51 0 0 0 0 0 0 0 102 28 0 44
31 0 0 35 57 0 0 0 0 0 0 0 99 0 0 56
43 6 0 0 42 0 20 0 0 0 22 30 17 0 0 16
40 3 0 0 35 16 0 0 0 29 10 0 0 0 22 1
11 0 13 0 0 0 0 0 23 35 0 1 0 0 0 45
