0 0 0 0 0 0 0 0 0 0 0 0 0 0 0 31
0 0 0 0 0 0 0 0 0 0 0 0 0 0 0 9
0 0 0 0 0 0 0 0 0 0 0 0 0 0 0 45
0 0 0 0 0 0 0 0 0 0 0 0 4 0 0 46
0 0 0 0 39 32 18 8 21 52 0 0 0 3 0 57
0 0 0 52 156 184 78 18 0 45 0 0 17 19 0 57
0 0 0 0 125 187 58 0 0 3 0 43 0 0 0 93
0 0 0 0 186 180 38 0 0 0 0 37 0 0 0 113
0 0 0 39 139 110 34 42 0 0 0 0 0 0 25 3
0 0 0 0 80 45 62 69 0 0 0 0 0 129 142 71
0 0 6 4 30 0 21 18 0 0 0 0 0 108 25 87
0 0 0 0 0 0 0 0 0 0 0 0 0 0 1 93
0 0 0 0 0 0 0 0 0 0 0 9 0 0 48 137
0 0 0 0 0 14 32 0 0 0 0 0 0 0 111 153
0 0 0 7 14 0 0 0 0 0 0 0 0 0 85 100
0 0 12 18 11 0 0 0 0 0 0 0 0 0 48 72
