39 0 3 2 2 2 5 6 4 9 15 8 10 7 0 113
0 0 0 0 0 0 0 0 0 0 0 0 0 0 0 42
3 0 4 11 29 14 13 8 12 3 17 18 0 0 0 26
14 0 0 28 80 72 61 47 70 102 93 62 0 8 0 26
53 14 10 36 182 237 162 140 182 180 156 100 59 54 0 29
145 149 52 74 204 216 123 79 102 131 187 224 204 105 16 47
249 303 117 180 250 150 97 62 77 132 223 218 278 199 126 95
104 171 76 213 200 112 87 49 90 142 140 108 254 185 108 116
0 11 39 102 149 182 90 59 97 114 65 137 265 116 0 113
17 17 18 34 161 186 83 86 86 109 126 253 338 165 72 119
47 35 18 55 141 173 107 104 81 126 200 238 235 72 108 68
26 35 25 25 126 161 154 114 104 151 300 175 40 71 107 26
34 28 10 5 76 132 142 107 109 278 329 71 15 159 89 19
27 9 51 78 102 79 85 119 214 238 72 0 116 245 103 14
31 72 96 63 46 47 73 161 160 24 0 60 197 185 1 18
47 56 47 26 16 26 72 101 0 0 31 62 150 115 35 35
