0 0 0 0 0 0 0 0 
0 0 0 0 0 0 0 0 
0 0 0 0 0 0 0 65 
0 0 0 0 0 0 0 88 
0 0 0 0 72 16 147 0 
0 0 0 0 230 710 676 560 
0 0 0 0 883 987 376 380 
64 0 0 634 1151 600 168 9 
