0 0 0 0 0 0 0 0 
0 0 0 0 0 0 0 0 
0 0 0 89 0 0 0 0 
0 0 0 0 0 0 0 0 
0 0 0 90 199 212 0 0 
0 0 0 900 972 0 0 0 
0 0 509 1003 0 0 0 0 
0 0 128 0 0 0 0 0 
