0 0 0 435 332 0 264 0 
0 0 0 337 0 0 0 0 
0 0 0 505 310 0 0 0 
0 0 0 0 42 0 0 0 
266 0 0 0 102 0 0 0 
328 0 0 0 436 0 0 0 
0 106 404 912 547 0 0 0 
0 60 195 4 0 0 0 0 
