0 0 0 250 158 0 0 0 
305 923 1060 1399 1237 1027 849 931 
422 1057 609 954 1147 1346 1008 988 
512 598 0 0 161 393 225 488 
28 162 0 0 0 0 0 0 
0 0 0 0 0 0 0 0 
0 0 0 0 0 0 0 0 
0 0 0 0 0 0 0 0 
