0 0 0 0 0 0 0 0 
0 0 0 95 46 0 0 0 
0 0 0 743 678 1 0 0 
518 1516 1033 820 282 0 0 0 
92 1442 709 180 0 0 0 0 
0 119 293 0 0 0 0 232 
0 0 0 0 0 0 60 81 
10 58 0 0 142 598 356 0 
