0 0 0 0 0 0 0 0 
0 354 0 0 0 0 0 0 
0 0 0 0 234 0 0 0 
0 0 0 0 111 109 0 0 
0 0 0 0 93 231 0 0 
0 0 0 0 319 129 0 0 
94 0 0 453 0 0 31 0 
207 69 0 0 0 0 0 0 
