128 324 72 0 1 5 126 0 
287 428 776 797 345 0 0 0 
0 0 0 796 194 0 0 0 
0 0 0 261 0 0 0 0 
356 0 0 0 0 0 0 0 
82 0 0 0 0 0 0 0 
0 0 0 0 0 0 0 0 
0 0 34 0 0 0 0 0 
