0 0 0 0 0 0 0 0 
49 0 470 0 0 0 0 0 
406 0 0 0 0 205 0 0 
0 0 0 0 0 139 0 0 
0 0 0 0 0 0 117 0 
0 0 0 0 0 0 0 289 
0 0 0 0 0 0 0 125 
377 0 0 0 0 0 0 0 
