0 0 0 0 0 0 0 0 
0 0 0 0 0 0 0 0 
0 0 0 0 0 0 0 0 
0 0 0 0 4 0 0 0 
0 0 0 0 309 0 0 0 
0 0 0 0 0 346 760 231 
0 0 0 0 0 905 1121 0 
0 0 141 0 172 1294 561 0 
