0 0 0 0 0 0 0 0 
0 0 242 0 0 0 0 0 
0 0 60 0 0 179 0 0 
0 0 463 191 0 179 0 0 
0 0 726 355 0 0 300 0 
0 0 358 0 0 221 773 275 
0 0 0 0 0 53 750 105 
0 0 0 0 262 0 342 10 
