800 964 884 835 747 587 576 130 
754 943 245 0 211 86 158 0 
803 186 0 0 0 0 0 0 
0 0 0 0 0 0 0 0 
0 0 0 0 0 0 0 0 
298 0 0 0 0 0 0 0 
89 0 0 0 0 0 0 0 
0 0 0 0 0 0 0 0 
