159 0 201 100 0 66 202 0 
401 0 514 175 0 0 0 0 
541 0 575 797 0 0 130 178 
10 0 0 563 0 0 1049 650 
306 0 0 630 0 0 145 913 
310 0 0 201 0 0 0 889 
122 0 0 0 0 0 0 813 
105 0 0 0 0 0 0 612 
