1052 1219 1234 804 988 1108 1164 1428 
0 0 0 0 0 0 0 0 
0 0 0 0 0 0 0 0 
0 0 0 0 0 0 0 0 
0 0 0 0 0 0 0 0 
0 0 0 0 0 0 0 0 
0 0 0 0 0 198 0 0 
0 0 138 61 536 0 0 144 
