0 0 0 0 0 0 0 0 
0 0 0 0 0 0 0 0 
0 0 0 0 0 0 0 0 
660 0 0 0 0 0 0 0 
1379 0 0 0 411 0 0 0 
831 564 0 0 284 0 0 0 
303 375 0 0 0 0 0 0 
0 0 0 0 0 0 0 0 
