0 0 0 0 0 0 0 0 
0 0 0 0 0 0 0 0 
0 0 55 897 641 0 0 0 
0 0 0 1067 677 199 0 0 
0 0 0 538 640 17 0 0 
0 0 0 742 877 0 0 0 
0 0 260 953 823 0 0 0 
0 0 276 765 0 0 0 0 
