0 0 0 0 0 0 0 0 
0 0 0 0 0 0 0 0 
0 0 0 0 0 0 0 0 
0 0 0 940 10 0 0 0 
0 0 0 567 594 910 2 0 
0 0 0 436 1105 816 402 145 
0 0 0 175 620 0 0 133 
0 0 0 466 0 0 0 0 
