0 0 0 0 0 0 0 0 
0 0 0 0 0 0 0 0 
0 0 0 357 0 0 225 232 
0 0 0 102 0 0 0 239 
0 0 348 219 0 0 0 0 
0 71 0 149 640 0 0 0 
0 0 0 711 665 0 0 7 
0 0 133 172 73 0 0 85 
