0 0 0 0 0 0 0 0 
0 0 0 0 0 0 0 0 
0 0 0 0 0 0 0 0 
0 0 94 241 0 1053 336 0 
0 0 0 265 0 1303 1319 358 
0 0 0 83 171 690 979 320 
0 0 0 0 0 0 117 223 
0 0 0 0 0 0 0 93 
