0 0 0 69 0 0 0 0 
0 366 0 0 0 0 270 188 
0 933 691 560 212 183 469 235 
217 988 645 528 209 836 741 482 
0 1242 889 300 0 0 0 209 
0 796 295 0 0 0 0 104 
0 0 0 0 0 0 0 0 
0 0 0 0 0 0 0 0 
