0 0 0 0 0 0 0 0 
0 0 0 0 0 56 0 0 
0 0 0 0 0 61 0 0 
0 0 367 0 0 491 0 119 
0 54 541 457 0 374 0 218 
0 0 0 0 0 88 388 332 
0 0 0 0 0 0 294 106 
0 0 0 0 0 100 355 266 
