0 0 0 0 0 0 0 0 
0 0 0 0 0 0 0 0 
0 0 0 0 0 0 0 0 
0 0 0 0 0 0 5 0 
0 0 0 0 0 0 1071 1032 
0 0 0 0 0 0 472 254 
0 0 0 0 0 0 0 84 
0 0 0 0 0 0 0 514 
