0 0 0 0 0 0 0 0 
0 0 0 0 0 0 0 0 
0 0 0 0 0 0 0 0 
0 0 600 0 0 0 0 0 
0 0 153 0 0 0 0 22 
0 0 115 0 0 0 20 150 
97 66 140 0 0 0 204 209 
151 11 0 0 0 455 590 444 
