0 0 0 0 0 0 0 0 
0 0 0 0 0 0 0 0 
0 0 0 0 0 0 0 0 
0 0 0 0 0 0 0 0 
366 0 0 0 0 0 0 0 
503 0 0 0 0 0 0 0 
78 0 369 0 0 0 0 0 
119 377 545 0 0 0 0 0 
