0 0 0 0 75 0 0 0 
0 0 0 0 0 0 0 0 
0 0 0 0 0 0 0 0 
0 0 289 97 0 0 0 247 
0 0 216 290 0 0 0 864 
0 0 0 0 0 0 0 549 
0 0 0 0 0 0 80 331 
0 0 0 0 0 0 0 192 
