332 28 0 0 0 0 32 0 
60 0 0 0 0 0 0 54 
0 0 0 1170 517 0 0 0 
0 0 0 1443 819 0 0 0 
169 0 0 0 0 0 0 218 
0 0 0 0 0 0 0 0 
0 0 0 0 0 0 0 0 
172 523 606 294 0 0 0 0 
