0 0 0 0 0 0 0 0 
0 0 0 0 0 0 0 0 
0 429 0 0 0 0 0 0 
39 322 0 0 189 152 0 0 
243 509 0 0 0 0 0 0 
0 74 0 0 0 0 0 0 
0 0 0 0 0 0 0 0 
0 0 0 399 103 262 0 0 
