0 0 0 0 0 0 0 0 
0 0 0 0 0 0 0 0 
0 552 0 0 0 0 0 0 
146 373 0 0 0 0 0 0 
0 0 0 0 494 398 0 0 
0 344 668 458 905 183 0 0 
14 170 123 87 113 0 0 0 
0 0 0 0 0 0 0 0 
