0 0 0 0 0 0 0 0 
0 0 0 0 0 0 0 0 
0 0 442 51 0 170 0 0 
0 0 189 392 0 32 416 0 
0 0 0 134 0 0 143 0 
0 0 0 15 10 0 0 0 
0 0 0 133 0 0 0 71 
0 0 0 0 0 0 0 0 
