0 0 0 543 96 0 0 0 
0 0 407 738 372 0 0 0 
193 113 0 0 0 0 0 3 
218 0 0 0 0 0 0 0 
40 0 0 245 714 2 0 0 
0 126 188 283 84 0 0 0 
95 109 0 0 0 0 0 0 
41 0 0 114 0 119 0 0 
