539 0 0 0 0 0 0 0 
0 0 0 0 0 0 0 0 
0 0 0 0 0 0 0 0 
0 0 169 36 0 0 0 0 
166 0 0 0 0 542 1384 478 
0 0 0 0 73 1388 344 29 
0 0 78 560 1406 359 0 0 
447 186 532 1053 861 302 289 433 
