0 0 0 0 0 0 0 0 
0 0 0 0 0 0 0 0 
0 0 0 0 0 0 0 0 
0 0 0 0 0 0 0 0 
0 0 0 0 0 516 68 0 
0 0 0 317 1040 552 0 0 
0 0 0 729 787 0 0 0 
0 0 0 307 0 0 0 222 
