690 0 0 50 22 185 558 0 
585 77 545 726 143 296 287 0 
198 0 446 776 173 270 263 210 
0 0 0 0 0 0 321 646 
282 0 0 0 0 0 755 1056 
375 0 0 0 0 0 705 608 
0 0 0 0 0 256 63 145 
281 485 0 0 194 25 0 0 
