0 0 0 0 0 0 0 0 
0 0 0 0 0 0 0 0 
0 0 0 0 0 0 0 0 
439 0 0 0 0 0 0 0 
0 0 0 0 0 0 0 0 
0 0 0 0 0 255 19 0 
83 59 0 0 136 0 0 0 
0 0 0 0 0 0 0 118 
