279 792 508 430 249 130 457 670 
657 973 560 739 443 25 553 692 
0 0 0 0 0 0 249 801 
0 0 0 0 0 0 0 496 
0 0 0 0 0 0 0 0 
0 0 0 0 0 0 0 0 
0 0 0 0 0 0 0 0 
0 0 0 0 0 0 0 0 
