268 0 0 0 0 0 0 204 
0 0 0 0 0 0 0 0 
0 0 0 0 0 0 0 0 
410 0 0 0 0 0 0 0 
240 0 0 0 0 0 0 0 
0 0 0 0 0 0 0 0 
0 0 0 0 0 0 0 0 
0 0 208 372 230 832 692 345 
