511 362 282 336 451 472 515 669 
502 835 250 351 3 0 0 621 
168 1546 350 0 0 0 0 476 
0 592 0 0 0 0 0 129 
0 0 0 0 0 0 0 0 
0 0 0 0 0 57 0 200 
8 151 0 0 426 508 271 17 
0 0 0 0 111 188 0 0 
