63 0 0 0 0 427 648 0 
624 407 502 0 0 664 614 0 
242 0 0 0 0 160 560 0 
0 0 0 0 0 0 175 0 
0 0 0 20 0 0 0 143 
0 0 0 0 0 0 216 353 
0 0 0 0 0 0 0 74 
0 0 0 39 519 0 0 110 
