0 0 370 613 534 383 350 0 
0 0 0 0 0 0 0 0 
0 0 0 0 64 0 119 0 
0 0 0 0 0 0 0 0 
0 0 0 0 10 0 0 0 
0 0 0 51 765 164 0 0 
0 0 0 497 836 0 0 0 
0 0 13 516 470 0 0 0 
