635 0 0 45 251 242 0 0 
0 0 0 0 0 337 2 0 
0 0 0 0 142 322 305 0 
0 0 0 0 199 0 0 0 
0 0 0 0 0 0 0 0 
0 0 0 0 0 0 0 0 
0 0 0 0 0 0 0 0 
0 0 62 74 0 0 0 0 
