0 0 0 0 0 0 0 14 
0 0 0 0 0 0 0 0 
0 0 0 0 134 0 0 0 
0 0 0 0 1085 312 0 0 
0 0 0 0 673 453 0 0 
0 0 264 447 374 267 0 0 
0 0 645 590 0 389 0 0 
0 0 122 0 0 0 0 0 
