0 0 0 0 0 0 0 0 
0 0 963 775 855 613 0 0 
481 0 126 75 230 1211 856 0 
0 0 0 0 0 453 565 0 
0 0 0 0 0 0 0 0 
0 0 0 0 0 0 0 0 
0 0 0 0 0 0 0 0 
0 0 0 0 0 0 0 0 
