0 0 0 0 0 0 0 0 
0 0 109 0 0 0 0 0 
0 0 131 0 152 131 0 0 
11 645 769 0 200 0 0 0 
0 657 908 0 0 0 613 266 
37 277 97 0 0 727 982 66 
0 0 0 0 0 1204 688 0 
0 0 20 44 658 723 106 0 
