0 0 0 0 0 0 0 0 
0 0 453 260 352 644 0 0 
1289 150 278 221 98 1567 526 0 
0 0 0 0 0 316 0 0 
0 0 0 116 0 0 0 0 
250 0 0 0 0 0 0 399 
0 0 0 0 0 0 0 95 
0 0 0 0 0 0 0 0 
