523 310 420 336 331 201 240 903 
0 0 0 0 0 0 0 0 
0 78 0 0 0 0 0 0 
0 11 0 0 0 0 0 0 
0 0 360 0 0 0 299 0 
0 327 793 0 0 837 839 0 
114 438 543 615 1825 1316 350 0 
0 0 84 1118 1189 211 421 165 
