0 0 93 165 164 0 0 0 
856 0 0 0 509 552 301 0 
1038 0 0 0 49 141 461 0 
526 201 0 0 0 0 0 0 
0 0 0 0 0 0 0 0 
0 0 0 0 0 0 0 0 
0 0 0 0 0 0 0 0 
0 0 0 0 0 0 0 0 
