0 0 0 0 0 0 0 0 
80 0 0 0 0 0 159 0 
0 0 0 0 0 0 0 0 
0 0 0 126 0 0 0 0 
0 0 0 112 59 0 0 0 
478 377 0 30 0 0 0 0 
34 0 0 0 0 0 0 0 
0 0 0 0 0 0 0 250 
