37 0 0 312 354 309 8 0 
470 556 0 0 0 242 449 718 
0 0 0 0 0 0 0 158 
0 0 0 0 0 0 0 6 
0 0 0 0 0 0 0 0 
0 0 0 0 0 0 0 607 
0 0 0 0 0 0 0 90 
0 0 0 0 0 0 0 0 
