544 0 0 0 0 0 29 498 
0 0 0 0 0 0 0 0 
0 0 0 0 0 0 0 0 
0 0 0 0 0 0 0 0 
310 0 0 0 0 149 91 0 
0 0 0 0 0 399 0 0 
0 0 0 81 655 93 0 0 
0 0 0 429 0 0 0 0 
