0 171 14 236 0 2 220 0 
0 0 0 0 0 0 0 0 
0 0 0 288 0 0 0 0 
0 0 0 0 0 0 0 690 
0 0 0 0 0 0 0 706 
0 0 0 0 0 0 89 133 
0 0 0 0 0 0 0 0 
0 291 163 0 233 0 0 0 
