682 109 0 127 209 115 362 430 
0 0 0 0 0 0 0 0 
0 0 0 0 0 0 0 0 
0 0 0 0 0 0 0 0 
124 0 0 0 0 0 0 0 
0 0 0 0 0 0 0 0 
0 196 594 180 5 0 0 0 
105 70 356 244 0 0 0 0 
