0 0 0 0 0 0 0 0 
0 0 0 746 243 0 117 323 
0 498 0 0 0 0 40 804 
0 673 0 10 213 0 0 135 
0 148 0 266 727 0 0 0 
0 393 0 499 749 0 0 0 
0 48 521 326 0 0 0 0 
0 0 182 0 0 0 0 0 
