0 0 0 0 0 0 0 0 
0 0 0 0 0 0 0 0 
0 0 0 213 0 0 0 0 
0 0 141 1455 6 0 0 0 
0 0 0 677 0 0 0 0 
0 0 0 0 11 0 0 0 
0 0 0 513 21 0 0 0 
0 0 465 494 0 0 0 0 
