0 0 0 0 0 0 0 0 
0 0 0 0 0 0 0 0 
0 0 0 0 0 0 0 0 
0 148 0 0 554 733 51 0 
0 166 0 0 370 351 0 0 
0 60 0 0 503 0 40 0 
0 0 0 42 201 0 0 0 
0 0 0 42 0 0 0 0 
