0 0 0 0 0 0 0 0 
0 0 0 0 0 0 0 0 
0 0 0 0 0 0 0 0 
0 0 0 0 71 0 0 0 
27 0 0 166 596 0 0 0 
0 220 0 21 0 0 0 9 
0 0 0 0 0 532 0 0 
0 0 0 0 0 159 0 0 
