388 139 104 84 103 121 124 64 
291 59 105 0 81 259 228 0 
444 434 0 0 0 268 380 126 
0 60 0 57 0 0 68 68 
78 0 38 163 0 0 164 0 
101 0 40 119 0 0 42 0 
0 0 0 0 0 0 80 24 
0 56 0 65 76 118 132 38 
