67 0 0 0 0 0 0 586 
0 16 138 0 0 0 0 355 
41 431 417 0 26 0 4 371 
154 448 336 0 240 290 82 368 
0 255 48 0 264 260 371 330 
17 87 0 0 0 0 274 0 
0 0 0 0 0 195 206 0 
0 0 0 0 105 105 0 41 
