35 0 0 0 0 0 0 10 
0 0 448 457 77 0 0 46 
0 0 43 337 0 25 0 99 
158 167 0 0 0 0 0 96 
270 323 0 0 27 0 0 0 
305 195 0 149 141 0 0 0 
108 127 0 125 0 0 0 0 
0 0 39 1 0 0 0 0 
