20 0 0 0 0 0 0 80 
0 0 246 288 243 90 0 0 
560 0 0 227 235 432 366 155 
614 326 47 0 0 0 104 85 
5 0 0 0 0 23 57 21 
0 0 0 147 0 76 0 0 
0 6 0 92 111 0 9 69 
82 0 0 0 129 59 55 213 
