401 293 302 250 274 276 260 164 
419 169 0 0 0 150 180 176 
165 54 0 16 11 0 14 75 
137 0 0 0 0 0 0 0 
200 81 0 0 0 0 0 0 
114 45 0 0 0 0 0 4 
0 39 51 0 31 145 0 0 
229 190 177 189 363 253 179 137 
