0 0 0 0 0 0 0 0 
0 0 0 0 0 0 0 0 
0 3 0 0 70 0 17 0 
0 0 0 47 203 164 111 0 
0 72 125 17 209 447 0 0 
1 168 124 38 401 425 118 0 
100 120 5 214 220 30 224 46 
0 0 0 129 0 91 162 0 
