0 0 0 0 0 0 0 0 
0 0 0 0 0 0 0 0 
0 0 0 0 0 0 0 19 
78 9 0 129 0 71 27 0 
151 0 0 70 60 91 0 0 
68 101 41 34 38 0 0 25 
70 0 0 0 0 0 0 101 
0 0 0 0 0 0 50 68 
