0 0 0 0 0 0 0 0 
0 0 0 0 0 0 0 0 
81 0 0 111 256 330 191 0 
265 278 106 155 233 470 409 9 
137 71 92 69 272 411 314 15 
14 0 131 268 288 347 189 0 
0 0 88 266 283 154 47 43 
0 0 0 258 175 0 214 89 
