0 0 0 0 0 0 0 0 
145 6 88 0 4 168 120 0 
225 178 33 0 0 205 180 0 
0 0 339 339 80 101 129 0 
0 0 417 263 193 165 43 47 
0 0 325 230 137 161 316 204 
66 0 0 25 19 99 413 107 
12 0 0 52 0 293 231 20 
