548 76 68 36 26 23 23 0 
402 0 161 0 0 12 0 0 
90 0 251 0 0 73 0 0 
0 0 49 0 0 0 330 130 
258 0 92 0 0 15 378 118 
222 0 0 0 0 32 0 38 
67 0 0 0 0 97 0 50 
147 0 0 0 99 0 0 27 
