886 173 204 190 197 185 154 348 
737 0 0 0 0 0 0 50 
482 150 426 316 308 377 233 0 
550 236 192 0 273 238 279 119 
253 138 293 0 141 107 108 138 
331 95 66 0 126 189 74 159 
229 59 100 112 210 137 0 35 
215 69 11 86 83 61 37 26 
