255 196 175 181 175 175 171 171 
75 0 62 31 0 23 0 0 
0 0 0 0 40 7 0 0 
167 0 0 53 68 36 74 175 
65 0 51 0 0 160 377 33 
0 11 36 0 23 1004 846 174 
170 116 68 0 1378 1282 82 0 
180 174 0 706 1257 275 138 0 
