0 0 0 0 0 0 0 0 
0 0 227 0 0 0 0 0 
50 0 486 395 34 241 95 0 
181 0 44 95 0 121 433 0 
24 0 294 112 155 0 0 0 
0 0 0 191 37 0 0 41 
0 0 0 103 62 0 0 44 
32 0 0 0 0 0 0 210 
