0 0 0 0 0 0 0 65 
0 0 482 389 199 223 36 51 
175 111 611 287 0 158 95 311 
0 350 566 1 0 79 151 353 
29 0 162 24 21 400 300 186 
92 68 200 128 117 268 102 182 
352 426 324 49 28 0 299 204 
367 132 0 6 0 94 152 168 
