742 590 519 503 493 480 603 492 
606 320 157 169 218 258 484 495 
293 257 0 0 0 0 268 317 
0 0 0 88 0 0 0 91 
371 235 0 0 0 0 0 282 
229 239 0 0 0 0 0 208 
258 81 0 0 0 68 37 276 
0 50 95 0 85 163 0 215 
