0 0 0 0 0 0 0 0 
0 0 0 0 0 0 0 0 
0 149 193 0 325 293 0 0 
83 52 105 187 302 379 234 26 
0 0 188 263 259 246 147 74 
0 0 108 193 232 190 84 159 
0 0 0 0 0 14 155 165 
0 0 0 139 193 0 277 241 
