0 0 0 0 0 0 0 0 
0 34 143 237 195 14 0 0 
102 0 0 0 0 93 43 35 
0 0 0 0 0 0 0 0 
145 258 0 0 0 0 0 0 
0 43 0 0 0 0 0 0 
90 270 158 0 70 0 0 0 
83 124 22 0 0 0 0 39 
