290 84 57 33 66 110 93 190 
348 271 89 100 69 74 146 259 
201 355 0 0 0 0 109 234 
0 0 0 0 0 0 0 0 
0 70 0 0 0 0 0 0 
0 10 0 0 0 0 191 71 
87 7 0 0 0 207 82 33 
0 0 0 0 52 136 0 0 
