0 0 0 0 0 0 0 0 
0 0 0 0 0 0 0 0 
0 0 30 0 0 0 0 0 
314 308 199 0 64 224 89 84 
0 0 0 0 0 207 211 1 
0 0 0 0 0 292 28 0 
0 0 0 35 159 0 168 232 
91 0 0 224 0 91 231 51 
