0 0 0 0 0 0 0 0 
0 0 0 0 0 0 0 43 
0 282 424 84 0 0 0 28 
0 0 232 312 17 1 18 0 
0 0 191 145 140 74 134 101 
0 0 178 152 78 0 169 96 
0 0 0 0 0 156 261 102 
0 0 0 0 45 43 40 0 
