0 0 0 0 0 0 0 0 
0 0 0 0 25 0 0 0 
0 61 190 134 0 13 0 0 
1 128 143 111 0 272 0 0 
0 16 27 21 0 393 174 50 
0 0 127 143 349 339 7 86 
0 0 277 177 234 0 301 144 
0 53 0 12 0 131 243 0 
