0 0 0 0 0 0 0 0 
0 0 0 0 0 0 0 0 
0 0 0 67 233 0 35 0 
134 0 49 190 492 174 23 0 
101 0 208 47 432 64 299 0 
0 0 0 120 231 415 181 65 
0 0 0 117 350 264 0 121 
0 0 0 117 149 0 61 93 
