0 0 0 0 0 0 71 312 
0 94 0 0 0 0 0 137 
0 426 0 0 97 0 0 0 
0 339 0 0 0 0 0 80 
0 587 59 0 0 0 0 168 
0 367 56 0 0 0 34 0 
0 18 123 0 0 178 271 0 
0 0 93 0 0 0 0 0 
