0 0 0 0 0 0 0 0 
0 0 0 0 55 128 0 0 
0 250 81 0 70 76 0 0 
0 66 292 151 34 93 0 34 
0 342 428 39 12 145 267 110 
0 186 186 0 39 96 335 169 
0 0 0 0 205 110 106 108 
0 0 0 0 0 60 39 118 
