283 330 227 194 204 283 356 484 
108 102 0 0 0 0 157 241 
0 0 6 199 3 0 0 0 
56 122 0 130 0 75 0 0 
352 369 0 0 0 23 127 73 
69 9 0 0 0 0 0 0 
26 30 35 70 0 0 0 0 
0 41 58 182 0 0 0 0 
