60 8 62 30 18 70 16 0 
0 0 245 45 33 103 18 0 
67 0 254 0 168 101 145 0 
129 0 162 0 50 319 476 44 
34 0 316 82 0 47 22 35 
63 0 194 266 0 0 0 111 
59 0 6 202 0 0 1 126 
0 0 42 94 0 0 139 201 
