0 0 0 0 0 0 0 36 
0 0 0 0 0 0 0 0 
0 0 212 0 0 67 0 0 
194 0 192 60 129 160 146 0 
0 2 241 7 0 77 74 0 
0 0 174 32 10 29 0 0 
0 0 144 119 0 0 57 79 
0 0 0 31 0 0 123 58 
