180 251 236 240 259 261 299 438 
0 347 0 52 100 80 9 21 
0 543 0 149 174 0 3 0 
26 277 0 0 123 0 57 2 
0 395 48 0 0 0 142 0 
0 322 95 0 56 30 0 0 
0 0 112 0 262 0 72 0 
0 0 46 33 258 203 258 0 
