0 0 0 0 0 0 0 0 
0 0 0 0 0 0 0 0 
0 0 0 399 201 109 0 0 
138 0 0 0 0 109 111 131 
0 78 0 0 0 0 0 0 
0 50 13 147 46 20 0 0 
0 189 291 252 257 273 0 0 
52 213 104 123 63 0 63 0 
