0 0 0 3 23 15 120 224 
0 224 0 113 79 0 80 237 
262 248 38 133 168 18 108 108 
189 63 0 66 161 0 0 0 
0 220 67 96 174 0 0 0 
0 0 0 69 63 0 0 0 
0 0 0 85 0 0 0 0 
0 0 56 0 0 0 0 21 
