0 0 0 0 0 0 0 0 
0 0 0 65 17 0 0 0 
0 0 328 320 173 359 66 0 
80 0 0 0 0 196 18 165 
0 0 0 13 0 0 0 0 
0 0 0 195 0 0 0 0 
0 0 0 180 0 0 0 0 
0 0 5 0 0 0 0 0 
