0 0 0 0 0 0 0 0 0 0 0 0 0 0 0 40
0 0 0 0 0 0 0 0 0 0 0 0 0 0 0 0
0 0 0 0 0 0 0 0 0 0 0 0 0 0 0 0
0 0 0 0 31 70 47 42 55 47 33 0 0 0 0 0
16 0 0 0 71 49 3 0 0 0 17 36 36 0 0 0
65 87 0 0 16 0 9 0 0 0 29 35 10 2 6 19
51 69 30 69 55 0 0 0 0 0 8 0 27 31 20 25
0 0 46 60 0 23 0 0 0 0 0 40 16 13 0 61
0 4 0 0 21 4 0 0 0 20 28 63 43 0 73 68
4 0 0 0 10 0 0 2 0 0 84 27 17 0 37 0
0 0 2 3 8 0 17 0 0 20 0 30 0 47 29 0
4 0 0 0 31 20 5 0 0 0 39 11 22 29 0 0
3 0 0 12 59 36 14 23 7 75 0 39 3 40 6 0
0 37 45 38 17 0 0 0 16 0 30 19 55 3 0 8
31 46 0 0 0 0 8 36 18 26 24 5 56 0 3 16
16 0 0 0 0 0 0 0 35 14 0 42 5 22 27 0
