98 0 0 0 0 0 0 0 0 0 0 0 0 0 0 0
93 0 0 0 0 0 0 0 0 0 0 0 0 0 0 0
92 0 0 0 0 0 0 0 0 0 0 0 0 0 0 0
93 0 0 0 0 39 50 54 59 78 25 16 0 0 0 0
107 0 0 0 0 0 0 0 0 10 39 54 58 0 0 0
138 126 0 0 0 0 0 0 0 6 0 10 86 27 3 0
0 112 65 0 0 0 0 0 0 13 0 0 24 0 15 0
48 0 0 0 0 0 0 0 8 31 0 0 9 58 0 0
56 0 0 0 0 0 0 0 3 31 0 0 36 60 0 0
47 0 0 0 0 1 14 0 0 22 2 0 20 17 0 0
50 0 0 0 0 0 11 4 10 0 19 26 0 0 0 0
41 0 0 0 0 0 6 0 0 9 29 41 0 0 0 0
38 0 0 0 0 0 25 21 33 26 18 0 0 0 19 0
40 0 0 0 0 0 5 0 0 9 0 0 0 0 0 0
44 0 0 0 0 0 2 6 0 0 0 0 0 0 0 0
19 31 29 34 33 33 37 36 66 83 86 63 69 51 57 66
