106 21 23 21 21 21 23 22 22 19 30 20 20 18 18 8
67 4 6 2 0 1 3 3 2 1 6 3 3 2 0 0
67 3 6 0 3 1 3 2 2 2 0 3 2 2 0 0
67 1 4 2 4 0 0 0 0 13 1 22 2 0 0 0
69 32 0 7 0 0 0 9 22 50 40 71 17 20 0 0
41 51 35 8 0 5 4 30 32 62 1 44 34 72 0 0
16 146 75 0 0 0 21 34 37 56 32 82 41 35 0 0
55 69 0 37 0 1 20 29 24 87 66 21 49 99 74 8
56 19 19 36 0 1 34 22 29 93 36 0 21 120 0 0
46 10 14 16 0 39 58 0 27 68 70 0 78 153 0 0
47 26 28 13 0 22 27 13 32 13 61 84 158 88 24 2
46 0 17 24 0 17 43 7 17 37 22 148 119 0 29 0
28 21 26 0 0 0 16 0 5 0 186 163 0 0 35 0
50 22 0 0 0 0 10 2 13 158 171 21 0 34 68 0
44 0 7 10 1 2 14 8 136 147 26 27 0 82 47 0
0 11 0 8 2 6 8 107 128 0 12 0 50 52 0 0
