3 0 0 0 0 0 0 0 0 0 0 0 0 0 0 0
0 0 0 0 0 0 0 0 0 0 0 0 0 0 0 0
0 0 0 0 0 0 0 0 0 0 0 0 0 0 0 0
0 0 0 0 0 3 7 9 8 11 5 1 0 0 0 0
0 0 0 0 0 46 30 28 23 11 26 0 2 0 0 0
9 0 0 0 0 18 2 0 0 2 35 44 14 0 4 0
19 9 0 25 25 30 9 0 0 0 42 10 6 30 42 21
0 0 0 47 0 24 23 0 5 16 0 0 18 11 0 0
0 0 0 0 4 37 14 0 19 6 0 25 44 6 6 30
0 2 2 0 5 40 0 28 22 8 53 45 64 0 32 25
0 0 0 0 20 52 22 33 13 40 58 22 67 0 31 0
0 19 14 11 45 56 38 22 19 37 79 22 0 28 34 0
0 4 0 3 35 48 32 30 26 96 100 0 0 38 17 0
0 5 58 65 55 41 27 30 36 67 0 0 10 54 9 0
21 69 66 38 15 17 13 32 29 0 0 0 63 40 0 22
31 38 24 20 20 16 39 31 1 40 41 71 72 46 49 28
