149 27 24 27 26 27 27 29 32 31 29 34 30 33 32 44
118 10 7 11 10 11 7 11 10 13 11 14 8 9 10 13
121 12 9 14 13 15 11 13 12 12 10 6 4 5 8 13
124 13 12 12 7 0 0 0 0 0 0 15 15 6 7 15
119 22 13 7 63 0 0 0 0 0 6 0 0 12 4 14
51 0 21 6 86 0 15 0 3 8 24 0 8 12 0 1
4 17 12 0 69 0 20 4 0 4 45 26 25 47 0 38
63 36 0 60 53 0 17 7 5 11 53 24 47 53 23 27
81 7 8 15 42 0 10 2 0 7 36 0 0 0 46 0
72 0 0 2 46 0 5 22 0 5 0 0 21 0 30 21
72 0 0 0 46 0 0 11 0 0 17 24 16 6 23 20
74 0 0 0 23 0 0 4 0 0 22 6 13 4 0 19
75 4 0 0 0 0 18 12 0 12 20 6 8 4 5 22
67 0 0 0 14 8 8 21 9 0 3 0 0 0 17 25
27 0 4 9 11 14 12 24 0 2 9 0 8 0 14 1
9 0 5 0 5 4 5 0 0 4 0 10 27 17 10 24
