164 130 131 129 124 123 123 119 118 120 118 113 115 113 112 116
103 79 77 74 71 69 68 63 61 62 63 58 55 50 51 83
101 75 71 69 68 72 72 68 68 62 59 56 56 53 54 82
95 68 67 79 67 75 71 61 56 49 42 49 50 50 50 79
83 60 60 74 33 51 32 28 25 11 16 38 44 45 44 75
52 45 53 63 37 11 0 0 0 0 3 45 42 39 45 74
15 25 64 26 52 12 3 0 0 0 5 23 24 18 44 68
23 24 21 23 31 1 7 0 0 2 21 1 0 11 39 44
34 17 19 17 5 9 1 0 1 4 12 0 6 37 33 12
35 14 14 12 5 3 1 0 7 0 0 0 9 20 6 16
31 9 10 8 0 12 10 0 3 0 0 20 53 32 6 10
29 12 8 0 16 24 26 17 20 18 0 38 45 1 7 4
24 9 10 15 18 15 12 11 11 4 48 35 12 6 9 4
26 7 21 35 29 14 7 8 1 23 50 7 3 14 4 5
23 21 18 17 18 16 12 0 23 31 5 9 1 9 0 5
36 43 33 28 27 28 24 31 39 13 23 8 21 15 6 6
