40 0 0 0 0 0 0 0 0 0 0 0 0 0 0 64
0 0 0 0 0 0 0 0 0 0 3 0 0 0 0 0
0 0 0 0 0 0 0 0 0 0 0 0 0 0 0 0
0 0 0 0 23 0 0 0 0 0 5 0 0 0 0 0
0 0 0 0 117 28 3 5 27 0 11 0 0 2 0 0
0 0 4 0 114 32 13 0 26 8 74 0 48 0 0 0
61 104 0 43 92 25 30 3 21 0 44 26 90 45 0 0
15 101 8 62 44 3 30 11 20 7 59 0 92 15 20 0
0 0 0 0 88 22 11 11 15 24 4 35 59 0 23 0
0 0 0 0 74 33 0 39 15 31 0 39 89 0 17 0
0 0 0 0 91 23 15 21 19 24 7 0 54 0 22 0
0 0 0 0 44 15 19 16 23 0 48 0 0 19 24 0
0 0 0 0 14 29 50 25 0 11 18 0 0 47 0 0
0 0 0 0 7 7 8 21 21 0 0 0 27 32 30 0
0 0 8 0 0 18 17 1 20 0 0 0 48 33 10 0
0 0 7 0 0 0 9 6 0 3 0 0 19 37 0 0
