1 0 0 0 0 0 0 0 0 0 7 2 0 0 0 51
0 0 0 0 0 0 0 0 0 0 0 0 0 0 0 41
0 0 0 0 0 0 0 0 0 0 0 0 0 0 0 43
0 0 0 8 22 34 26 21 9 43 25 0 0 0 0 41
24 0 0 16 2 0 0 0 0 16 42 0 25 0 0 41
30 43 0 10 47 51 0 6 0 49 37 0 30 16 29 26
0 47 39 108 56 51 25 12 0 45 105 0 70 36 25 0
0 23 0 53 12 7 21 7 0 56 74 0 60 0 0 26
0 0 0 2 58 7 0 0 1 61 14 0 42 67 0 54
0 0 0 6 61 19 8 21 0 29 0 0 62 4 33 22
0 0 0 4 65 20 22 23 0 10 59 0 45 0 36 10
0 0 0 0 43 24 56 21 0 27 44 0 0 19 35 14
0 0 0 10 25 9 57 29 5 19 36 0 0 31 4 5
0 0 1 0 0 0 17 5 0 14 0 0 0 24 22 20
0 0 0 0 0 1 16 17 0 0 0 0 12 22 0 34
0 2 13 12 6 12 12 1 0 7 0 0 48 21 0 27
