53 0 0 0 0 0 0 0 0 1 0 6 0 1 0 57
22 4 2 4 1 0 3 1 1 3 7 2 4 5 0 17
25 4 4 5 2 1 3 1 1 2 0 1 1 2 1 16
26 5 2 3 52 0 0 0 10 19 32 19 0 0 1 15
35 16 0 9 124 9 0 0 11 53 9 40 0 9 1 14
29 40 19 17 114 38 1 0 14 67 70 23 16 82 0 38
72 37 61 103 97 44 5 4 22 67 53 87 0 146 14 55
24 32 28 47 123 23 1 2 23 11 71 65 33 71 53 68
35 4 0 13 88 0 13 12 17 66 79 97 32 104 59 18
23 3 1 8 92 1 57 8 8 12 84 95 6 124 43 32
20 10 6 6 78 10 42 0 35 21 37 90 62 109 7 46
34 2 1 32 70 47 36 18 13 97 0 79 58 50 29 20
26 10 12 20 14 23 52 0 28 42 91 98 74 0 22 30
21 21 18 0 1 2 25 0 25 41 86 6 88 0 57 16
53 0 0 5 3 0 22 0 21 79 0 75 56 28 36 2
22 10 5 0 2 0 8 9 39 5 6 43 48 42 15 14
