0 0 0 0 0 0 0 0 0 0 0 0 0 0 0 31
0 0 0 0 0 0 0 0 0 0 0 1 0 0 0 0
0 0 0 0 8 14 17 16 18 7 0 0 0 0 0 0
0 0 0 6 14 0 0 0 0 0 0 0 0 0 0 0
0 2 0 0 33 76 82 82 81 66 43 7 0 0 0 4
16 0 2 10 11 0 13 9 12 19 29 64 31 0 0 0
39 67 6 0 18 5 7 0 0 0 49 18 11 35 77 77
15 42 94 109 59 0 5 0 0 23 38 0 27 104 104 46
0 0 2 0 9 14 15 3 0 9 53 0 14 32 17 27
4 10 47 51 12 19 15 0 0 2 43 37 44 14 15 0
41 52 14 9 2 0 0 10 0 20 67 54 86 0 30 6
10 22 28 26 72 15 35 26 16 20 42 43 0 0 15 2
11 7 10 23 18 24 20 47 27 84 78 0 1 28 2 0
8 0 34 66 74 29 17 13 9 45 0 10 0 31 36 0
17 63 62 18 2 0 0 37 41 0 7 0 41 30 0 4
53 21 0 3 0 0 33 79 0 0 0 16 25 12 36 1
