18 1 2 2 3 0 0 3 0 1 5 0 4 2 5 5
14 0 1 0 1 0 0 0 1 0 4 7 0 0 0 0
13 0 0 0 0 0 0 0 0 2 0 0 0 0 0 0
12 1 0 0 31 18 15 14 21 22 0 0 0 0 0 0
13 0 0 0 5 45 50 55 49 65 46 21 1 1 0 0
78 30 5 0 0 2 14 12 0 16 21 40 78 21 9 0
63 119 38 46 53 8 3 5 19 22 18 12 21 32 42 23
0 40 91 48 77 28 14 4 24 17 10 28 0 10 10 2
11 0 12 13 0 14 2 21 26 21 6 26 37 29 10 2
12 15 6 13 8 18 21 14 11 37 41 10 14 27 20 0
21 14 5 11 0 13 29 21 0 19 45 11 0 9 10 12
18 17 11 16 14 20 0 18 26 32 39 39 0 2 19 0
10 6 10 19 18 0 32 22 27 10 8 2 0 20 7 1
5 8 2 15 26 6 0 0 0 0 0 0 18 21 62 0
8 6 5 0 0 0 4 0 0 3 0 0 8 37 5 3
13 2 0 3 0 0 15 10 13 2 0 2 15 28 55 9
