81 60 62 65 66 68 69 71 72 73 73 78 74 75 75 135
13 10 10 11 8 9 9 8 5 6 7 2 7 7 5 55
14 10 10 8 11 14 14 13 15 13 9 7 2 0 0 55
19 12 12 10 7 0 0 0 0 0 8 5 8 3 3 58
13 13 11 24 3 0 0 0 0 0 0 0 0 6 5 59
0 3 14 24 0 0 0 0 0 0 0 0 0 0 0 44
0 0 12 1 0 0 0 0 0 4 5 36 0 0 0 0
63 56 0 2 3 0 0 0 0 5 44 21 31 84 107 75
40 30 35 42 0 0 0 0 0 4 5 0 0 13 0 5
0 0 0 0 0 0 9 0 0 0 0 0 0 37 0 11
18 4 9 1 0 0 0 0 0 0 2 0 101 67 0 21
0 0 0 0 0 0 0 0 0 0 0 90 111 0 0 23
0 0 0 0 0 0 0 0 0 0 124 118 0 0 0 20
0 0 0 0 0 0 3 7 2 124 144 0 0 0 14 8
0 0 0 0 0 0 0 0 141 120 0 0 0 0 15 0
0 0 0 0 0 1 11 74 137 0 0 0 0 5 0 17
