0 0 0 0 0 0 0 0 0 0 0 0 0 0 0 0
0 0 0 0 0 0 0 0 0 0 0 0 0 0 0 0
0 0 0 0 0 0 0 0 0 0 0 0 0 0 0 0
0 0 0 0 0 0 0 0 0 0 0 0 0 0 0 0
0 0 0 0 33 62 61 56 51 27 15 0 0 0 0 0
2 0 1 0 11 14 2 0 0 11 17 40 19 0 0 0
63 9 0 0 0 0 0 0 0 0 0 30 23 52 65 30
24 75 65 34 59 0 2 2 0 0 1 0 12 39 60 15
0 0 0 0 0 3 16 2 2 0 0 4 0 0 0 0
0 9 10 10 23 0 0 1 0 0 1 32 6 11 0 3
22 4 0 0 0 14 9 0 0 3 27 9 1 0 0 1
24 10 2 0 14 20 34 29 16 13 5 0 0 0 0 3
4 4 0 0 0 34 70 50 50 38 0 0 0 0 0 1
0 0 30 37 39 10 35 41 39 0 0 0 0 27 29 2
20 31 32 14 12 17 33 16 0 0 0 0 0 0 0 6
27 8 8 5 1 0 0 0 0 0 0 2 0 28 17 0
