15 0 0 0 0 0 0 0 0 0 0 0 0 0 0 56
4 0 0 0 0 0 1 0 3 0 0 11 5 6 2 45
5 0 0 0 0 0 7 8 6 6 5 4 3 6 4 45
10 1 0 5 7 15 26 22 21 21 9 15 5 6 7 47
37 15 3 9 44 26 23 24 35 50 22 31 15 7 11 51
71 23 2 14 51 12 11 9 22 37 23 30 47 47 19 61
12 90 59 13 115 17 12 4 19 37 42 35 0 51 20 52
22 0 21 85 54 33 8 14 30 47 52 79 0 65 9 43
10 22 14 26 48 26 17 21 28 50 52 30 0 55 14 59
14 18 20 25 47 16 44 17 23 37 37 27 0 36 32 42
13 22 15 23 55 15 54 32 23 20 49 66 0 30 18 43
10 21 19 13 49 19 28 21 33 47 18 41 15 21 20 41
17 21 22 17 15 7 31 28 33 33 0 18 24 15 27 42
19 19 9 16 23 22 17 14 17 5 11 28 29 25 41 46
32 19 19 14 15 6 23 8 4 14 18 24 33 34 24 46
29 19 16 16 13 13 18 11 23 30 39 47 34 24 62 50
