0 0 0 0 0 1 2 3 4 4 5 6 7 7 9 112
0 0 0 0 0 0 0 0 0 0 0 0 0 1 4 103
0 0 0 0 0 0 0 0 0 0 0 0 0 1 4 103
0 0 0 5 0 0 0 0 0 0 0 4 2 1 3 104
0 0 0 26 101 39 0 0 0 0 0 0 2 5 1 106
0 0 0 34 127 60 0 0 0 0 13 0 0 0 0 111
1 0 0 50 119 64 6 0 0 0 33 11 0 0 0 72
17 0 0 34 26 25 11 0 0 0 0 39 20 0 1 94
0 5 3 24 79 35 1 0 0 0 6 62 0 0 62 95
0 0 0 29 74 22 0 21 0 0 24 81 7 0 43 70
0 0 0 28 82 34 0 14 0 3 0 14 5 44 51 60
0 0 1 19 66 29 0 0 0 0 0 0 17 57 19 61
0 0 0 38 52 44 0 0 0 0 0 0 51 58 0 65
0 13 26 20 32 4 1 0 0 0 0 0 65 43 0 64
0 26 13 0 0 1 0 0 0 0 0 27 71 0 25 62
0 0 0 0 0 0 2 0 0 0 2 46 26 1 10 61
