105 96 98 98 98 98 98 99 98 100 100 96 97 97 96 97
0 1 2 2 2 2 2 0 1 1 1 0 0 0 1 0
0 2 1 1 2 2 2 3 3 2 2 3 2 2 3 0
0 1 0 6 18 46 54 54 53 39 13 6 1 1 0 0
4 1 1 1 0 0 0 0 0 0 16 34 30 5 0 0
23 25 0 0 0 0 1 0 0 0 0 0 0 28 41 28
0 0 54 35 11 4 3 0 11 15 11 2 5 0 0 0
0 0 0 0 0 1 0 0 3 6 16 5 16 34 57 46
13 50 62 45 7 0 0 0 0 8 15 1 18 24 21 0
2 20 18 0 0 0 9 10 7 14 18 13 24 0 0 0
28 40 32 41 0 1 0 2 5 0 10 0 17 6 2 1
0 0 0 0 8 21 25 33 16 28 13 0 22 3 0 0
0 0 28 52 31 12 0 4 18 1 0 19 0 4 15 0
13 13 12 0 10 8 14 11 6 9 24 0 0 0 0 0
4 0 5 4 1 1 0 0 2 19 5 6 0 8 19 1
18 20 13 15 15 18 52 89 70 41 42 19 32 35 25 28
