-2222 -4832 -4604 -4833 -4119 -3375 -2828 -2003
-2558 -4313 -1522 -1960 -2397 -2590 -2572 -1854
-1254 -1127 1586 2141 685 297 -1440 -2289
-541 1514 1973 1813 -768 -612 68 -376
-1074 -1856 -2240 -2178 -4576 -4612 -917 663
-1101 -2183 -4212 -5168 -7460 -4996 -2105 -1036
-386 -694 -2687 -6230 -6187 -3600 -3926 -1906
-34 77 -360 -1388 -752 -1515 -2112 -641
