-1027 -1165 -1091 -951 -207 555 245 -904
-2365 -2013 -2681 -1863 -897 -238 -916 -1233
-488 -713 -1400 -639 1252 1422 -17 -1415
-42 -956 -2163 -2961 -1601 148 -500 -2330
-1369 -1280 -2772 -3588 -4101 -1576 -2011 -3717
-341 -281 -2367 -4310 -6104 -4644 -2784 -3244
-760 -1964 -3801 -5356 -6670 -3003 -1253 -2093
-924 -2469 -3807 -4680 -2827 -736 -928 -1059
