-1351 -2866 -1896 -1180 -1444 -1406 -2070 -2158
708 864 683 1805 1344 1713 1967 196
-232 360 1028 2031 1937 410 1312 247
-552 143 158 1057 1852 -495 280 301
1431 1689 -405 -74 -318 -1270 -934 403
172 -227 -1082 -2331 -2925 -3069 -2516 -834
-738 -965 -1693 -3741 -3400 -2273 -3007 -2183
-237 15 -1096 -2119 -390 -676 -2193 -1867
