-1797 -1193 -1731 -1034 -653 -1022 -47 415
-1780 -1036 -2659 -1662 227 -1145 -1630 -79
-1461 -1947 -3624 -2534 327 -2303 -5231 -1245
-399 -1542 -4170 -2415 -291 -2307 -4644 -1218
-514 -381 -4093 -3822 -3289 -1944 -1565 -907
-848 -556 -3572 -4887 -2022 164 -2519 -1759
-317 -454 -2055 -2246 965 356 -2542 -1046
242 40 -459 -56 482 -741 -1839 -924
