-623 -430 -1794 -1444 -804 -805 -777 -339
1 -634 -2432 -2670 -352 53 -1450 -672
-753 -1579 -632 -991 134 -119 -2416 -1076
-1045 -1278 -515 -1833 -2920 -3829 -4584 -1848
-283 -487 -989 -3582 -5963 -6034 -2675 -1228
-1344 -2353 -2733 -4939 -4934 -3606 -96 -330
-1249 -1685 -2224 -3363 -3896 -1616 -1300 -916
63 244 -1037 -2221 -782 401 -227 -175
