-1693 -1460 -778 -651 -1085 -943 -874 -1095
-2950 -1952 -727 -1173 -2901 -3364 -3582 -3199
-1803 -3051 -2857 -3871 -3084 -1679 -2158 -989
-1240 -3311 -2681 -3971 -3036 -993 -2312 -1804
-1691 -1762 -231 -607 -2059 -2917 -3652 -2495
-1210 -2530 -1699 -1054 -1979 -4027 -3115 -1480
-766 -2981 -3796 -1727 -4000 -4624 -1741 -612
-606 -1290 -2128 -3626 -4405 -1695 387 -83
