-2542 -2502 -1399 -1085 -1187 -2276 -2407 -1124
-4624 -6200 -4676 -3143 -3153 -4276 -4115 -2330
-3895 -4529 -3113 -2040 -3186 -3013 -2933 -1100
-2383 -2273 -1052 -95 -2709 -2652 -2221 -484
-496 -1234 -1654 -806 -1412 -1561 -1637 -1207
-602 -1025 -1776 -2019 -1085 -1666 -1823 -76
-1652 -1311 -1977 -2799 -3038 -4568 -2716 -404
-1422 -2221 -2274 -3517 -4640 -3720 -905 -462
