-3841 -3762 -3892 -4179 -3622 -2674 -2287 -1691
-4687 -3405 -2653 -2826 -3262 -3422 -3261 -2518
-1966 -1316 554 313 -1257 -2573 -1837 -1400
-1001 -685 720 725 -453 -2612 -2522 -1247
-2316 36 526 266 -328 -2012 -2022 -676
-2475 -133 -869 -1692 -1622 -1433 469 866
-482 -674 -1114 -1355 -2035 -1230 -36 471
-703 -746 -1152 -2674 -3832 -2228 -1368 -409
