-1317 -2824 -2260 -3210 -2108 -1918 -2524 -1988
-1471 -2024 -890 -3017 -1651 -1478 -1612 -1706
-690 -1661 -235 -918 772 -486 -1446 -1322
-72 -1025 -1055 -1062 121 1763 316 -1477
-442 -100 -1203 -2992 -3417 -475 -1135 -2795
-1267 -1875 -2369 -1980 -3203 -4582 -5376 -4244
-298 -1013 -844 -1341 -4468 -6448 -3471 -1963
214 -21 -497 -1683 -3019 -2060 -364 -358
