-2257 -5439 -4544 -4748 -3954 -2957 -2933 -2462
-4953 -8511 -6616 -8146 -8577 -6347 -6360 -4621
-4919 -5805 -2480 -4424 -6835 -4800 -4065 -3439
-3080 -2343 -1512 -2534 -5306 -2528 -1486 -2041
-1746 -1746 164 -3142 -6642 -2674 -126 -1766
-1489 -2077 447 -3624 -5597 -2893 877 -1051
-684 -1387 -1372 -1874 -1954 -1061 -296 -908
-33 -921 -1388 -1115 -1266 -1276 -312 -708
