-1365 -902 -2650 -3445 -2073 -1751 -2246 55
-2223 -2228 -4726 -6032 -5111 -4353 -3255 -1335
-4320 -4337 -5217 -5233 -6480 -4349 -3292 -1913
-5736 -3885 -5142 -4914 -7504 -5122 -2990 -1683
-6544 -5468 -3282 -5142 -7798 -5795 -4464 -1661
-5155 -5874 -3146 -5467 -5805 -5191 -4099 -858
-2181 -3644 -4817 -6537 -6260 -5600 -3930 -996
-767 -1934 -3714 -4586 -5246 -3362 -2920 -792
