637 1271 571 234 736 1301 996 745
-2971 -2895 -3322 -3785 -2365 -2388 -2792 -2670
-2104 -1848 -1058 -560 754 -307 -2060 -1915
-1021 -1366 411 -226 -735 -457 -591 -1563
-351 -687 -975 -2915 -4961 -1335 279 -1466
-200 -1156 -2514 -4798 -3770 166 -1161 -2100
-715 -1089 -1948 -1906 219 -186 -2292 -2357
-359 -231 -218 -121 0 -1757 -2104 -691
