-1280 -3270 -2868 -2421 -2125 -1603 -2090 -1721
-1771 -3093 -3899 -3070 -2440 -2894 -2650 -1978
-1673 -1626 -1498 -2230 -2010 -2518 -2254 -674
-1729 -1059 -1602 -2662 -2533 -2213 -354 -22
-1175 -2215 -1710 -2846 -1217 -782 -406 -1555
-1261 -2360 -1725 -2680 -489 -222 -1995 -1368
-312 -1942 -2469 -2137 -430 -2406 -2401 -571
223 -1504 -2629 -1338 -2207 -3733 -1720 -552
