-2441 -1999 -2103 -1671 -1425 -2078 -2119 -1076
-1121 -791 -1724 -1251 -1188 -1680 -855 -285
-860 -1149 -1977 -76 290 -1452 -1188 357
-2104 -3385 -3476 -728 359 -1339 -2841 -874
-578 -1905 -1753 -594 -1367 -2784 -3456 -1232
639 958 -542 -1905 -2174 -2596 -3489 -1310
-428 752 -311 -2143 -1340 -1627 -2787 -1547
-439 182 -1027 -1770 -601 -656 -1772 -500
