-1828 -2910 -2548 -3313 -3501 -3117 -2428 -1326
-2033 -3724 -3492 -4347 -3956 -3657 -1916 -1374
-2584 -4692 -3572 -4620 -4505 -4049 -3805 -2832
-2982 -4044 -2102 -635 -2525 -2660 -2540 -2133
-2216 -3152 -1549 733 -1955 -4002 -3635 -1841
-591 -701 -729 -1851 -3619 -4980 -2256 65
-711 85 -1004 -3247 -3684 -3126 -1302 311
1 644 146 304 399 -1092 -726 -85
