-690 -644 -1091 -852 -593 -850 -761 -321
-1155 -1651 -3113 -2639 -2699 -2730 -1997 -1600
-885 -1304 -3423 -3574 -2411 -1897 -1820 -1368
-811 -1446 -4280 -4307 -1536 87 -2080 -2574
-388 91 -2648 -3775 -890 -763 -3985 -2783
592 297 -1823 -3114 -1458 -1688 -3040 -2683
-224 -1065 -1673 -1612 -2319 -2207 -2222 -1707
-848 -1568 -1457 -1449 -3823 -2832 -2180 -1359
