200 -54 -49 -773 -1132 -767 -761 -915
19 -1979 15 -768 -1455 -1604 -1513 -509
-881 -3009 -448 -1458 -2569 -2246 -1514 -325
-2057 -4215 -1812 -2267 -3584 -1617 167 752
-971 -2902 -2421 -2515 -1965 -1196 131 1588
-894 -3432 -2300 -1712 -2311 -3179 -1806 555
-47 -1682 -467 -1379 -3152 -3497 -1346 338
281 -572 -2259 -4127 -3166 -2569 -1005 235
