-1851 -2960 -2281 -1183 -693 -1253 -1867 -2332
-23 -2200 -3874 -2500 -1800 -1183 -752 -2240
-101 -2288 -2593 -59 -714 -583 -882 -1341
-555 -920 -1669 65 246 -538 -1887 -1149
-699 -324 -50 362 -621 -2064 -2484 -876
202 -477 -1046 -2179 -2787 -3408 -2496 -526
-565 -1302 -1200 -1792 -3009 -4332 -3085 -817
-419 -260 -500 -788 -2165 -1373 -440 130
