777 -400 331 224 150 -18 159 -265
1439 -92 222 728 249 298 -600 -1040
728 -705 -2747 -3143 -3340 -1852 153 -175
-1388 -532 -3758 -4436 -5455 -2440 -922 -1655
-1261 -1512 -4091 -2725 -2964 -586 -1540 -2257
-340 -1642 -2187 -273 -1601 -2022 -1648 -266
188 -1120 -1292 -258 -2393 -3824 -2397 104
-167 -546 -824 -987 -1911 -1716 195 1411
