3 7 -582 -1322 -1488 -750 -40 -168
-2250 -2575 -2770 -3937 -4163 -3801 -3185 -2293
-1706 -3054 -1178 -1955 -1827 -3459 -4289 -3157
-964 -3528 -1408 -478 774 -129 -3559 -3322
150 -2893 -1388 669 1466 2316 -1158 -1886
-509 -2491 -2729 -89 69 -365 -591 -681
-1023 -1898 -2239 -931 -2200 -2051 -897 -698
-172 -999 -1431 -2007 -3493 -1340 -149 -342
