-1796 -2255 -2738 -2329 -1059 -1803 -2337 -1641
-920 -2820 -3122 -2594 -904 -986 -2632 -2372
-373 -1570 -610 538 2487 -356 -3355 -2375
-49 -2165 -695 536 687 -1365 -3604 -1920
-1549 -2168 -558 -490 -2741 -3836 -3486 -2074
-1501 -2281 -642 -628 -2785 -1502 -1948 -1354
-915 -886 946 -616 -2122 -909 -1899 -1427
-696 -45 392 -724 -646 -969 -1143 -496
