-950 -1075 -1205 -1112 -1136 -918 -964 -895
-1338 -1514 -1614 -1753 -1722 -1564 -1183 -1021
-1058 -2164 -2256 -2084 -1834 -1605 -1297 -1080
-1010 -1659 -1964 -1493 -1993 -1857 -1335 -1218
-1148 -1341 -1703 -1485 -1965 -1661 -1942 -1485
-884 -1060 -1203 -1389 -2039 -2222 -2204 -1653
-510 -1002 -1175 -1771 -2118 -2199 -2046 -1453
-226 -510 -883 -1095 -1339 -1358 -1183 -795
