-1341 -3040 -2710 -2824 -2309 -1936 -2009 -1354
-1684 -4170 -3713 -2621 -3791 -3485 -2565 -2224
-1512 -4350 -9087 -5412 -4306 -4471 -3145 -1155
-701 -2177 -8508 -6346 -3448 -2609 -972 -365
346 -885 -3094 -4844 -2792 -2511 -2864 -2177
1623 1265 -187 -2628 -1904 -2098 -3795 -2431
588 1021 -696 -1651 -358 -2943 -4592 -2540
46 -119 15 608 65 -2275 -1635 -766
