-311 -2473 -2055 -572 -748 -1177 -1789 -1737
-562 -2805 -2697 -1328 -967 -1397 -1044 -1586
-567 -1238 -768 -727 -2426 -2390 -1517 -655
-357 -1105 -793 -1636 -4069 -2722 -2909 -1524
-683 -1987 -3338 -3621 -2707 -1461 -3984 -1966
-452 -2731 -3701 -2768 -2854 -3244 -3479 -210
-145 -1217 -571 -1259 -3888 -2453 39 1126
35 -291 -1016 -1760 -2299 -747 -30 105
