-3319 -3057 -3986 -4214 -3341 -3232 -3137 -1236
-3931 -4661 -4442 -3977 -3780 -4909 -4127 -1483
-2550 -2365 -2610 -2648 -2746 -1273 -2590 -958
-1503 -1524 -3059 -3245 -2131 840 -1936 -1955
-2732 -3152 -3041 -2648 -1556 -478 -3933 -3563
-1152 -2168 -2122 -615 -556 -2588 -4183 -2439
-547 -1972 -2028 236 -2626 -3820 -2378 -813
-1198 -2492 -1923 -1387 -2638 -1589 -1028 -597
