-4258 -5492 -4793 -4198 -4310 -5129 -4857 -2335
-3417 -4146 -4142 -4433 -4043 -4748 -4998 -1223
-3584 -4695 -4013 -3338 -2567 -2187 -2773 -627
-4338 -6220 -4069 -453 -1 -2787 -2554 -394
-2755 -5750 -4198 386 -547 -4581 -4334 -1768
-864 -4629 -4288 -2880 -4173 -4074 -4654 -1188
-1452 -3559 -3910 -7213 -6408 -4504 -5422 -1125
-796 -1352 -3158 -6768 -3130 -1938 -3471 -1168
