-1789 -3172 -3676 -4032 -4339 -3152 -1969 -867
-5013 -6123 -4515 -3860 -5303 -5995 -5415 -2769
-4407 -4431 -2282 -1725 -4956 -7413 -6731 -2957
-2751 -2847 -2184 -1646 -2065 -3337 -5160 -2411
-2455 -1206 -916 -284 799 -1518 -4110 -3279
-1832 -1010 -576 1123 512 -538 -1772 -2622
-755 42 841 1930 409 -59 -1121 -1521
-128 -72 400 1104 -200 -993 -588 -265
