-4577 -4772 -4749 -4872 -3515 -4069 -5182 -2593
-2988 -2300 -682 -1074 -702 -1337 -3159 -1198
-2906 -2105 48 -552 208 636 -1126 -1644
-2659 -1027 463 -1207 -1682 486 1151 -539
-2733 -1530 537 -1649 -3386 -2111 -764 -1684
-2979 -2131 -1613 -3242 -5985 -4718 -3329 -1705
-1549 -1570 -2787 -4850 -8548 -7225 -3209 -1932
-926 -694 -2471 -5806 -5952 -3669 -1896 -1233
