520 -700 -2284 -3567 -3279 -2159 -1444 -1240
-2637 -3810 -5153 -6069 -5311 -4838 -3912 -2754
-2437 -3631 -3662 -5203 -6735 -6211 -4824 -2552
-1597 -3506 -5234 -5149 -6856 -7031 -4260 -611
-452 -1313 -3397 -5709 -6187 -3468 127 -399
-387 -666 -1378 -4298 -1616 1904 282 -1159
-676 102 -1023 -1689 843 -455 -2164 -1432
354 728 -637 567 -1772 -2799 -1892 -1017
