-1105 -1847 -1145 -2761 -2705 -2470 -2800 -1479
-1332 -2555 -2385 -3802 -2917 -2475 -4014 -2567
-1247 -2592 -518 -1844 -1897 -2091 -3699 -2383
-1697 -3330 -2224 -3461 -3566 -2085 -3230 -1731
646 -748 -1163 -1398 -5031 -2726 -1813 -1784
499 -47 -259 -1685 -3609 -2138 -518 -396
-849 -835 -1119 -2431 -2573 -2503 -600 -75
-116 -1624 -2276 -2158 -2762 -2132 -1750 -279
