-1439 -582 1184 463 545 34 -707 -1019
-483 -1671 16 -951 -998 -125 -1288 -1719
-2667 -4683 -1396 -2253 -3224 -1012 -2067 -2176
-1409 -2297 78 -113 -1002 60 -1260 -1331
-787 -1470 -55 268 -893 -2033 -1563 -1250
-1230 -1575 -1110 -1405 -3501 -4359 -2005 -691
-26 -458 -851 -2554 -4433 -3130 -1393 -831
-68 623 686 30 -1639 -1255 -681 -350
