-722 -650 -917 -1382 -1076 -905 -683 -489
-827 -593 1047 -47 -308 -363 -627 -118
208 963 3137 1473 581 814 -32 349
-435 -968 1407 -16 -1629 -1630 -879 -453
-984 -2685 -1713 -2454 -3639 -3514 -1504 -394
-1354 -3192 -3213 -2766 -2122 -2496 -1853 -1753
-1661 -1629 -1778 -1082 -1382 -2697 -2363 -847
-361 -974 -715 474 -642 -1328 -215 -511
