-1803 -3899 -4004 -3488 -2991 -2921 -3672 -1417
-3145 -5321 -4097 -2902 -3695 -4174 -5017 -2886
-1401 -3247 -2417 -1154 -487 -46 -2479 -1313
-1454 -1263 -1585 -73 33 -208 -1724 -855
-1516 -746 -1482 451 -333 -2183 -3808 -2757
-896 -1413 -1574 510 -1847 -3310 -4484 -2061
-1393 -1337 -2059 -1559 -3849 -3880 -2757 -508
-1200 -2331 -2575 -3453 -3066 -2545 -1288 -206
