-688 -1758 -2658 -2177 -1806 -1257 -1080 -1338
-1477 -3152 -3886 -2820 -3395 -3208 -2352 -1678
1025 -656 -3565 -2781 -2154 -2328 -2002 -2472
1225 53 -2782 -2375 -220 -320 -1003 -1413
79 752 -236 -1594 252 -599 -2442 -2040
-878 508 80 -1291 529 478 -1833 -2175
-851 -511 -566 -97 1380 1394 -369 -696
-894 -982 -71 594 -24 87 11 -365
