-4440 -3450 -1971 -2772 -1892 -2703 -3341 -1525
-3563 -2037 -831 -3658 -1889 -1753 -2833 -910
-2841 -1845 -1042 -3116 -887 -1751 -3297 -1996
-2129 -1953 -1877 -3074 -2309 -3767 -2998 -3357
-433 634 -74 -1053 -4744 -4348 -4697 -4822
527 1587 473 -2639 -5096 -3116 -4129 -3839
-39 177 -1625 -4285 -3990 -2999 -3167 -3584
-393 -952 -1904 -1277 -2198 -1375 -644 -1532
