-401 -3089 -2448 -2427 -2369 -2104 -1422 -1863
1086 -1330 -750 -1515 -2014 -283 641 -973
-951 -954 970 -168 -2679 -2393 -1109 -1333
-1533 34 1361 1116 111 -259 -1687 -1627
-1394 -737 -14 -214 -1387 -1710 -1961 -1043
-580 -1116 -545 -1347 -2923 -3630 -1339 -361
248 -1026 -406 -771 -4364 -4216 -1651 -622
284 -16 233 43 -1079 -449 112 282
