-2951 -2359 -3779 -3129 -2514 -2755 -2172 -498
-4849 -3026 -4193 -3494 -3306 -4021 -4464 -1742
-2514 -1969 -837 -2067 -1305 -2203 -4428 -3192
-1207 -1741 -293 -2106 -1305 -1747 -3543 -2678
-168 -442 -2436 -3369 -2285 -1604 281 -628
573 -56 -3361 -5623 -4065 222 1087 -551
-671 -1134 -2920 -5075 -3840 768 -11 -1293
-360 922 190 -878 -920 481 -435 -1263
