-2784 -4316 -2347 -3374 -2389 -2728 -3657 -2276
-854 -3170 -758 -2525 -1400 -1338 -2092 -904
-881 -3145 -1837 -1963 -1122 -1485 -2303 -1250
-1686 -2632 -2645 -2390 -828 -405 -1139 -1407
-2489 -1593 -2220 -2612 -2363 -2031 -3242 -3303
-2004 -2098 -898 -2795 -3916 -2902 -3084 -2556
-1181 -2262 -2072 -2663 -4194 -3269 -1652 -877
-608 -1904 -2744 -2176 -2756 -2240 -1191 -648
