-2446 -2097 -2330 -2556 -1976 -2690 -3084 -2116
-821 2499 1602 966 1155 -686 -541 2348
-1945 587 -290 75 937 -1739 -2143 -143
-920 1016 -642 -1352 -271 606 -9 -577
-1141 -268 -1251 -1441 508 2810 1286 -2538
-352 -245 -314 722 2379 1360 -270 -2445
265 -13 329 1842 433 -1347 -1389 -2359
-212 -499 -230 -1127 -1176 -918 -657 -1605
