-2338 -5119 -4118 -4164 -3423 -2739 -3919 -4231
-872 -4078 -4306 -4970 -3081 -812 -1528 -3657
-1179 -3612 -3659 -5146 -2869 -1181 -2526 -3185
-1594 -1717 -2343 -3662 -1019 675 -1365 -2891
-2373 -820 -15 -928 242 1943 474 -3027
-2244 -1072 235 -2303 -2445 -1364 -2073 -3758
-1513 -2539 -2106 -3256 -4369 -3650 -2905 -2265
-558 -2620 -4490 -5076 -4681 -3639 -1691 -725
