-2204 -1901 -2223 -2746 -2672 -2356 -2164 -1783
-3398 -3173 -4283 -4331 -3253 -2748 -1657 -1169
-4097 -2961 -2987 -3649 -3287 -2851 -1602 -1035
-3800 -3335 -1489 -2607 -2281 -1590 -2270 -1764
-2443 -2375 150 -676 -129 114 -2160 -3065
-1371 -936 -478 -297 -902 -751 -1940 -2469
-269 -110 -291 -1154 -2121 -1257 -530 -1456
-570 -888 -1183 -1758 -1191 52 896 -76
