-1065 -3054 -3787 -3592 -2376 -1776 -1749 -1806
-2937 -5633 -4871 -5946 -6451 -5002 -4106 -3194
-3172 -3602 -3650 -3760 -3983 -2796 -2997 -2414
-2022 -381 -1980 -2356 -577 617 -1883 -2163
-2106 -1786 -1720 -1744 -824 549 -810 -2184
-2019 -2198 -1635 -1480 -1271 -241 -598 -2050
-2082 -2736 -2795 -2095 -1782 -918 -596 -1170
-307 -838 -1642 -1062 -249 -526 -396 -363
