-443 -676 -148 -236 -606 -914 -277 -862
45 -787 -224 -917 -1030 -1346 -163 -523
266 -562 -1013 -1925 -1893 -2341 376 467
441 -567 -2311 -2228 -1580 -3787 -2120 -97
1894 1685 -1831 -2552 -848 -2019 -3413 -1866
159 1159 -1114 -2867 -890 -781 -3102 -3616
-925 -124 -575 -1365 -583 -3071 -5139 -3758
-392 -20 263 506 -973 -3321 -3646 -2208
