-789 -3733 -5357 -5011 -4045 -3574 -2512 -864
-3400 -5901 -5214 -2883 -3028 -5347 -5559 -1690
-2277 -3092 -4302 -1318 -1111 -4179 -5254 -1759
-2348 -2550 -4156 -2720 -1083 -3207 -4700 -1743
-1697 -3062 -2637 -1166 -133 -1849 -4542 -3387
-733 -1283 18 632 552 -2183 -5432 -3465
-638 -796 511 900 -859 -2723 -3475 -1589
-223 -48 810 -2 -1299 -1773 -1582 -633
