-2199 -3042 -2991 -2286 -1951 -1603 -964 -1014
-3377 -4378 -3085 -2290 -1885 -1934 -2415 -1138
-2853 -2400 -2084 -5136 -3121 -1309 -856 -44
-3674 -3125 -2321 -6198 -3095 296 -670 -1104
-4387 -3628 -2152 -4337 -2430 -1707 -2949 -3079
-2398 -4133 -3316 -3720 -4302 -6320 -4256 -2741
-2105 -3651 -3716 -5112 -7116 -5518 -3931 -1905
-934 -2202 -4327 -7000 -5445 -3901 -2179 -1694
