-740 -1906 -2012 -3099 -1961 -1453 -1647 -1400
-810 -1831 -2545 -2628 -2083 -1358 -2001 -2037
-293 -1518 -2235 -1768 -1209 -1388 -1966 -2583
-1517 -1692 -2024 -2702 -3237 -3012 -2780 -3067
-874 -1531 -1499 -5360 -3671 -1436 -1136 -447
444 -575 -2590 -4829 -933 195 303 706
-743 -2417 -3742 -1922 -1136 -2400 -1377 -854
-225 -295 -178 -44 -881 -471 217 -28
