-4645 -7209 -6509 -5511 -4380 -3770 -4881 -4326
-2584 -3201 -3003 -3519 -2811 -1962 -2410 -2241
-1270 -101 -397 -1274 -481 472 -1470 -1639
-1605 197 -590 -2223 -528 1424 -876 -1698
-1515 -869 -539 -2147 -1179 -893 -1123 -2256
-1202 -1266 -1476 -2351 -4272 -3351 -1559 -1591
-492 -814 -2502 -3716 -6241 -5401 -2660 -1045
-322 -1452 -3125 -3811 -5581 -3228 -2001 -1169
