-2703 -2879 -2876 -3041 -2525 -2953 -3336 -1803
-3664 -3842 -4235 -3789 -2625 -3158 -3922 -1984
-3078 -3532 -2087 -2229 -2630 -3481 -4602 -2316
-1907 -1976 24 -350 -452 -2867 -4011 -1489
-970 -1910 -460 -91 448 -1875 -2660 -1607
-1128 -2965 -1905 -864 109 -942 -1550 -1094
-1111 -1648 -837 -824 -1080 -1317 -1128 -691
-156 32 -235 -1185 -1017 -383 -690 -402
