-2175 -3806 -3373 -3408 -3113 -3165 -3440 -3005
-3143 -6484 -6629 -5401 -5871 -6003 -5383 -2705
-3879 -6916 -6230 -3953 -7106 -6882 -6055 -2837
-3538 -5546 -3934 -2281 -3953 -5039 -5500 -2738
-3173 -4711 -2377 -538 -415 -3466 -5226 -2032
-2276 -3551 -2718 -360 -994 -3734 -3413 -767
-1184 -2397 -2000 -79 -2106 -3223 -2600 -222
-650 -1026 -906 -248 -887 -1479 -1702 -621
