-1055 -456 301 251 -278 -1545 -1755 -500
184 -195 -650 637 345 -825 -992 165
-316 -1071 -3661 -1260 -402 -1112 -1562 253
-414 -888 -2364 -1365 -2212 -4645 -4714 39
1031 -694 -2164 -2873 -3664 -5538 -6518 -1167
971 -286 -2346 -5134 -4088 -4389 -5577 -2855
-465 -654 -2020 -4776 -3528 -3368 -4272 -3316
-319 -32 -1256 -2641 -1901 -1345 -1841 -1607
