-718 -1111 -1621 -2087 -1969 -670 7 -971
-1143 -364 -1247 -580 -1619 -1498 168 243
-1893 -1042 129 1472 -491 -1012 441 897
-1472 -1609 -1432 -1152 -886 -413 584 830
-2139 -4521 -4357 -4304 -2304 -2006 -2906 -502
-1758 -4536 -5932 -5551 -3732 -5410 -5839 -2090
-821 -1621 -3554 -4207 -6347 -7682 -6820 -4104
-894 -1265 -2638 -3523 -4315 -3952 -4862 -2573
