339 -1418 -1266 -829 -1050 -1025 -840 -1149
1286 -1451 -1564 -1614 -2353 -651 1141 853
92 -1462 -870 147 -2902 -1669 -25 15
-158 -2672 -3035 82 -1580 -1267 -985 -451
-1195 -3595 -3306 -2860 -4521 -4635 -4068 -1155
-1699 -3814 -3777 -3815 -4560 -5913 -4361 -1150
-553 -933 -1840 -2332 -4795 -5421 -2912 -58
-222 166 21 158 -2299 -3479 -874 373
