-400 -1388 -633 -1452 -1216 -1257 -1593 -668
-394 -1910 -694 -1136 -1088 -1105 -2339 -541
-2391 -4680 -5531 -5140 -4368 -3548 -4220 -1006
-3487 -6134 -6385 -4774 -4471 -4107 -7031 -3136
-2972 -5324 -4628 -1546 -1144 -1460 -6154 -4582
-1627 -4056 -1780 98 -564 -946 -3821 -2822
-1912 -2415 -281 618 -1963 -2954 -2482 -1921
-800 -1026 -774 -1179 -3104 -2304 -990 -959
