-1918 -4688 -4571 -3598 -3123 -2878 -3058 -2197
-2124 -3377 -3565 -2403 -4296 -3269 -2424 -991
-1865 -1797 -1401 -1411 -3967 -3649 -2282 -718
35 -68 -1352 -2481 -2741 -2975 -3038 -1402
617 -1086 -250 -1006 -2605 -2149 -2206 -785
667 -692 633 475 -3331 -3835 -2514 -1057
-426 -1114 -957 -3326 -6042 -3867 -1655 -1044
-191 -1235 -3101 -5182 -3739 -1008 -84 108
