-3401 -3823 -2930 -2953 -2018 -2047 -2255 -1364
-5329 -6072 -5420 -6372 -5503 -5441 -5968 -4025
-4009 -5435 -3313 -3446 -3016 -3710 -4406 -2909
-2978 -3044 -1245 -1865 -587 -1420 -3196 -2413
-1317 -1155 466 1355 2234 -359 -950 -1641
16 -385 490 1149 709 -1310 -2062 -1751
-457 -382 -528 -1576 -1767 -1405 -1821 -948
181 -363 -949 -1333 -613 -670 -111 -10
