-858 -1574 -1138 -1900 -1529 -1626 -1540 -1500
104 3 864 -557 -1683 -1142 -94 -437
-491 -1506 -42 -284 -2995 -1501 -537 -642
-1432 -4275 -1840 153 -4194 -2798 -2068 -1982
423 -4011 -4494 -2049 -3241 -4350 -4193 -2511
944 -2149 -4789 -2710 -2587 -4622 -2422 -1137
754 -520 -902 -908 -2173 -5324 -2769 -1713
-26 -252 -1435 -2906 -4269 -2977 -2473 -1829
