-4453 -4394 -1317 -994 -1278 -2108 -2567 -1876
-5054 -5025 -2043 -2625 -2071 -3796 -3147 -2142
-1645 -410 1798 -1982 -2282 -1842 -2491 -1382
15 400 878 -1531 -1395 344 -894 -1606
-1309 -17 507 -973 -1381 -1427 -3361 -3622
-1543 -686 81 -2015 -3036 -3430 -3606 -3040
-858 -1005 -2549 -3438 -4060 -4285 -2237 -1478
-675 -2216 -3611 -2289 -2130 -2121 -1115 -811
