-3005 -2224 -2100 -1271 -794 -1851 -2889 -1377
-3662 -3225 -4654 -3370 -1359 -1179 -1778 -71
-3932 -3030 -2993 -1419 -696 -1338 -2268 -913
-1685 -1420 -912 253 -346 -1705 -2308 -1159
-145 -2568 -3045 -2022 -3118 -2886 -2292 -901
-1031 -2765 -2940 -3269 -3982 -2777 -2363 -1259
-1625 -1214 -2297 -5101 -3427 -3336 -4183 -2722
-709 -345 -1599 -2815 -1765 -2313 -3307 -1489
