-520 -1188 -1092 -1632 -1800 -1790 -1049 -668
-584 -2608 -2711 -3329 -3533 -3284 -3036 -1541
-1404 -1658 -2188 -2498 -2704 -2798 -2009 -907
-1250 -1941 -1081 -462 716 -1219 -2081 -154
-1323 -2514 -869 1109 2455 -128 -1353 -1004
-1884 -2892 -1309 -225 -253 -610 -1779 -1773
-1379 -1670 -1384 -2305 -1507 -588 -738 -178
-448 -1253 -1866 -2231 -1243 -651 -296 -72
