-2465 -4771 -5393 -3801 -2917 -2824 -3489 -2775
-2750 -4505 -3826 -3263 -3668 -2889 -3768 -2958
-1442 -3118 -2495 -2920 -3129 -3338 -3084 -1665
-512 -1479 -113 -3292 -4175 -2928 -2021 -1264
-2185 -205 31 -1648 -1275 -245 -1490 -2567
-2454 -1255 -44 549 475 -444 -3024 -2297
-1201 -624 785 1185 -1394 -1917 -1453 -356
-30 -155 -441 -2484 -3076 -994 -377 -140
