-2427 -3555 -3513 -3128 -3202 -3322 -2945 -2325
-1690 -2300 -1177 202 323 -957 -1042 -1646
-1198 -111 1658 1828 3416 49 879 75
-686 1393 3253 -385 1022 -1775 765 1397
-747 10 2159 -1438 -2488 -3626 -1701 -1015
-640 -731 -639 -3068 -4299 -3754 -2323 -1842
-149 91 -807 -4331 -4378 -2981 -2491 -1658
-206 -809 -1630 -3428 -3468 -2371 -1945 -1590
