-1496 -706 -935 -909 -1259 -1106 -1127 -484
-2433 -1526 -2350 -3044 -2254 -1361 -1308 -781
-2283 -2332 -3544 -4173 -3731 -2071 -2838 -2178
-2045 -1519 -2774 -3589 -4728 -3795 -3309 -1849
-2037 -1780 -1288 -2739 -4373 -3749 -2348 -1090
-2048 -2124 -445 -2305 -4124 -2936 -567 -905
-1147 -464 -857 -2590 -2941 -1602 114 -836
81 527 -828 -549 -835 -995 382 94
