-4509 -5964 -4109 -3984 -3610 -3886 -5218 -3955
-4337 -5041 -3280 -3350 -3731 -3114 -4028 -2843
-3733 -5184 -1188 -299 -2856 -2354 -2905 -2947
-3238 -4432 -1197 341 -508 -366 -1220 -3343
-1195 -1591 133 533 -850 -2416 -1580 -2786
-172 562 796 -1402 -4241 -5329 -2354 -985
-110 -762 -1610 -3650 -5303 -5673 -2634 -1624
-367 -1497 -3812 -5075 -4643 -4242 -2124 -1025
