-424 -2281 -1768 -648 252 520 -143 -1516
1116 -1813 -2582 -2234 -1118 1222 1433 -632
-449 -1541 -586 -1781 -3712 -1280 718 -653
-234 -496 45 -1263 -3728 -2016 330 -457
170 -1278 -1609 -2888 -3827 -2327 -2329 -2154
-676 -2538 -3612 -3442 -2695 -2592 -3719 -2726
6 -588 -757 -288 -1628 -3047 -2171 -1024
78 310 828 452 -1593 -1783 -1154 -940
