-132 -43 -37 1 -1 1 0 -5 5 28 13 -17 -12 124 222 -96
-239 -88 -97 -73 -118 -150 -160 -159 -146 -115 -73 -69 -45 55 145 -60
-199 -59 31 38 -135 -170 -110 -80 -76 -88 -107 -120 -80 89 239 -85
-251 -132 61 219 -66 -104 28 111 70 -2 -143 -155 -145 -11 172 -90
-44 -132 22 240 2 -84 53 130 168 79 -41 19 -33 -49 114 -118
261 -59 -26 131 40 -89 -98 -28 114 70 -38 -16 108 -44 17 -130
185 143 -31 -80 -157 -198 -93 -32 86 7 -57 -117 -6 -184 -47 -152
139 145 35 52 -113 -247 -81 67 156 6 -131 -96 -101 -202 -156 -172
-122 -13 107 208 59 -189 -33 106 171 72 -218 -246 -192 -49 -262 -245
-197 -274 -89 81 -2 -153 -31 66 81 98 -311 -532 -341 -236 -222 -308
-208 -327 -152 -50 -61 -107 15 68 24 62 -206 -563 -567 -368 -191 -281
-166 -216 -144 -119 -105 -86 -4 24 -3 -43 -268 -414 -543 -343 -174 -175
-179 -173 -122 -131 -119 -32 67 89 -22 -347 -547 -442 -247 -179 -131 -173
-234 -325 -243 -167 -99 -45 -27 -154 -414 -698 -729 -353 -165 -4 -28 -199
-175 -339 -227 -100 21 56 -72 -404 -602 -672 -516 -392 -233 -69 -38 -209
-27 -144 -121 -49 -16 9 -141 -385 -459 -399 -283 -192 -141 -28 30 -124
