-372 -222 -280 -256 -244 -238 -235 -232 -228 -227 -237 -236 -239 -181 -147 -111
-652 -326 -436 -392 -344 -324 -312 -321 -325 -318 -318 -341 -351 -269 -227 -183
-598 -174 -237 -191 -189 -223 -191 -212 -198 -146 -116 -121 -176 -103 -154 -108
-581 -151 -145 -60 -219 -287 -259 -254 -276 -222 -165 -189 -144 -32 -123 -94
-663 -231 -158 9 -182 -421 -317 -149 -128 -118 -137 -290 -241 -40 -63 -42
-618 -319 -113 -10 -89 -335 -181 -50 -79 63 -20 -262 -169 23 -48 -91
-257 -427 -183 -169 -219 -163 -42 43 75 202 62 -33 36 112 -119 -197
-43 -313 -322 -227 -176 -32 -23 43 33 170 160 163 26 -151 -234 -32
-47 -124 -144 -109 10 -11 -7 15 0 188 285 210 -12 -209 -130 -103
-130 -84 7 79 126 -34 -14 18 40 209 351 445 -27 -109 -2 -122
-190 -72 69 107 115 77 20 39 168 204 419 315 -129 78 -48 -94
-168 -2 91 165 121 37 -42 15 163 395 213 -157 -19 108 -119 -52
-86 57 82 122 10 -33 -108 -14 225 166 -215 -245 115 10 -128 -32
-1 100 5 -74 -122 -68 43 216 144 -205 -264 33 224 23 -49 43
-3 -61 -142 -206 -162 -9 126 41 -187 -308 -201 98 168 20 -23 -66
-103 -177 -178 -169 -101 4 -20 -108 -143 -142 -126 65 85 64 -102 -27
