-105 -150 -180 -213 -216 -229 -232 -217 -203 -195 -187 -183 -189 -179 -236 -106
-281 -228 -339 -341 -306 -355 -427 -426 -402 -363 -315 -286 -334 -375 -467 -169
-53 0 -90 -39 26 -91 -200 -183 -114 8 88 72 -18 -136 -308 -202
41 147 -1 21 96 -31 -218 -300 -262 -34 167 150 113 55 -155 -118
73 220 110 61 37 -21 -243 -332 -318 -115 204 187 164 139 -47 -127
-202 13 172 30 -135 -144 -163 -265 -339 -127 56 -30 25 178 -148 -289
-404 -346 -45 -203 -183 55 154 41 -130 -68 -1 -58 65 43 -396 -462
-348 -517 -436 -418 -92 316 327 234 83 40 -48 104 121 18 -393 -240
-217 -506 -585 -511 52 398 259 213 111 64 76 159 34 -208 -273 -55
-203 -534 -602 -367 180 398 222 193 183 143 116 115 -89 -321 55 37
-175 -439 -451 -279 179 317 230 165 131 122 158 122 -328 -31 199 127
-199 -351 -355 -281 -7 83 118 78 12 67 56 -272 -188 321 213 128
-92 -205 -289 -283 -222 -161 -65 -29 -60 14 -457 -390 142 352 88 111
46 -194 -397 -387 -287 -179 6 38 -7 -440 -474 105 415 161 -65 52
0 -233 -320 -307 -230 -124 0 -86 -411 -498 -53 295 234 -108 -74 20
-17 -143 -152 -112 -90 -16 58 -114 -233 -152 87 215 54 -28 -83 -23
