-346 -458 -409 -406 -393 -387 -390 -386 -385 -374 -372 -363 -369 -404 -242 -139
-387 -548 -471 -507 -528 -511 -478 -459 -476 -496 -450 -432 -442 -532 -268 -172
-400 -559 -387 -503 -577 -459 -428 -458 -503 -528 -522 -456 -396 -420 -218 -189
-398 -581 -535 -538 -571 -644 -824 -821 -713 -647 -524 -505 -576 -591 -348 -241
-410 -754 -916 -513 -109 -88 -420 -396 -234 -407 -404 -533 -655 -781 -465 -327
-245 -432 -738 -339 33 -177 -517 -456 -284 -234 -9 1 -170 -491 -355 -448
227 147 -260 64 201 -279 -500 -352 -202 23 215 47 -23 -50 15 -382
103 304 213 295 57 -389 -486 -414 -234 56 56 -162 -33 89 85 -342
-186 -167 -284 -183 -198 -319 -360 -352 -285 -82 -140 -236 -64 -137 -47 -182
-299 -431 -504 -173 -188 -258 -328 -316 -408 -295 26 200 214 -67 -10 -196
-193 -362 -481 -158 -185 -250 -225 -187 -311 -271 192 288 34 -137 -47 -276
-192 -290 -348 -59 -37 -108 -156 -159 -232 -117 148 -86 -269 -164 -128 -257
-214 -367 -429 -299 -205 -81 28 4 -77 163 -48 -401 -344 -155 -73 -311
-275 -456 -363 -182 -95 -44 -25 17 11 -118 -477 -439 -267 165 236 -133
-107 -139 -208 -218 -305 -185 87 234 -107 -433 -429 -276 -31 -11 -25 -225
88 55 -119 -172 -213 -88 83 -56 -303 -149 -71 85 231 180 51 -167
