224 314 139 118 98 89 84 90 98 109 117 119 120 56 30 63
146 388 117 148 110 77 56 55 72 102 112 122 106 42 -164 -11
139 191 -65 20 44 13 -17 -36 0 84 63 32 -27 -128 -292 -184
143 284 33 57 98 66 -38 -123 -81 76 182 258 226 78 -176 -118
103 437 193 -65 -58 -69 -226 -309 -281 -83 55 270 377 339 31 -36
-142 324 425 86 -81 -165 -185 -180 -240 -150 -7 58 185 355 119 28
-332 -166 61 0 -51 -108 12 0 -216 -185 -40 -86 -86 61 39 61
-322 -587 -624 -334 -194 -55 57 -9 -261 -208 -130 -151 -180 57 3 26
-122 -349 -542 -446 -256 -6 167 26 -257 -320 -252 -133 -41 160 -91 -48
8 73 -167 -332 -164 47 159 61 -198 -385 -357 -109 59 84 -126 -58
1 98 -133 -228 -121 38 118 45 -52 -277 -261 -59 -44 -44 -38 -5
-39 40 -155 -300 -258 -50 47 -1 -65 -159 -86 -20 -102 41 -2 -12
-59 -21 -255 -411 -443 -224 -148 -102 -241 -240 -116 -58 -9 48 24 -15
-91 -101 -314 -341 -308 -207 -113 -90 -127 -117 -81 -35 3 76 -22 -56
-185 -113 -171 -153 -110 -107 -113 -10 36 27 104 -33 55 131 33 -66
-111 -38 13 45 -18 -86 -55 61 50 77 -4 -105 -52 5 -3 -14
