-670 -642 -572 -502 -502 -491 -472 -480 -486 -457 -444 -461 -466 -379 -351 -147
-719 -574 -528 -443 -481 -521 -513 -510 -502 -459 -464 -460 -432 -357 -256 -318
-609 -244 -321 -171 -234 -386 -349 -291 -208 -113 -78 -201 -246 -146 -97 -174
-638 -401 -498 -284 -395 -463 -289 -148 -2 26 -54 -234 -325 -294 -256 -266
-649 -316 -463 -203 -241 -156 -118 -114 -37 -160 -277 -237 -132 -196 -266 -273
-397 -179 -202 52 -2 198 140 64 -30 -93 -34 9 -74 -229 -247 -158
0 -516 -411 119 45 152 117 9 -121 -56 261 163 -138 -156 -186 -61
-48 -594 -506 -28 -87 -44 -32 -57 -147 -90 -37 -93 -36 -253 -247 -153
-379 -400 -273 15 19 33 24 -86 -206 -217 -96 74 126 -40 -123 -95
-542 -454 -425 -30 -133 6 15 -64 -188 -166 203 392 181 110 43 -28
-537 -460 -378 -75 -221 17 95 -2 -93 55 335 137 -34 -70 79 -2
-374 -404 -409 -190 -216 123 146 -113 -16 340 243 -175 -198 0 76 -109
-334 -437 -458 -187 51 274 113 -31 229 227 -157 -257 -143 168 144 -143
-435 -387 -184 -8 14 131 135 186 82 -333 -450 -152 82 295 -112 -292
-427 -178 32 56 -81 -66 25 -109 -485 -635 -352 51 239 183 -228 -216
-145 -12 38 -65 -116 -131 -231 -446 -544 -379 -144 125 154 -17 -160 -114
