-95 -311 -388 -429 -428 -431 -428 -406 -397 -385 -362 -350 -361 -362 -260 -256
-320 -546 -534 -570 -542 -553 -614 -611 -594 -543 -482 -482 -514 -498 -357 -379
-354 -508 -462 -422 -326 -404 -515 -512 -456 -376 -325 -337 -400 -488 -417 -500
-397 -455 -326 -241 -214 -521 -804 -863 -746 -552 -335 -207 -252 -304 -267 -399
-387 -380 -151 13 65 -319 -610 -613 -428 -193 -81 -174 -187 -174 -93 -285
-498 -513 -143 148 193 -11 -77 6 146 326 289 48 -70 -5 -3 -275
-94 -268 -130 48 77 53 109 155 187 302 370 308 231 179 21 -329
84 -121 -198 -116 99 117 153 195 210 236 312 207 135 187 23 -202
-62 -213 -301 -157 31 103 139 195 252 257 241 208 129 144 -77 -213
-154 -379 -374 -179 4 186 258 233 240 179 200 166 111 101 71 -139
-149 -192 -148 -65 12 105 187 186 210 228 193 150 40 28 151 -96
-148 -201 -115 -92 -60 39 138 187 172 117 30 34 -37 77 122 -55
-185 -252 -274 -370 -341 -242 -114 -84 -190 -165 -50 -18 -86 65 107 -39
-211 -351 -515 -554 -493 -316 -137 -74 -74 9 18 -65 -80 152 165 -9
-212 -292 -384 -356 -354 -264 -205 -113 47 156 -22 -101 168 274 238 0
-135 -244 -297 -294 -324 -257 -70 137 184 50 -209 -89 116 57 -77 -175
