-275 -395 -240 -170 -169 -170 -170 -168 -170 -177 -177 -188 -198 -175 -283 -121
-591 -633 -280 -145 -169 -229 -254 -282 -265 -267 -254 -262 -248 -178 -284 -89
-363 -440 -148 -128 -247 -250 -273 -261 -278 -276 -173 -122 -137 -64 -200 -75
-406 -566 -291 -332 -421 -504 -427 -330 -373 -352 -291 -316 -268 -168 -290 -175
-792 -907 -446 -385 -313 -146 149 299 176 15 -131 -386 -312 -273 -345 -198
-644 -677 -494 -480 -435 -236 269 402 199 89 109 14 -45 -175 -366 -198
15 -314 -313 -366 -581 -572 -164 -44 -136 -127 33 113 119 8 -140 -45
133 44 -44 -178 -451 -472 -210 -150 -232 -225 -193 -177 -17 93 125 2
-23 -6 78 -68 -197 -292 -96 -31 -182 -283 -344 -205 -145 -116 -98 -105
-166 -194 34 -122 -227 -300 -122 -123 -133 -241 -243 -69 -130 -194 -247 -232
-110 -117 50 -87 -164 -183 -86 -42 0 -84 -156 -82 -34 -137 -333 -290
-42 -80 33 -102 -77 14 153 68 48 -18 -41 27 -137 -404 -367 -302
-104 -213 -62 -88 46 155 255 138 102 181 271 2 -380 -440 -335 -398
-226 -303 8 192 294 214 163 97 221 256 4 -422 -427 -129 -157 -317
-138 -65 204 162 97 -18 -47 -20 56 -173 -503 -410 -162 -66 -252 -388
55 11 -12 -98 -92 11 117 91 -82 -252 -232 -22 56 -10 -154 -122
