426 -276 -389 -366 -371 -362 -366 -351 -335 -330 -330 -321 -318 -296 -173 -310
879 183 109 172 180 197 175 184 192 191 183 142 135 148 349 33
700 -181 -226 -186 -255 -423 -603 -631 -593 -484 -282 -152 -178 -184 12 -121
727 -34 -125 -57 -101 -217 -412 -381 -242 -187 -126 -149 -168 -123 49 -77
330 -296 -82 141 356 420 258 85 194 121 53 -22 -145 -119 -97 -197
473 -110 -75 38 386 393 309 240 302 282 366 284 220 62 -33 -255
538 55 -73 -71 -39 -130 -122 4 217 270 239 156 271 118 119 -214
322 98 -3 222 198 63 -94 -36 181 225 131 -98 63 -68 -34 -230
224 -165 -236 126 293 252 -55 -38 108 116 41 -80 9 28 48 33
246 -258 -325 53 163 95 -181 -109 53 135 103 66 108 43 138 66
297 -164 -190 82 61 7 -141 -88 -8 122 185 41 75 -76 156 -44
321 -54 -210 -169 -129 -175 -234 -246 -175 38 136 94 12 -119 22 -87
218 -179 -339 -302 -216 -145 -110 21 191 203 133 -13 -7 -118 -70 -51
128 -146 -63 49 92 83 42 112 169 115 15 -35 -46 -86 -82 41
179 -24 -44 38 15 -33 -70 -93 -232 -281 -208 -155 -179 -241 -230 -125
200 159 58 32 -13 6 27 82 -2 73 53 21 12 43 12 24
