306 738 581 504 507 501 491 480 488 478 459 471 479 595 234 488
-296 -57 -264 -347 -335 -309 -318 -320 -314 -322 -354 -330 -306 -121 -699 -40
144 601 315 157 74 150 160 154 178 209 205 247 297 479 -48 489
95 478 249 -103 -312 -183 -125 -154 -177 -102 -73 5 87 340 -173 336
-9 291 252 -286 -497 -259 -217 -334 -522 -514 -475 -260 -76 270 -99 317
-335 71 100 -508 -807 -462 -307 -278 -478 -504 -374 -278 -456 3 -221 276
-679 -441 -303 -652 -652 -168 -60 78 -192 -439 -514 -456 -680 -276 -484 78
-567 -487 -560 -965 -808 -287 -138 -37 -257 -406 -300 -304 -530 -330 -469 98
-90 77 -96 -584 -445 -95 -168 -79 -278 -266 -243 -239 -578 -418 -324 171
35 368 225 -483 -392 -245 -269 -118 -189 -305 -294 -167 -489 -204 -218 286
-79 220 236 -354 -333 -272 -468 -201 -208 -374 -428 -434 -487 -152 -253 199
-68 201 142 -335 -356 -428 -507 -244 -268 -284 -423 -564 -322 -45 -276 211
72 244 76 -280 -339 -492 -450 -241 -164 -273 -517 -275 36 33 -230 260
71 130 -45 -201 -138 -324 -289 -208 -300 -583 -392 72 29 -213 -330 278
-138 -58 -91 -122 -59 -150 -33 -62 -350 -322 -4 70 -328 -405 -456 207
-215 -112 14 45 85 -73 -263 -366 -223 86 161 -144 -300 -260 -151 219
