-23 -95 -205 -247 -234 -212 -190 -178 -170 -168 -163 -178 -193 -214 -159 -201
-140 -392 -417 -368 -338 -325 -301 -284 -275 -295 -312 -340 -346 -380 -325 -458
-101 -232 -154 -79 -23 0 2 -14 -2 0 -19 -55 -100 -142 -124 -293
-40 -184 -104 -61 -85 -191 -294 -284 -215 -152 -57 0 -13 -48 -11 -224
-97 -208 -79 -161 -351 -444 -367 -308 -213 -132 -97 -178 -209 -115 18 -171
-210 -273 -104 -36 -205 -288 -10 -35 -38 -38 -64 -141 -182 -124 -16 -155
-119 -180 -101 10 -18 -120 122 47 0 3 2 16 31 -68 -3 -120
79 -186 -53 17 -45 -77 102 7 -49 -2 68 74 -11 -221 -239 -186
149 -98 -116 -98 -148 -98 66 8 4 49 97 29 -89 -255 -262 -208
81 -119 -132 -79 -134 -144 36 26 51 58 -3 -80 -98 -199 -154 -79
66 -133 -128 -11 -85 -123 17 2 31 -47 -136 -79 -154 -183 -56 6
34 -120 -60 104 44 -32 25 -44 -24 -110 -108 -181 -257 -263 0 24
67 -29 -6 -36 -175 -151 -46 -149 -268 -300 -274 -310 -290 -273 28 -21
66 -133 -264 -366 -354 -169 -108 -183 -152 -180 -268 -312 -284 -139 103 29
-113 -422 -421 -314 -202 -81 -77 -34 -23 -238 -288 -271 -185 -46 66 -8
-151 -310 -221 -118 -61 -52 -57 -30 -194 -334 -237 -147 -64 51 43 -64
