-86 -595 -224 -211 -223 -229 -217 -209 -220 -214 -199 -222 -236 -236 -191 -62
-204 -908 -370 -352 -350 -417 -369 -359 -329 -277 -269 -286 -324 -370 -418 -175
-30 -616 -182 -175 -141 -388 -281 -193 -88 48 46 -26 -122 -121 -334 -171
-73 -588 -272 -207 -233 -684 -543 -304 -159 62 126 -16 -150 -75 -332 -119
-71 -264 -126 -17 -269 -749 -638 -344 -84 26 81 -35 -59 -5 -362 -29
-116 -165 2 248 73 -252 -263 -213 64 4 -134 -186 -99 -91 -484 -34
-170 -338 -232 65 152 217 148 -82 30 -41 -186 -137 -154 -326 -634 -68
-151 -638 -479 -21 287 217 149 -21 -35 -84 -29 92 -66 -402 -537 33
-288 -692 -320 305 417 75 43 2 -17 -86 -91 143 133 -49 -140 91
-408 -767 -320 336 404 -27 0 46 5 -135 -173 -41 140 263 111 69
-458 -766 -317 182 180 -43 -31 -59 -14 -56 -48 -33 211 336 170 45
-358 -683 -321 25 51 7 -74 -224 -49 30 92 -12 55 194 140 65
-212 -511 -257 -166 -62 1 -134 -426 -222 55 104 31 30 112 85 108
-235 -428 -331 -360 -230 -42 -160 -333 -101 193 -29 -11 -11 83 68 98
-356 -450 -162 -144 -172 -181 -306 -372 -143 -113 -164 63 35 -40 1 115
-262 -252 -72 -117 -161 -181 -343 -400 -270 -185 -88 46 -45 -133 -92 24
