-661 -673 -566 -628 -627 -627 -613 -596 -591 -595 -585 -574 -572 -501 -464 -261
-319 -290 -282 -315 -283 -291 -284 -258 -252 -244 -207 -209 -229 -188 -157 -236
-318 -218 -121 -139 -137 -197 -203 -184 -194 -156 -48 -56 -68 -27 44 -158
-310 -185 -131 -110 -137 -351 -383 -419 -464 -396 -235 -161 -94 -25 43 -144
-296 -190 -85 101 141 -208 -338 -372 -419 -326 -241 -295 -177 -54 30 -120
-269 -400 -148 275 410 280 85 -71 -193 -140 -118 -298 -287 -193 -141 -164
-21 -529 -585 -328 -18 230 315 191 18 -12 -62 -140 -153 -301 -427 -276
-41 -378 -394 -443 -215 23 219 187 0 -76 -82 -3 9 -354 -538 -383
-34 -150 -260 -309 -10 98 121 140 34 -60 -91 69 122 -12 -105 -158
-141 -273 -318 -268 36 173 101 142 136 -35 -99 -129 -175 54 100 11
-256 -396 -356 -276 -27 163 135 92 67 28 -62 -309 -439 -97 15 24
-211 -339 -298 -224 -133 -53 -19 -119 -106 -101 -222 -332 -192 166 94 94
-113 -233 -320 -343 -291 -186 -135 -274 -393 -576 -561 -219 180 255 99 102
-153 -281 -385 -358 -315 -151 -51 -121 -406 -561 -265 156 217 128 -21 -7
-299 -417 -313 -224 -143 -75 -221 -434 -568 -280 50 16 17 23 -30 -35
-150 -241 -125 -90 -101 -137 -307 -375 -196 44 -38 -143 -1 38 -58 -120
