-500 -178 -59 -66 -62 -66 -65 -61 -69 -74 -75 -68 -60 -174 -76 68
-640 -161 -178 -192 -184 -123 -96 -83 -95 -135 -140 -138 -136 -311 -166 2
-655 -155 -221 -213 -43 159 207 168 130 81 29 -57 -99 -266 -139 12
-624 -113 -297 -223 143 471 381 205 175 199 217 153 31 -154 -69 49
-423 51 -251 -147 312 600 279 54 -41 -61 132 162 98 -72 62 181
-327 174 55 106 303 331 -64 -255 -373 -230 111 105 -70 5 306 272
-290 -59 89 340 551 242 -140 -261 -367 -245 67 -64 -37 108 346 158
-380 -70 20 67 215 210 -8 -145 -278 -142 40 -31 111 141 135 161
-338 -46 9 -192 -78 144 6 -144 -218 -128 195 265 216 197 108 183
-284 37 -31 -151 -189 56 11 -33 -91 26 384 390 298 56 117 115
-238 101 30 -50 10 166 66 73 73 110 257 254 53 -49 168 55
-273 -6 12 71 198 168 33 117 96 69 176 15 -122 95 101 28
-263 27 185 347 312 100 -51 42 6 26 -206 -305 -71 218 198 108
-107 340 409 302 68 -153 -205 -35 -68 -277 -446 -239 122 301 131 97
93 363 127 -51 -192 -215 -93 7 -165 -206 -203 26 138 152 95 167
92 77 -93 -93 -77 -35 -45 -95 -106 -77 17 94 18 59 45 53
