225 252 125 179 167 163 166 158 148 153 168 155 140 104 167 80
209 120 159 203 177 167 183 169 158 168 154 149 170 134 121 4
69 -51 -35 1 47 58 34 -24 -70 -104 -110 -53 -22 -55 -84 -44
10 -72 -84 -62 59 -21 -127 -137 -178 -144 -16 17 -34 -68 -84 -45
-50 -60 -153 -226 -381 -419 -392 -226 -115 1 -2 -45 -163 -89 -152 -44
-125 -207 -269 -426 -439 -480 -321 -121 41 -3 -162 -139 -271 -165 -125 -18
60 -51 -278 -393 -175 -81 -60 42 65 -12 -47 -91 -307 -153 -51 85
165 103 -87 -105 -50 -31 -47 -61 -52 22 23 -50 -135 68 166 102
66 29 -15 -63 -142 -20 -121 -102 -13 -4 36 100 84 154 24 36
-87 -69 -5 -23 -50 48 -126 -181 -47 -30 80 161 279 369 11 35
-84 -86 -180 -154 -42 9 -124 -238 -128 20 33 466 835 520 172 34
-92 -175 -115 -4 26 -19 -118 -227 -115 -25 282 987 650 262 132 -53
-59 9 98 91 19 -8 -217 -270 -133 435 1254 845 80 31 -71 -105
-1 158 27 51 60 4 -140 -108 509 1349 1046 94 -138 48 -124 -81
65 164 167 113 -19 -75 -62 397 1233 1111 266 -105 50 94 -64 -81
109 136 57 38 -24 -11 230 694 590 76 -123 16 138 -38 -50 -24
