-49 21 -6 -3 -7 -4 -8 -8 -12 -8 -7 -21 -35 -46 -123 72
-191 -278 -220 -187 -232 -204 -195 -185 -209 -235 -229 -198 -177 -255 -281 78
-231 -364 -277 -247 -233 -78 -70 -60 -101 -209 -272 -335 -319 -370 -346 0
-234 -395 -406 -355 -111 245 283 228 237 179 80 -56 -182 -385 -382 -33
119 -197 -482 -698 -503 1 226 176 206 236 309 421 212 -196 -260 34
550 487 -191 -597 -665 -525 -375 -203 -155 -130 -83 229 356 127 53 154
72 602 317 -124 -158 -246 -381 -289 -214 -218 -512 -519 -159 102 47 83
-369 -30 220 -77 -114 49 -161 -196 -157 -145 -362 -415 -177 10 -120 -37
-235 -221 -146 -287 -319 -55 -66 -178 -137 -55 -111 -206 0 60 -138 17
-75 7 -69 -281 -312 -158 -41 -157 -214 3 25 -138 -78 -77 -227 -166
-60 0 -86 -233 -223 -113 24 63 -73 -80 75 -58 -192 -106 -145 -168
-142 -87 -92 -123 -90 -45 8 145 -14 -74 -25 -165 -297 -138 -95 -166
-207 -203 -72 -2 -41 -94 -54 88 109 33 -201 -297 -300 -1 -22 -112
-76 -14 -28 6 -55 -122 -223 -60 -119 -208 -286 -358 -206 16 68 -4
81 47 -138 -133 -168 -166 -57 -11 -174 -155 -148 -197 -165 22 63 -51
-89 -25 -93 -82 -84 -148 -195 -129 30 127 57 -134 -140 55 213 95
