-616 -652 -684 -663 -654 -632 -612 -606 -598 -584 -586 -585 -587 -573 -568 -369
-571 -330 -267 -190 -234 -211 -214 -170 -162 -166 -206 -220 -199 -97 -221 -229
-611 -424 -251 -216 -201 -96 -111 -35 -39 -97 -199 -258 -240 -222 -280 -231
-575 -456 -284 -276 -224 -22 3 64 16 -105 -184 -224 -248 -297 -337 -320
-561 -538 -309 -323 -97 336 327 277 174 -46 -60 -81 -182 -270 -245 -331
-314 -269 -118 -153 -209 81 252 211 -7 -94 159 349 62 -49 -9 -231
78 -135 -304 -289 -590 -615 -158 -60 -324 -357 25 194 -129 24 164 -172
-372 -476 -335 -299 -640 -628 -211 -173 -454 -531 -446 -400 -533 -445 -144 -302
-445 -477 -363 -409 -513 -291 -37 -122 -476 -647 -439 -244 -336 -505 -216 -113
-264 -152 -196 -339 -633 -251 8 -39 -432 -636 -238 -167 -347 -573 -317 -253
-193 -62 -99 -290 -555 -235 107 28 -217 -272 -244 -592 -825 -563 -367 -211
-162 -62 -112 -236 -331 -69 190 62 -35 -254 -518 -1009 -843 -245 -313 -201
-234 -176 -258 -343 -272 -9 177 184 -208 -576 -916 -753 -360 -134 -183 -273
-365 -295 -215 -194 -170 4 129 103 -434 -985 -809 -240 -138 -75 -170 -333
-360 -205 -114 -49 -35 15 0 -193 -791 -898 -316 -184 -9 -31 -186 -310
-226 -120 -54 -2 -26 -149 -284 -393 -562 -273 -240 -284 -241 -141 -262 -294
