-287 -32 -139 -165 -160 -146 -136 -132 -132 -127 -116 -124 -125 -93 255 229
-311 66 -78 -66 -85 -73 -68 -83 -72 -58 -26 -48 -57 -70 587 275
-457 -116 -250 -168 -186 -251 -227 -251 -224 -239 -227 -232 -241 -303 354 117
-399 -99 -157 12 130 -162 -198 -215 -121 -183 -234 -206 -197 -262 324 124
-302 -58 -31 227 408 -180 -140 -88 27 22 -155 -173 -175 -149 364 120
-160 39 91 415 218 -586 -373 -348 -161 -6 -135 -75 -91 2 332 56
-92 151 221 419 219 -396 -338 -366 -141 143 -21 -149 -51 75 363 108
-225 123 298 436 330 -277 -325 -377 -135 229 279 -139 -158 63 261 79
-140 -93 11 240 30 -364 -259 -391 -154 257 255 -202 -193 193 319 -77
-83 -33 45 192 -29 -395 -197 -337 -193 110 61 -248 -142 368 -17 -271
-130 16 -38 79 -67 -332 -139 -236 -325 -159 -96 -285 -40 197 -186 -220
-117 -12 -57 62 -74 -338 -163 -163 -252 -315 -358 -121 268 81 -95 -100
-140 -126 -171 -79 -194 -244 -124 -166 -261 -593 -302 192 200 -166 -61 -79
-183 -146 -255 -174 -277 -194 -175 -287 -637 -542 53 184 -94 -248 -13 -122
-235 -206 -369 -307 -265 -106 -135 -321 -301 -7 100 -156 -295 -71 39 -136
-233 -268 -300 -192 -163 -167 -144 -54 79 107 -95 -227 -122 -3 -4 -102
