-292 -380 -423 -455 -450 -459 -454 -433 -433 -441 -419 -387 -404 -505 -560 -299
-507 -413 -446 -423 -434 -447 -420 -392 -426 -448 -404 -384 -405 -527 -701 -432
-185 -147 -216 -66 62 81 -29 -74 -128 -191 -149 -105 -127 -227 -357 -301
-192 -214 -336 -165 171 239 -103 -255 -282 -333 -202 -218 -173 -315 -377 -274
-124 -389 -519 -361 68 481 218 -66 -151 -56 185 -56 -167 -340 -348 -270
50 -440 -722 -718 -470 110 397 229 20 42 244 133 84 -162 -301 -314
178 23 -362 -591 -565 -250 16 106 -31 -272 -131 121 423 23 -216 -217
-11 80 -372 -655 -343 37 -138 -44 -107 -350 -362 -80 90 -108 -227 -79
-74 20 -295 -543 -156 284 31 105 68 -277 -334 -203 -142 -390 -155 -166
-142 -132 -313 -498 -381 47 86 108 147 -70 -314 -232 -256 -367 -68 -220
-89 -139 -273 -450 -403 -162 29 71 42 -99 -205 -237 -329 -106 41 -93
-128 -80 -132 -327 -418 -257 49 188 -60 -199 -237 -365 -311 -150 -49 -107
-169 -72 -10 -191 -374 -299 -112 106 -91 -260 -536 -378 -274 -62 -82 -68
-58 -161 -198 -238 -275 -275 -114 58 74 -212 -397 -422 -385 -172 37 12
37 -183 -224 -198 -118 -31 -11 -65 -201 -139 -129 -342 -396 -130 216 59
-38 -124 -142 -69 -66 -47 -83 -182 -213 -162 -175 -363 -348 -45 40 -18
