-431 36 -63 -56 -38 -38 -52 -49 -41 -61 -98 -102 -95 -81 -153 -187
-634 -35 -162 -199 -168 -108 -117 -124 -132 -146 -166 -168 -166 -126 10 -121
-606 -43 -118 -272 -157 126 149 151 76 -39 -186 -215 -113 -78 -30 -128
-671 -140 -64 -298 -134 443 457 264 73 10 -100 -178 -119 -57 47 -87
-460 -187 -160 -447 -612 40 342 279 2 -21 27 -7 -148 -129 66 -55
-192 -136 -198 -484 -1056 -591 -67 116 -127 -322 -346 -165 -243 -184 93 -27
-92 40 -85 -322 -794 -522 -293 -161 -241 -450 -579 -284 -301 -245 95 16
25 156 160 -212 -500 -188 -118 -56 -201 -411 -518 -390 -449 -387 -25 -112
-64 243 268 -276 -692 -374 -191 -24 21 -288 -308 -403 -588 -698 -161 -152
-138 266 321 -83 -647 -492 -257 -148 20 -142 -242 -418 -727 -722 -432 -231
-111 310 203 21 -461 -332 -116 -44 -48 -121 -326 -657 -732 -617 -489 -222
-150 225 167 143 -237 -224 -80 140 138 -235 -573 -729 -470 -347 -404 -170
-215 124 129 131 -55 -89 -133 117 -11 -590 -807 -642 -378 -335 -292 -173
-168 51 -12 19 -1 -9 -137 -59 -346 -649 -535 -370 -417 -400 -217 -163
-144 -31 -164 -46 25 29 -209 -197 -505 -361 -238 -398 -533 -333 -130 -113
-81 -32 -66 -62 -9 39 1 -29 -121 -28 -59 -207 -366 -246 -104 -54
