-109 180 253 233 228 239 244 228 229 263 251 207 224 294 434 223
-669 -594 -457 -361 -402 -421 -365 -395 -354 -327 -335 -409 -385 -247 -145 -268
-508 -206 -57 111 -56 -102 53 45 87 96 48 -115 -86 9 22 -29
-434 -258 -79 341 -68 -304 -39 60 99 99 74 -77 -119 -24 -24 -84
-199 -188 58 538 -85 -450 -73 150 167 11 -113 -209 -49 -61 -42 -39
-107 -264 91 454 -176 -594 -400 -118 46 -85 -102 -143 7 -212 -200 -52
27 -362 -172 274 -152 -533 -335 -116 116 37 -189 -322 -131 -488 -358 -9
-105 -518 -364 25 -376 -569 -254 -156 29 10 -297 -234 62 -448 -349 -1
-254 -513 -343 154 -169 -392 -132 -154 -27 -100 -438 -126 147 -470 -491 -71
-342 -369 -56 380 55 -240 -185 -185 -89 -161 -383 -114 137 -407 -493 -274
-273 -206 -7 318 98 -174 -282 -290 -134 -144 -241 -49 -67 -385 -371 -322
-324 -260 -51 121 -28 -91 -264 -270 -114 47 30 -241 -288 -228 -230 -345
-294 -170 -40 -17 -29 72 -152 -365 -58 251 -65 -448 -275 2 -133 -354
-192 -221 -82 -87 38 120 -225 -386 135 106 -392 -358 69 12 -287 -434
-194 -263 -82 -153 -124 6 -138 1 242 -293 -400 53 256 -155 -517 -379
-156 -240 -146 -119 -49 45 18 -61 -170 -351 -66 198 18 -312 -480 -254
