-246 -205 -183 -199 -188 -191 -178 -166 -161 -157 -157 -170 -162 -96 39 20
-362 -556 -659 -617 -585 -598 -579 -583 -583 -587 -525 -542 -563 -587 -366 -364
-327 -393 -425 -321 -402 -501 -437 -407 -409 -351 -294 -356 -373 -319 -40 -193
-368 -428 -338 -94 -132 -464 -439 -359 -432 -439 -378 -382 -390 -328 3 -143
-330 -529 -481 -82 218 -170 -641 -547 -484 -466 -369 -373 -338 -404 -100 -173
-126 -558 -413 -88 180 193 -349 -347 -136 -59 69 -87 -188 -406 -292 -278
190 -409 -618 -263 33 198 66 -35 46 136 163 70 32 -212 -410 -358
190 13 -347 -173 51 -35 -61 44 33 73 55 150 138 -102 -411 -446
-46 -37 -98 -1 236 -93 -150 23 9 -11 -55 82 82 -96 -214 -373
-133 -295 -305 -22 235 55 -155 -39 -3 -57 -72 60 -11 -154 -181 -232
-161 -407 -383 -64 152 137 -49 -76 -41 -71 -2 -20 -163 -185 -177 -164
-125 -284 -410 -211 31 175 31 -177 -205 4 27 -253 -183 -122 -135 -147
-100 -230 -386 -256 20 149 121 -131 -196 -175 -480 -357 -72 -72 -41 -157
-154 -294 -265 -223 -142 1 70 -37 -221 -503 -549 -248 -121 54 78 -223
-167 -330 -312 -298 -195 0 33 -149 -347 -395 -309 -349 -198 -42 -8 -109
-44 -115 -112 -69 -93 -39 -1 -107 -140 -88 -230 -258 -27 125 63 -70
