-80 -245 -364 -278 -273 -264 -246 -245 -263 -260 -228 -237 -265 -282 -275 -65
-49 -287 -412 -340 -349 -400 -400 -391 -402 -355 -293 -285 -316 -316 -213 -213
-81 -128 -227 -114 -155 -397 -372 -314 -293 -183 -71 -88 -160 -153 -61 -112
-92 -107 -213 -135 -294 -755 -581 -453 -247 -160 -150 -119 -128 -69 -55 -117
-368 -115 -249 -158 -243 -703 -396 -204 -20 42 -177 -248 -65 -33 -69 -156
-355 -7 -259 -37 -23 -322 -109 68 223 229 -27 -164 37 -36 -199 -213
-120 -18 -428 -267 -90 -124 61 187 335 457 178 -10 23 -3 -256 -178
134 14 -169 -139 38 -165 -41 139 336 488 143 -48 25 -25 -403 -309
99 -110 -347 -44 202 -163 -50 53 238 423 44 -248 -15 157 -117 -300
-59 -259 -346 -103 169 -147 15 47 160 293 66 -128 -79 304 0 -234
-138 -255 -292 -135 -14 -181 110 61 82 214 298 159 -39 184 47 -29
-53 -155 -276 -207 -206 -201 96 -16 -43 226 406 272 46 -20 13 71
-6 -232 -437 -306 -183 -95 117 -35 122 348 262 168 -151 -134 113 64
-112 -358 -407 -216 -230 -99 54 8 55 158 257 -29 -280 -115 124 -11
-205 -260 -246 -106 -115 -31 125 77 -19 149 8 -224 -58 5 97 -18
-172 -130 -85 -80 -126 -63 -54 -72 58 54 -223 -99 54 66 47 -56
