-259 -295 -131 -101 -100 -97 -106 -111 -115 -129 -160 -179 -167 -209 -383 -191
-229 -230 -78 -74 -66 -52 -71 -107 -107 -147 -161 -141 -117 -100 -288 -175
-167 -202 -48 23 50 17 12 18 18 1 11 -63 -101 -125 -225 -109
-273 -299 -171 -117 62 143 239 212 191 98 5 -80 -59 -67 -166 -55
-171 -191 -188 -394 -256 -203 -6 -38 -70 -87 37 80 36 -8 -113 30
98 -192 -206 -332 -462 -576 -353 -231 -246 -295 -118 -156 -284 -196 -161 3
-184 -537 -627 -533 -453 -393 -311 -358 -387 -349 -408 -474 -421 -259 -127 -8
-196 -394 -333 -322 -161 -121 -183 -294 -389 -488 -502 -254 -188 -175 -130 -47
-59 95 212 -199 -203 -167 -143 -259 -348 -498 -243 -36 -78 -219 -128 -35
-34 141 251 -69 -131 -280 -316 -396 -236 -238 -168 -134 -260 -310 -209 -151
-74 -43 41 -204 -238 -225 -149 -211 -46 -48 -103 -253 -417 -301 -217 -154
-120 -87 -67 -267 -221 -186 -195 -222 -147 -105 -172 -404 -286 -118 -227 -239
-167 -90 -1 -5 32 -151 -320 -161 66 -16 -385 -563 -181 -71 -249 -255
-94 81 266 236 162 -39 -176 -40 -30 -392 -502 -288 -139 -259 -401 -296
17 71 113 34 7 -60 -112 -103 -208 -194 -113 -137 -306 -380 -320 -139
12 6 40 -27 -12 -20 -115 -158 -107 -6 -68 -187 -369 -371 -178 40
