-164 135 177 120 124 125 120 116 110 106 98 95 102 120 161 -56
-237 282 326 230 227 205 189 178 179 195 247 281 307 355 480 218
-380 103 96 -33 -60 -21 -44 -39 -103 -146 -103 -31 29 160 242 33
-410 -79 -61 -199 -237 -125 -62 -39 -159 -266 -310 -304 -243 -46 83 -34
-465 -360 -178 -68 -121 -74 58 67 -85 -247 -276 -260 -315 -181 0 -62
-272 -395 -450 -235 -125 2 117 188 0 -243 -249 -251 -319 -237 -60 -87
-166 -262 -531 -404 -381 -83 121 123 -85 -231 -129 -140 -311 -225 -108 -172
32 50 118 -89 -375 -137 -12 -56 -188 -291 -183 72 -37 -89 -98 -149
48 352 361 -28 -289 -100 -89 -114 -123 -314 -334 23 97 121 70 22
-86 216 209 -83 -211 -74 -114 -174 -158 -308 -341 -99 -253 -361 -23 20
-150 21 2 -155 -181 -156 -166 -147 -175 -307 -250 -94 -426 -361 -165 -76
-90 70 -29 -143 -189 -166 -178 -185 -255 -287 -252 -154 -196 -91 -114 -81
-135 38 -32 -43 -53 -28 -58 -26 -154 -212 -347 -242 -106 -110 -234 -160
-183 -97 -17 30 -9 28 50 56 -100 -268 -397 -250 -158 -149 -343 -183
-143 -111 -56 40 52 39 127 178 -36 -261 -319 -344 -140 -109 -198 -86
-52 -28 -46 -119 -73 -2 114 152 -13 -120 -197 -199 -98 -134 -105 -38
