-215 -222 -226 -199 -196 -188 -186 -187 -189 -189 -188 -192 -191 -192 -149 -85
-303 -316 -276 -257 -265 -250 -236 -231 -239 -241 -241 -244 -242 -245 -224 -129
-240 -233 -214 -204 -204 -199 -174 -165 -174 -167 -168 -184 -180 -178 -161 -83
-241 -242 -256 -242 -234 -252 -182 -157 -141 -138 -149 -172 -178 -190 -193 -109
-252 -220 -295 -307 -344 -304 -233 -212 -209 -197 -173 -189 -176 -177 -162 -111
-208 -211 -277 -302 -427 -354 -247 -250 -253 -209 -209 -235 -217 -176 -180 -99
-264 -197 -220 -235 -339 -328 -235 -249 -297 -257 -258 -304 -211 -186 -186 -118
-261 -280 -204 -200 -281 -271 -246 -283 -307 -240 -226 -265 -258 -206 -194 -112
-154 -238 -225 -192 -258 -245 -251 -283 -301 -247 -203 -256 -271 -235 -204 -103
-144 -144 -186 -191 -243 -263 -223 -235 -284 -247 -198 -276 -285 -246 -198 -106
-127 -137 -155 -148 -215 -240 -216 -199 -229 -249 -233 -300 -237 -214 -169 -105
-127 -148 -161 -169 -179 -199 -170 -197 -198 -191 -314 -302 -277 -196 -183 -101
-133 -160 -154 -153 -163 -146 -146 -179 -170 -310 -293 -282 -253 -181 -179 -111
-122 -124 -127 -135 -156 -146 -132 -149 -293 -278 -325 -282 -187 -185 -195 -102
-92 -109 -141 -133 -117 -113 -106 -206 -267 -286 -275 -173 -169 -180 -183 -89
-84 -89 -71 -74 -70 -108 -157 -161 -173 -151 -125 -124 -123 -133 -86 -79
