10 243 171 166 163 158 169 173 159 151 155 159 171 149 70 -48
7 397 288 274 303 264 248 239 267 265 273 269 255 213 159 74
43 376 124 7 -38 -143 -137 -154 -143 -18 90 155 186 150 97 -21
68 414 168 -148 -362 -463 -374 -340 -267 -184 -100 42 122 167 174 -23
-345 166 59 -91 -317 -428 -193 17 14 -105 -254 -294 -186 17 77 -33
-448 -119 -146 -211 -241 -470 -301 -25 -59 -175 -204 -230 -192 -74 -84 -109
-305 -376 -607 -538 -466 -551 -417 -174 -123 -141 -166 -395 -276 -153 -143 -82
15 133 -205 -361 -391 -476 -270 -152 -91 -105 -175 -418 -330 -322 -191 -49
-48 197 79 -39 -194 -367 -283 -179 -207 -216 -398 -597 -556 -436 -337 -189
-109 47 -31 -138 -150 -370 -345 -191 -257 -256 -452 -482 -452 -472 -258 -172
-85 107 36 -68 -80 -254 -267 -213 -246 -360 -564 -439 -336 -149 5 -167
-45 101 -20 -215 -281 -393 -415 -367 -524 -483 -413 -279 -268 -1 4 -181
-118 -30 -184 -289 -287 -289 -209 -189 -354 -253 -209 -195 -234 -189 -197 -233
-179 -33 -65 36 38 -24 -124 -264 -223 30 140 -124 -144 -87 -70 -150
-142 -6 15 50 0 -184 -317 -408 -283 -106 -367 -522 -404 -385 -355 -340
101 224 181 160 169 161 109 181 319 359 249 132 172 125 131 41
