539 54 68 66 64 39 22 32 31 6 1 26 22 -79 -312 -459
539 -184 -2 -40 -12 2 -95 -92 -111 -107 -91 -47 -35 -181 -375 -487
392 -254 -106 -256 -121 40 -131 -202 -251 -268 -203 -49 -86 -248 -375 -496
331 -183 -175 -483 -251 168 -125 -350 -454 -437 -170 17 -33 -195 -303 -422
85 -335 -282 -565 -273 249 -57 -436 -558 -485 -102 74 -123 -264 -207 -442
-221 -469 -521 -723 -453 45 -139 -420 -459 -396 -30 -3 -163 -73 -2 -387
-317 -396 -465 -926 -648 -79 -55 -334 -422 -291 -20 -239 -314 181 135 -468
-85 -315 -336 -768 -597 40 -7 -303 -476 -322 -156 -320 -275 319 74 -412
141 -154 -342 -807 -699 87 -52 -267 -505 -373 -167 -241 -89 360 118 -69
250 -122 -402 -793 -667 -11 -103 -229 -470 -338 13 -138 -126 -104 -49 83
216 -151 -350 -622 -527 -69 -57 -127 -326 -302 -98 -115 -140 -217 -58 15
183 -150 -275 -437 -324 -174 -72 -63 -240 -373 -192 32 -62 -172 -37 37
73 -126 -149 -210 -134 -203 -67 -47 -421 -325 -8 90 -317 -216 -160 12
-8 -19 -16 -122 -195 -297 -145 -170 -485 -119 35 -190 -430 -193 -72 52
141 109 -10 -55 -171 -297 -217 -305 -240 82 -145 -488 -332 -84 -33 32
118 38 -116 -139 -198 -222 -183 -91 94 39 -323 -355 -135 -42 8 -38
