-74 -328 -227 -248 -240 -230 -223 -215 -212 -202 -187 -180 -190 -170 -176 -211
-332 -819 -649 -657 -654 -633 -618 -583 -611 -619 -624 -618 -613 -594 -544 -464
-272 -554 -301 -270 -169 -120 -125 -106 -107 -130 -184 -263 -341 -300 -307 -235
-323 -603 -362 -232 -89 -58 -134 -120 -75 -20 -79 -177 -332 -381 -403 -320
-78 -377 -340 -352 -207 -70 104 70 112 238 253 86 -227 -258 -306 -290
80 -79 -89 -124 -107 -35 105 119 148 257 293 322 185 23 -210 -324
253 260 270 91 59 110 164 100 140 230 279 426 353 242 -42 -147
187 9 139 94 96 99 46 -16 56 189 256 463 399 283 9 -31
133 -80 31 72 102 24 65 18 102 209 224 313 221 122 -82 -106
34 -190 -90 0 38 1 49 35 148 264 298 406 311 132 8 -98
9 -221 -125 -36 -12 20 117 120 144 262 346 328 185 -46 -126 -115
-32 -197 -99 -18 7 127 262 240 217 283 316 74 61 -151 -152 -171
-17 -151 -127 -97 -34 80 257 208 199 279 154 -20 -60 -116 -39 -123
-10 -211 -187 -119 -19 63 200 141 159 104 -13 -46 -104 44 43 -117
-66 -169 -138 -105 -73 -12 109 263 176 75 -132 -197 45 209 85 -63
-67 -96 -61 -70 -88 -58 45 80 112 -62 -247 -69 152 188 18 -40
