-454 -243 -367 -249 -244 -227 -214 -214 -208 -186 -201 -220 -211 -32 84 -71
-533 -204 -280 -79 -132 -120 -106 -103 -66 -23 -15 -72 -55 74 314 148
-565 -255 -227 -32 -267 -290 -239 -215 -149 -142 -133 -163 -89 -50 140 18
-509 -263 -131 91 -403 -549 -315 -156 -55 -194 -292 -335 -192 -170 51 -93
-519 -442 -27 415 -212 -663 -347 -49 91 -32 -280 -330 -233 -321 -52 -147
-211 -431 -212 220 -196 -649 -362 -64 41 -34 -354 -297 -215 -473 -182 -146
-15 -240 -70 69 -289 -610 -441 -274 -222 -270 -361 -122 -134 -570 -40 -6
-184 -306 -53 332 -70 -453 -320 -294 -367 -409 -223 -115 -353 -717 74 80
-313 -276 -37 573 54 -468 -229 -274 -350 -417 -141 -65 -352 -461 157 -67
-431 -375 -88 455 24 -475 -177 -197 -292 -362 -142 -181 -485 -321 -122 -252
-422 -258 -30 366 -21 -389 -282 -216 -324 -351 -310 -504 -295 -71 -166 -255
-280 -160 -86 179 56 -122 -253 -290 -274 -329 -683 -570 37 -11 -126 -210
-267 -204 -186 26 78 79 -192 -264 -265 -687 -673 -10 271 -110 -185 -285
-366 -382 -302 -134 -19 122 -58 -147 -458 -753 -197 178 99 -184 -214 -324
-381 -360 -234 -100 18 103 -142 -363 -573 -391 -91 -1 -17 -86 -101 -337
-283 -246 -214 -200 -139 -134 -233 -257 -169 -101 -93 -62 -104 -111 -37 -185
