54 207 5 38 28 30 34 34 32 37 53 48 45 52 170 74
265 289 45 85 57 27 24 5 31 71 105 81 92 72 186 73
301 271 110 187 87 -15 99 73 65 70 60 73 135 127 188 75
299 342 224 265 -164 -635 -432 -409 -453 -399 -217 1 118 145 253 120
97 196 278 353 -446 -1316 -1037 -888 -821 -606 -567 -473 -178 110 230 149
-420 -380 82 205 -291 -831 -420 -321 -231 -189 -645 -853 -586 -197 -26 22
-565 -641 -382 -324 -481 -510 -200 -171 -76 -111 -302 -540 -552 -522 -300 -142
-274 -429 -518 -634 -630 -589 -255 -140 -112 -130 -193 -547 -769 -599 -275 -165
-116 -79 -220 -88 -274 -612 -283 -165 -167 -177 -297 -725 -832 -385 -208 -290
-63 -140 -71 67 -140 -529 -293 -220 -220 -327 -612 -872 -760 -77 -247 -220
-103 -143 -76 -3 -165 -438 -366 -335 -266 -449 -809 -872 -186 141 -164 -49
-35 -84 -8 -8 -253 -443 -463 -443 -345 -643 -1045 -444 194 -84 -107 74
77 25 -1 -182 -468 -580 -602 -646 -795 -1145 -644 212 87 -359 -151 37
-27 -244 -487 -661 -610 -396 -332 -541 -795 -551 122 135 -351 -485 -211 11
-196 -462 -467 -252 -53 -89 -414 -692 -411 55 136 -157 -417 -436 -183 -1
-149 -230 -116 -40 -11 -124 -328 -297 -28 -40 -74 -175 -266 -185 -145 -67
