-244 -322 -378 -330 -325 -335 -318 -305 -309 -318 -293 -296 -320 -352 -413 -182
1 57 -30 12 66 22 41 23 19 28 76 72 15 -49 -200 -27
-123 -29 -168 -19 170 41 43 38 32 48 57 -7 -85 -173 -273 -123
-131 -1 -167 -58 252 -10 -131 -174 -209 -64 60 105 15 -103 -236 -94
-107 66 -98 -73 213 -142 -361 -355 -266 -54 -29 65 95 40 -143 -71
-349 -66 -13 0 249 107 -42 -90 -55 170 109 91 57 148 -105 -34
-327 -71 -332 -256 73 15 -7 -48 -139 55 319 310 331 468 -82 44
-121 127 -231 -152 159 -123 -59 -123 -239 -106 196 179 174 279 -68 -32
-59 -43 -346 -100 311 -52 -33 -86 -209 -131 0 42 -37 26 -73 -174
38 -75 -303 -173 269 17 93 76 -73 -162 -137 41 -133 12 27 -172
6 -117 -282 -233 194 74 213 111 -92 -128 -152 -19 -280 -77 87 -78
69 11 -116 -112 73 62 263 162 -58 -104 -185 -252 -303 -40 107 -46
62 -5 -146 -142 5 9 205 -41 -252 -250 -359 -406 -150 3 128 -59
-23 -145 -277 -311 -225 -75 197 0 -184 -313 -473 -285 -140 -4 119 -88
-77 -209 -220 -154 0 60 110 -255 -347 -352 -199 -221 3 133 197 -118
-115 -121 -64 -66 -73 -64 -21 -253 -348 -198 -175 -144 93 111 142 -76
