0 9 9 9 8 9 9 10 10 10 11 11 11 11 12 12 13 13 13 13 13 13 13 14 15 15 15 15 16 16 17 102 
0 8 6 6 5 6 7 7 7 7 8 8 7 8 8 8 9 10 10 10 8 7 11 13 10 11 11 11 12 12 12 126 
0 7 6 6 5 5 7 8 7 7 8 8 8 9 9 9 9 10 11 10 9 8 12 14 11 11 11 12 12 12 13 126 
0 7 5 7 6 5 7 9 8 8 8 8 8 9 10 9 9 9 10 11 10 9 10 11 11 11 11 13 13 12 12 126 
0 7 6 7 6 6 8 9 9 8 8 9 8 9 10 10 10 10 10 11 11 10 10 10 11 11 11 12 13 12 12 126 
0 7 7 8 7 6 9 10 9 8 8 8 7 8 9 9 10 9 9 11 12 11 11 11 11 11 11 12 12 13 12 126 
0 7 7 9 8 8 10 11 9 10 14 15 15 17 19 19 19 20 21 18 13 14 13 12 12 12 11 12 13 13 13 127 
0 8 8 9 9 9 11 11 12 27 38 38 39 39 38 37 36 34 26 20 24 22 14 12 12 12 12 12 12 13 13 128 
0 10 9 9 10 10 10 11 39 62 34 18 18 14 11 10 12 7 0 0 18 8 0 9 17 14 12 12 12 13 13 129 
0 10 2 9 11 10 9 13 60 88 33 10 13 11 7 2 4 3 0 0 2 0 0 18 24 16 13 13 13 13 13 130 
0 13 2 12 11 11 9 14 66 95 34 11 14 14 11 6 4 6 0 0 19 13 1 11 0 0 10 15 16 16 15 134 
0 0 1 14 12 11 10 16 68 97 35 10 14 8 5 3 3 6 0 0 31 31 0 0 0 0 0 20 25 23 27 140 
0 0 0 0 0 11 12 30 78 102 41 17 17 6 5 2 0 5 0 0 38 32 0 0 10 0 0 35 29 26 30 128 
0 0 0 0 0 31 60 53 52 87 35 18 18 7 8 4 3 4 0 3 38 12 0 22 17 0 3 40 9 5 6 84 
0 0 0 0 0 20 61 51 10 45 26 23 19 6 8 4 5 9 0 0 15 0 0 43 40 0 1 18 0 0 0 82 
0 2 0 0 0 0 7 14 11 27 19 24 18 7 7 6 3 9 0 0 4 18 3 41 44 0 0 0 0 7 20 113 
0 6 9 12 11 10 11 15 43 52 20 16 13 7 7 8 4 3 0 0 15 21 20 46 29 1 0 0 26 43 40 103 
0 8 11 10 9 8 9 17 51 62 22 12 10 4 4 10 8 3 0 0 1 12 45 50 26 0 0 0 32 48 34 89 
0 7 9 11 14 14 14 20 50 57 22 5 0 8 16 14 9 5 0 0 1 41 59 38 19 0 0 0 38 47 25 86 
0 15 14 11 9 7 5 11 42 53 19 2 0 12 31 18 8 4 0 0 14 41 28 31 30 0 0 0 46 38 18 84 
0 4 3 4 4 6 10 19 53 57 16 7 0 12 32 17 5 8 9 6 18 9 0 29 10 0 0 23 51 22 8 80 
0 9 10 12 17 17 17 19 45 57 20 9 4 8 21 13 7 17 15 0 14 0 0 17 0 0 0 42 43 15 14 80 
0 16 16 16 17 15 13 13 41 57 23 12 11 2 8 6 1 9 9 5 12 0 0 0 0 0 23 48 29 6 16 81 
0 13 10 10 12 11 10 21 43 39 11 18 14 3 15 12 8 6 0 15 29 0 0 0 0 19 41 47 21 7 15 79 
0 13 9 7 8 9 14 24 30 32 29 27 8 1 24 16 9 16 12 23 16 0 0 0 14 28 50 34 7 7 16 81 
0 10 9 10 8 13 22 34 47 47 34 25 11 0 9 9 0 5 11 3 0 0 0 10 18 38 49 25 11 12 16 82 
0 9 9 14 20 29 35 35 33 26 16 15 11 6 6 7 3 1 0 0 0 0 1 10 22 51 52 13 0 3 20 80 
0 11 18 30 36 34 25 17 16 16 11 10 7 9 14 7 4 0 0 0 0 0 10 10 33 56 39 11 0 0 19 77 
0 27 34 34 26 18 13 9 10 12 11 8 4 6 14 9 2 0 0 0 0 6 8 17 46 52 12 0 6 16 24 76 
0 33 25 17 14 10 9 8 8 11 11 9 5 5 9 0 0 0 0 0 10 8 11 28 54 39 0 0 10 25 23 68 
0 16 10 9 11 9 6 7 8 10 10 7 8 7 0 0 0 0 5 12 10 11 18 42 44 13 0 4 22 32 21 62 
0 19 18 21 23 20 16 17 21 21 19 19 20 8 0 4 21 41 55 57 54 57 69 78 54 32 51 43 35 43 39 89 
