200 94 96 96 99 100 100 100 102 102 103 103 104 105 106 108 108 108 109 109 108 109 111 111 112 112 112 114 113 113 113 118 
65 6 6 6 7 7 7 7 7 7 7 6 6 6 6 7 7 8 6 6 4 10 10 5 7 6 7 7 6 7 7 67 
65 6 7 7 6 7 7 7 7 7 7 7 7 7 7 7 8 9 8 7 7 8 9 8 8 7 7 8 7 8 8 67 
67 6 8 7 7 8 8 7 8 7 8 6 6 7 7 7 7 7 9 7 5 4 6 8 8 7 8 9 7 8 8 68 
67 7 7 7 7 7 8 8 8 8 7 7 7 8 8 8 8 8 8 7 7 7 7 8 8 7 8 9 8 8 8 68 
67 7 7 7 7 7 7 7 7 7 5 5 5 6 6 6 5 5 6 7 7 7 8 7 7 7 7 7 8 8 7 68 
68 6 8 7 7 7 7 7 8 12 13 14 16 18 18 18 19 18 13 8 9 10 9 8 8 7 7 8 8 8 7 68 
68 8 7 8 7 7 7 5 16 20 26 30 28 27 28 27 24 21 18 31 21 10 13 11 6 7 8 7 8 8 7 69 
69 9 9 7 7 7 7 8 13 0 0 0 0 0 0 0 0 0 0 19 6 0 23 21 10 9 7 8 7 7 7 69 
68 0 15 9 7 7 7 10 22 0 0 2 2 0 0 0 6 2 0 0 8 18 28 26 19 18 11 8 8 8 8 71 
64 17 24 9 8 6 6 8 26 0 0 13 14 13 12 8 10 8 0 26 13 0 1 0 0 29 23 12 11 12 13 73 
0 40 28 30 11 9 7 11 29 0 0 9 3 6 9 9 12 5 0 17 10 0 0 5 0 0 39 21 19 19 24 64 
0 0 0 41 29 5 18 20 43 3 6 15 5 11 10 10 16 19 13 19 17 0 13 14 0 0 41 0 19 6 17 48 
3 0 0 30 59 33 32 0 44 9 7 15 9 14 11 10 15 9 12 22 12 0 33 0 0 0 9 0 0 0 0 28 
38 6 0 0 0 6 7 0 3 16 21 12 6 8 11 9 14 7 0 12 14 11 23 26 0 0 0 0 0 0 14 50 
54 11 8 0 0 0 0 19 2 0 16 12 10 8 9 9 10 20 1 18 41 4 3 34 2 22 18 54 37 30 23 56 
59 28 25 31 30 27 27 30 30 0 0 13 11 8 9 8 6 10 6 37 15 3 26 0 19 28 12 60 22 8 0 53 
49 12 9 8 7 10 11 17 22 0 7 11 10 6 9 13 7 8 0 10 0 39 4 1 7 0 11 20 11 0 4 52 
42 8 13 16 16 13 10 11 18 1 7 6 21 24 5 8 12 11 0 9 52 15 0 3 0 0 7 25 15 0 14 45 
49 12 5 1 0 0 0 6 21 0 10 10 18 28 10 5 12 7 8 10 11 0 27 36 0 0 20 16 2 3 17 44 
27 0 5 10 12 18 20 21 26 0 14 11 7 21 12 7 13 9 0 0 0 0 35 4 0 17 29 8 0 2 13 46 
54 21 19 21 17 9 6 8 26 9 3 10 4 10 16 15 18 13 0 13 25 6 25 0 14 23 8 8 3 22 9 44 
49 11 10 6 3 4 7 14 30 8 7 12 0 3 6 3 6 13 14 20 3 11 9 37 40 6 6 1 2 14 13 46 
31 1 6 8 9 9 14 15 3 0 16 17 6 27 15 11 13 5 16 32 0 0 0 40 13 11 12 3 13 8 12 43 
40 8 9 8 11 11 12 3 14 30 10 1 5 26 18 12 25 23 11 11 0 12 47 8 3 15 3 0 18 9 17 40 
38 11 14 10 14 22 26 34 30 4 5 9 0 0 2 1 0 5 0 0 0 41 14 1 13 16 0 22 17 13 13 45 
37 11 14 19 21 14 5 0 0 3 14 14 10 10 7 10 6 6 0 9 44 15 0 13 18 10 0 0 2 27 11 44 
40 17 22 15 2 0 0 7 16 15 10 13 15 21 11 9 13 0 4 42 16 0 10 11 17 0 10 10 0 10 12 39 
47 17 3 0 0 9 13 12 10 11 10 10 9 15 16 10 0 0 28 24 0 8 11 12 11 0 11 28 33 7 10 43 
26 0 0 9 14 12 12 10 12 13 11 9 7 9 9 0 7 37 17 1 10 11 12 18 4 3 11 14 10 6 5 39 
3 7 14 13 10 7 11 13 11 11 12 13 11 0 0 6 41 26 6 6 10 11 11 11 0 26 16 15 23 11 6 41 
30 26 26 25 25 23 25 27 27 25 26 29 27 39 77 89 62 60 72 67 69 65 62 43 49 69 49 22 40 49 54 67 
