16 6 5 4 4 4 3 2 3 2 1 0 0 0 0 0 0 0 0 0 0 0 0 0 0 0 0 0 0 0 0 0 
24 16 15 15 16 15 14 14 15 15 15 14 14 13 12 12 13 13 14 14 13 11 11 12 12 12 11 12 12 12 11 22 
23 15 15 14 14 14 14 14 15 15 14 14 14 13 11 11 12 12 13 14 12 12 12 11 10 10 10 10 11 11 11 22 
23 15 14 13 14 14 13 13 15 15 15 15 14 13 11 11 12 12 13 13 12 11 11 10 10 10 9 10 10 10 11 22 
22 15 14 13 14 14 14 13 14 15 15 14 14 12 11 11 12 12 12 13 11 10 10 9 10 10 9 10 10 10 11 22 
21 14 14 13 14 14 14 14 15 15 14 12 11 10 10 10 10 10 10 10 9 9 9 9 9 10 10 10 10 10 11 22 
19 13 13 13 14 14 14 13 13 13 11 9 7 6 5 5 6 5 6 4 5 7 8 8 9 9 9 10 10 10 10 22 
18 12 12 11 12 13 12 11 5 7 7 4 4 3 3 3 3 3 5 1 2 7 7 8 9 9 9 9 9 9 9 21 
15 12 10 11 11 11 11 9 2 5 9 10 8 7 7 8 8 6 2 5 6 7 9 8 8 8 8 8 8 8 8 20 
14 11 10 10 9 9 10 7 7 2 0 2 1 0 0 0 0 0 0 0 1 3 5 9 11 8 7 7 7 7 7 20 
19 7 10 7 8 7 8 7 7 0 0 0 0 0 0 0 0 0 0 0 0 0 11 12 11 14 6 6 6 6 5 22 
12 8 14 7 6 8 6 6 6 0 0 0 2 0 0 0 0 0 0 1 4 4 10 10 4 11 7 8 4 6 5 25 
0 4 13 15 7 7 0 8 6 0 0 1 2 0 0 0 0 0 0 1 5 5 0 0 2 0 7 9 9 8 10 27 
0 3 0 7 8 1 0 0 13 0 0 2 1 1 0 0 0 0 1 3 6 0 0 0 0 0 13 10 13 12 12 20 
0 1 0 0 8 5 13 0 10 3 0 1 0 0 0 0 1 0 1 6 3 0 0 0 0 0 17 5 8 5 5 8 
0 0 0 0 2 6 11 0 0 0 1 1 0 0 0 0 0 0 0 0 0 0 0 4 0 0 10 0 0 0 0 6 
0 0 0 0 0 0 0 0 0 0 0 2 0 0 0 0 0 0 0 0 0 0 0 2 0 1 1 1 0 0 0 12 
0 0 0 0 0 0 0 0 3 0 0 0 0 0 0 0 0 0 0 0 0 0 0 0 0 5 1 6 2 3 0 10 
0 0 0 0 0 0 0 0 2 0 0 0 0 0 0 0 0 0 0 0 0 0 1 0 4 1 0 3 2 0 0 9 
0 0 0 0 0 0 0 0 0 0 0 0 0 0 0 0 0 0 0 0 0 6 2 4 1 0 0 0 2 0 0 9 
0 0 0 0 0 0 0 0 0 0 0 0 0 2 0 0 0 0 0 0 0 5 1 8 0 0 0 0 0 0 2 9 
0 0 0 0 0 0 0 0 3 0 0 0 0 3 0 0 0 0 0 0 1 0 3 3 0 0 0 1 0 0 0 9 
0 0 0 0 0 0 0 0 5 3 1 1 2 1 0 0 0 3 0 0 0 0 6 0 0 0 0 2 0 0 0 9 
0 0 0 0 0 0 0 0 8 3 1 2 1 0 0 0 0 0 0 0 0 1 0 0 0 0 0 2 0 0 0 9 
0 0 0 0 1 0 1 5 6 1 0 1 0 2 0 0 1 0 0 2 2 0 0 0 0 0 3 0 0 0 0 8 
0 0 0 0 1 1 3 4 1 2 2 1 0 2 4 0 2 2 1 5 0 0 0 0 0 0 0 0 0 0 0 8 
0 0 0 0 1 3 6 7 8 5 4 2 0 0 0 0 0 0 0 0 0 0 0 0 0 1 0 0 1 0 0 9 
0 0 0 0 4 6 7 6 3 0 0 1 0 0 0 0 0 0 0 0 0 0 0 0 0 1 0 0 0 0 0 9 
0 0 3 5 5 5 2 0 0 0 0 0 0 1 0 0 1 0 0 0 0 0 0 0 0 0 0 0 0 0 0 8 
5 6 5 4 1 0 0 0 0 0 0 0 0 0 1 1 0 0 0 0 0 0 0 0 2 0 0 0 0 0 0 8 
7 6 2 0 0 0 0 0 0 1 2 1 0 0 0 0 0 0 0 0 0 0 0 0 0 0 0 0 0 0 0 5 
3 0 0 0 0 0 0 0 0 0 0 0 0 0 0 0 0 0 0 0 0 0 0 0 0 0 0 0 4 2 0 13 
