26 26 27 28 28 28 28 28 28 28 29 29 30 31 31 31 30 31 30 30 31 32 33 32 32 32 32 32 32 32 32 0 
0 2 2 3 3 3 4 3 2 3 3 4 4 5 6 5 4 4 4 4 7 8 5 5 6 7 7 6 6 6 6 0 
0 3 4 4 3 4 4 4 3 3 4 5 5 5 6 6 6 4 4 4 8 7 4 6 7 7 7 7 7 6 6 0 
0 4 4 4 4 4 4 4 3 4 4 5 6 6 7 7 6 5 5 5 7 7 7 8 8 8 8 7 7 7 6 0 
0 4 4 4 4 4 4 3 2 3 4 5 6 7 7 7 7 7 6 5 7 7 8 8 7 8 8 6 7 7 7 0 
0 4 4 4 4 4 4 3 3 3 4 6 7 7 8 7 7 8 8 7 7 8 8 7 7 8 7 7 7 7 7 0 
0 4 4 5 5 4 4 4 5 4 1 1 2 0 0 0 0 0 0 0 6 5 4 6 7 7 7 7 7 7 7 0 
0 4 4 5 5 4 4 6 12 0 0 0 0 0 0 0 0 0 0 0 0 0 0 5 7 8 8 8 7 7 8 0 
1 2 3 5 6 6 6 9 0 0 0 0 0 0 0 0 0 0 13 2 0 3 8 4 3 5 8 8 8 8 8 0 
0 0 4 6 6 6 7 8 0 0 3 0 3 5 8 8 6 14 24 7 8 14 0 0 0 0 5 8 8 8 9 0 
0 0 0 1 6 7 8 6 0 0 8 4 3 5 8 10 9 15 23 10 3 5 0 0 5 0 0 6 7 6 8 0 
0 3 0 0 1 9 10 5 0 0 12 7 5 9 12 13 11 13 29 11 0 3 3 8 17 9 5 0 0 0 0 0 
15 1 3 0 1 9 18 0 0 0 8 3 6 12 14 14 12 13 23 6 0 6 20 15 5 21 0 0 0 0 0 0 
15 5 48 27 0 0 0 0 0 0 7 3 8 10 13 14 10 13 17 0 0 26 19 3 12 26 0 0 0 0 0 0 
16 13 52 33 0 0 0 7 0 2 6 0 7 10 13 16 7 10 18 3 7 44 9 0 12 21 0 14 26 36 23 0 
14 19 28 24 17 14 1 29 11 16 4 0 7 10 12 15 10 7 17 19 16 22 13 0 6 21 3 28 29 30 6 0 
16 18 13 16 17 14 16 13 0 5 3 4 8 11 12 14 14 9 27 23 0 16 12 0 16 5 17 13 5 0 0 0 
15 12 11 12 13 13 13 6 0 0 8 5 7 16 17 12 13 14 33 6 12 23 0 0 8 5 30 4 0 0 10 0 
13 13 13 11 9 8 9 1 0 2 7 11 12 13 13 9 13 14 28 18 20 0 0 4 9 27 40 13 0 0 10 0 
10 7 7 9 10 12 15 11 0 6 8 18 15 2 4 8 11 16 26 22 0 0 0 2 5 38 46 11 0 4 6 0 
8 13 16 17 18 17 15 7 0 7 10 14 14 0 0 9 11 18 23 10 0 11 12 0 21 59 35 0 0 13 10 0 
14 14 13 12 9 6 6 3 0 6 7 11 12 0 3 11 7 7 20 21 3 23 0 0 52 54 13 0 4 13 7 0 
11 6 5 4 6 8 9 9 0 0 4 6 6 7 10 12 10 7 20 18 8 21 2 30 43 22 1 0 13 12 8 0 
6 8 8 7 10 13 13 4 0 2 13 0 5 6 6 8 6 11 21 2 2 15 42 43 16 8 0 0 13 12 9 0 
7 10 11 11 11 14 8 0 0 8 0 0 13 0 0 3 0 2 7 0 4 47 56 18 8 4 0 6 14 14 7 0 
8 12 10 12 11 10 0 0 0 0 0 0 10 2 1 7 6 2 3 0 49 70 24 7 12 0 0 11 3 9 5 0 
10 13 12 12 4 0 0 0 0 0 3 3 7 8 8 7 11 7 9 37 68 31 9 14 9 0 0 11 16 10 5 0 
12 13 5 0 0 0 0 0 1 5 5 5 9 5 5 7 9 9 35 58 34 10 15 14 0 0 1 11 29 16 7 0 
8 0 0 0 0 0 5 5 4 4 5 6 10 4 4 6 4 34 63 33 14 15 15 12 0 0 16 19 20 6 3 0 
0 0 0 1 5 5 4 5 5 4 4 5 10 7 4 10 32 57 40 13 16 16 14 4 0 8 26 19 6 5 6 0 
0 0 7 7 5 6 6 6 6 5 5 7 8 4 14 46 56 29 13 12 16 14 12 0 0 18 24 11 0 0 7 0 
0 0 0 0 0 0 0 0 0 0 0 0 0 5 16 13 0 0 0 0 0 0 0 0 0 0 0 0 0 0 0 0 
