54 43 43 42 42 42 42 41 41 41 40 39 38 38 37 37 37 37 37 37 36 36 35 34 35 34 34 33 33 33 33 80 
76 43 43 42 42 42 41 40 39 38 37 35 35 34 33 32 32 32 31 31 29 30 29 27 28 27 26 25 25 25 25 50 
76 41 42 41 40 40 40 38 37 36 36 34 33 33 31 31 30 30 30 30 29 29 28 26 27 27 26 25 24 25 25 50 
76 40 41 40 38 39 38 36 35 35 34 33 32 31 30 29 29 28 29 29 28 27 26 26 27 26 25 25 24 24 24 51 
76 39 39 38 37 37 36 34 33 34 34 33 32 31 30 29 29 28 28 28 27 26 26 26 26 25 25 24 24 24 24 50 
76 38 38 36 35 35 34 32 31 32 32 31 30 30 28 28 27 27 27 26 26 25 25 25 25 25 25 24 24 24 23 50 
75 36 36 34 33 33 33 31 31 32 32 33 33 33 32 31 31 31 27 25 24 23 24 24 24 24 24 23 23 23 23 49 
75 33 33 32 32 31 31 29 41 37 38 41 39 38 36 35 34 31 22 27 26 19 23 24 22 22 23 23 22 22 22 49 
75 29 32 30 29 29 29 30 45 18 11 14 12 10 9 9 10 7 4 16 13 9 21 25 22 22 22 21 21 21 21 48 
73 23 30 28 27 27 27 30 38 0 0 6 5 5 4 4 6 4 3 11 9 12 30 30 22 25 22 20 20 20 20 47 
63 27 31 27 24 24 25 28 32 0 0 3 2 3 3 1 3 1 0 9 13 7 18 20 18 22 26 21 20 20 24 46 
42 32 24 29 24 21 24 25 28 0 0 0 0 0 0 0 0 0 0 5 3 0 3 14 19 12 32 21 26 24 30 40 
30 26 2 21 25 19 34 20 30 0 0 0 0 0 0 0 0 0 0 7 1 0 9 19 12 11 41 18 26 23 28 27 
20 6 0 25 34 30 44 6 19 0 0 0 0 1 0 0 0 0 0 6 0 0 13 13 0 6 27 0 9 7 11 16 
20 0 5 22 22 18 12 0 6 0 0 0 0 1 0 0 0 0 0 0 0 0 10 7 0 0 0 0 0 0 9 24 
26 0 2 4 0 0 0 0 7 0 0 0 0 1 1 0 0 0 0 3 10 1 8 0 0 0 0 6 15 21 18 26 
34 5 5 6 8 8 7 9 14 0 0 0 0 0 0 0 0 0 0 16 6 0 8 0 0 1 0 26 22 16 1 11 
41 7 6 6 5 6 6 9 9 0 0 0 0 0 0 0 0 0 0 7 0 7 1 0 0 0 2 24 14 0 0 10 
42 7 8 8 8 8 8 8 7 0 0 0 0 5 0 0 0 0 0 0 13 7 0 0 0 0 7 24 11 0 0 9 
43 9 7 5 3 2 2 2 6 0 0 0 4 10 1 0 0 1 0 3 7 0 0 3 0 0 18 24 4 0 0 8 
36 0 0 2 4 6 8 8 9 0 0 4 7 9 0 0 1 5 0 0 0 0 8 0 0 2 25 18 0 0 0 9 
38 6 8 10 10 9 6 3 4 0 0 6 6 8 3 1 5 4 0 0 0 0 9 0 0 16 22 6 0 0 0 10 
42 7 7 8 5 1 0 3 7 0 3 10 3 8 4 1 4 0 0 4 0 0 0 1 15 18 14 0 0 0 0 9 
38 2 3 3 2 0 2 6 1 0 7 12 4 15 11 5 8 5 4 13 0 0 0 15 14 12 8 0 0 0 0 8 
35 2 3 1 2 2 4 3 3 8 14 10 7 18 13 9 11 14 14 10 0 0 21 19 8 12 0 0 0 0 0 8 
34 2 4 3 5 9 13 16 19 12 8 6 7 9 5 6 6 9 4 0 0 18 21 8 7 11 0 0 2 2 0 8 
33 4 7 9 14 16 16 13 8 3 6 7 5 9 6 7 8 8 0 0 14 24 9 4 12 4 0 0 0 3 0 7 
35 10 14 16 13 10 7 8 9 11 11 10 8 11 8 7 9 0 0 13 18 9 3 7 13 0 0 0 0 0 0 6 
41 17 14 10 7 7 10 12 13 12 11 11 11 11 8 6 0 0 7 18 6 2 3 9 6 0 0 0 6 3 0 7 
37 11 8 9 10 12 13 13 12 12 11 10 11 11 6 0 0 7 16 8 1 4 6 12 0 0 0 3 4 0 0 6 
24 8 12 14 13 11 12 13 13 12 10 11 11 5 0 0 11 17 9 3 3 5 9 6 0 0 5 5 7 0 0 9 
24 20 22 21 19 18 19 20 20 19 19 20 18 17 27 42 46 37 33 33 35 35 33 20 14 27 27 20 19 17 18 18 
