0 0 0 0 0 0 0 0 0 0 0 0 0 0 0 0 0 0 0 0 0 0 0 0 0 0 0 0 0 0 0 0 
0 19 17 18 17 17 17 18 17 17 17 18 17 17 18 17 18 18 19 18 20 14 15 22 20 19 20 19 20 20 20 0 
0 19 16 17 17 16 16 17 17 17 17 17 16 16 17 18 17 17 18 17 18 17 18 21 18 18 18 17 20 19 19 0 
0 18 15 17 17 16 15 17 17 18 17 18 17 17 18 18 19 19 18 18 20 20 20 19 19 19 18 18 21 20 20 0 
0 17 15 16 17 16 15 17 17 17 17 17 17 17 18 18 19 19 18 18 18 18 18 19 19 20 19 19 21 20 20 0 
0 17 15 17 17 16 16 18 18 16 17 17 17 16 18 18 18 18 17 17 17 18 18 19 19 20 19 20 19 20 20 0 
0 16 14 16 16 16 16 18 16 13 13 11 10 10 12 12 10 11 15 14 14 17 18 18 18 19 18 19 19 19 19 0 
0 15 15 15 16 16 17 18 1 17 21 15 19 21 21 21 22 26 27 3 11 28 17 15 19 19 18 19 19 19 19 0 
0 18 13 15 17 17 17 15 0 79 78 57 62 61 60 56 52 56 50 10 28 43 10 8 20 18 18 19 19 19 19 0 
0 30 7 14 16 17 16 11 0 67 44 17 18 20 21 19 12 18 27 10 18 28 6 15 28 15 15 18 18 18 19 0 
0 21 2 13 15 17 17 11 0 54 29 4 8 9 9 10 5 12 23 0 10 55 36 42 44 15 4 16 18 19 16 0 
0 6 21 2 10 15 16 11 0 53 35 9 20 16 11 12 6 14 26 0 12 63 41 20 35 42 0 20 20 24 14 0 
9 31 74 0 0 17 0 26 0 45 28 6 21 11 9 12 2 6 14 0 7 48 0 0 29 38 0 52 30 42 23 0 
0 23 66 0 0 5 0 89 0 42 24 7 21 9 10 14 5 15 20 0 13 41 0 6 47 31 0 75 46 51 30 0 
0 0 24 26 27 37 27 79 10 29 10 11 23 13 11 16 10 18 33 8 2 17 0 0 45 33 7 45 17 16 0 0 
0 0 3 31 43 42 26 14 0 33 14 16 17 12 10 14 14 7 30 0 0 22 4 0 39 1 1 0 0 0 0 0 
0 0 0 0 0 0 0 0 0 42 27 15 13 11 9 12 18 13 26 0 6 18 0 31 27 9 21 0 0 19 41 0 
0 13 17 16 17 16 15 8 0 42 21 14 11 8 9 10 18 13 28 4 18 0 22 39 36 52 26 0 15 39 31 0 
0 16 15 12 13 15 17 13 2 40 21 19 2 0 13 17 14 11 24 4 0 14 43 29 40 51 8 0 12 39 16 0 
0 14 19 22 24 23 21 13 0 43 16 16 5 0 17 23 12 10 13 11 11 50 15 0 43 31 0 0 28 38 9 0 
0 20 15 11 10 5 4 3 0 45 16 16 18 3 20 23 10 7 23 24 27 50 0 19 45 0 0 2 44 30 8 0 
0 3 5 4 9 16 18 18 0 37 27 17 25 16 17 17 9 9 32 13 12 32 0 22 1 0 0 17 38 7 9 0 
0 17 20 21 24 23 18 12 0 38 24 11 30 16 16 22 15 11 16 1 30 28 8 0 0 0 7 31 34 9 9 0 
0 26 21 18 14 15 10 14 25 38 11 7 25 0 6 16 9 15 11 0 41 40 3 0 0 9 14 37 19 12 8 0 
0 17 14 15 11 13 15 23 16 9 15 22 26 0 11 19 6 6 18 16 51 1 0 0 17 8 30 40 8 12 4 0 
0 14 9 13 10 9 10 8 11 30 24 18 26 23 22 25 27 18 30 36 19 0 0 17 13 8 39 21 11 8 8 0 
0 13 10 11 15 25 36 43 38 31 15 10 12 5 10 10 13 10 20 0 0 0 16 14 5 20 48 32 24 0 12 0 
0 11 12 24 38 42 38 23 11 10 12 10 8 0 8 10 5 17 3 0 0 10 15 13 5 37 32 11 19 3 13 0 
0 20 36 39 35 22 14 10 10 10 11 11 11 4 9 13 14 8 0 0 14 15 13 10 14 49 24 0 0 11 17 0 
0 39 37 21 13 11 10 10 9 8 10 10 10 9 15 21 0 0 0 5 16 13 12 5 31 34 15 5 8 21 24 0 
0 24 13 9 10 14 10 8 9 9 10 7 8 16 17 0 0 0 4 17 16 14 12 17 47 5 5 12 6 19 21 0 
0 4 1 2 4 6 4 1 2 4 4 1 2 0 0 0 0 2 3 8 4 7 9 23 24 0 10 33 16 13 8 0 
