70 0 0 0 0 0 0 0 0 0 0 0 0 0 0 0 0 0 0 0 0 0 0 0 0 0 0 0 0 0 0 0 
105 13 14 14 16 15 14 14 14 14 13 14 15 15 15 16 16 14 14 14 17 18 14 14 16 16 15 15 15 16 16 0 
106 14 15 14 15 15 14 13 14 14 14 14 15 15 15 16 16 15 14 14 15 18 17 16 16 16 16 15 15 16 16 0 
108 14 14 14 15 15 14 13 13 14 14 14 15 16 15 16 16 16 15 14 14 17 18 17 17 17 17 16 15 16 16 0 
109 14 14 14 15 15 14 13 14 14 14 15 16 16 16 16 16 16 16 15 15 16 17 17 17 17 17 17 15 15 16 0 
110 14 14 13 14 14 13 13 14 14 14 15 17 17 16 16 16 16 16 15 16 17 16 16 16 17 17 17 16 15 15 0 
112 15 15 14 14 14 13 13 13 13 14 16 18 19 19 19 19 19 22 20 17 18 19 17 16 17 17 16 16 15 15 0 
114 16 16 14 14 14 14 14 0 0 18 24 26 30 32 31 29 33 47 37 21 29 30 19 16 17 17 17 17 16 16 0 
112 19 19 16 15 15 16 13 0 0 15 29 29 31 35 37 33 37 55 51 32 41 42 25 19 19 17 17 17 16 17 0 
109 27 25 17 15 15 18 13 0 0 1 17 14 16 18 23 22 22 35 39 25 33 40 33 37 33 21 17 17 17 17 0 
114 43 37 21 17 16 17 14 0 0 0 12 12 14 16 20 20 17 36 33 0 15 41 38 48 58 35 19 19 20 16 0 
98 56 67 48 23 17 17 15 0 0 0 8 11 17 18 22 21 18 30 29 0 2 35 30 24 64 44 22 22 26 16 0 
51 35 82 92 38 18 0 17 0 0 0 5 8 15 15 20 22 21 27 23 0 10 20 5 12 48 31 18 30 32 25 0 
34 14 46 90 56 26 0 14 25 0 1 6 9 16 16 20 20 20 33 28 5 20 19 0 2 32 24 9 31 33 26 0 
41 7 3 38 51 37 21 3 26 7 6 6 8 18 18 19 22 16 32 40 16 9 25 0 0 23 31 7 14 15 12 0 
58 8 1 7 21 25 31 4 0 0 11 10 9 15 17 17 24 21 35 46 15 5 17 0 4 21 48 19 0 0 0 0 
75 14 14 12 12 13 13 7 0 0 10 14 12 14 16 15 19 25 44 40 26 14 0 5 12 35 60 40 1 0 9 0 
79 20 19 19 20 20 21 14 0 0 7 18 17 11 12 13 17 21 34 48 38 4 0 0 8 47 65 50 4 4 10 0 
79 20 20 20 19 20 20 16 0 0 7 22 27 7 1 13 18 20 26 53 24 8 6 0 8 44 63 38 1 5 10 0 
77 19 19 20 21 22 21 16 0 0 10 19 29 14 0 12 18 20 24 30 24 33 25 0 9 47 47 16 0 10 15 0 
74 20 21 19 18 18 17 13 0 0 10 14 25 22 8 14 19 12 19 26 22 37 24 7 25 44 30 1 1 12 16 0 
75 15 17 17 14 16 19 19 0 0 7 12 17 24 16 17 21 13 19 25 19 26 33 25 23 22 13 0 8 14 11 0 
73 18 19 19 19 20 20 15 0 0 8 7 14 19 13 15 19 22 23 11 15 29 59 40 14 9 1 0 10 20 12 0 
69 18 20 21 19 18 16 6 1 0 5 5 18 18 7 14 15 16 23 12 12 46 58 34 18 7 0 6 13 18 11 0 
67 16 16 17 19 17 12 7 2 0 0 3 15 24 13 17 24 15 15 21 39 62 36 22 17 2 0 13 19 18 11 0 
67 18 17 15 16 13 12 8 0 1 7 6 5 17 17 13 21 20 19 38 53 41 29 23 14 0 1 16 28 18 12 0 
66 18 17 12 9 8 11 13 15 13 12 9 10 7 7 10 11 18 32 46 30 23 25 23 6 0 0 15 35 25 11 0 
64 14 11 7 9 12 16 18 13 7 9 11 14 10 4 10 10 26 47 32 21 25 22 18 0 0 13 17 16 20 10 0 
58 8 10 13 15 16 13 12 12 9 8 10 14 15 10 13 23 36 34 23 20 23 21 10 0 3 25 29 8 6 10 0 
49 14 17 16 11 12 13 12 12 10 9 9 11 14 16 30 41 24 14 20 19 20 17 1 4 9 21 24 14 6 11 0 
40 17 15 11 9 11 15 13 11 11 11 10 10 17 27 37 30 19 15 18 19 18 10 0 15 17 9 20 18 10 14 0 
28 15 15 14 13 13 15 16 14 13 14 14 15 27 34 27 30 36 34 32 32 32 23 21 24 30 16 22 32 28 26 2 
