66 59 60 60 61 63 64 64 65 66 67 67 69 70 70 71 72 72 72 72 72 75 77 75 75 76 76 76 76 76 76 133 
56 20 21 21 21 22 22 22 22 22 22 22 23 23 23 23 23 23 23 24 22 24 25 23 23 24 23 23 23 23 23 103 
57 21 22 22 22 23 23 23 22 22 23 22 23 24 23 23 23 23 23 24 21 21 22 21 23 24 24 24 23 22 22 104 
58 21 23 22 22 23 23 23 22 22 23 23 23 24 24 24 23 23 24 24 23 23 23 22 23 23 23 24 22 22 22 104 
59 22 23 23 22 23 23 22 21 22 22 22 23 24 23 23 23 22 23 24 24 24 24 23 23 22 22 23 22 22 22 104 
60 22 24 24 23 23 23 22 22 23 24 25 25 26 26 26 26 26 26 25 24 24 24 24 23 23 23 23 23 23 23 105 
61 23 24 24 24 24 24 22 21 17 11 9 6 4 3 3 2 3 7 17 21 18 20 23 23 23 24 23 23 24 23 105 
61 22 24 24 23 23 24 24 19 0 0 0 0 0 0 0 0 0 0 0 0 0 10 23 24 24 24 24 24 24 23 105 
58 14 21 24 24 24 25 26 39 0 0 0 0 0 0 0 0 0 0 0 0 0 7 15 14 20 24 24 24 24 24 106 
51 5 22 24 24 23 24 27 52 3 0 5 5 6 5 4 8 4 0 14 1 0 0 0 0 3 20 24 24 24 24 106 
7 0 7 18 24 25 25 29 57 8 1 7 3 2 4 6 11 8 0 14 7 0 0 0 0 0 8 17 16 16 16 94 
0 0 0 0 20 25 24 27 56 13 8 14 5 5 8 7 13 16 7 24 21 0 1 6 0 0 5 0 0 0 0 63 
0 0 0 0 21 26 20 0 21 0 2 13 5 8 9 6 10 8 2 21 22 0 25 23 0 0 2 0 0 0 0 35 
25 22 0 0 0 0 0 0 0 0 2 12 0 5 6 3 8 1 0 12 23 6 42 39 1 0 12 0 0 0 17 62 
45 40 16 0 0 0 0 0 17 0 3 7 0 4 5 1 5 5 0 20 36 18 32 36 10 13 45 43 67 56 57 86 
52 41 43 41 35 32 36 34 47 7 1 1 1 5 6 2 0 2 0 22 34 15 20 19 0 14 24 49 58 37 21 63 
43 22 22 20 20 22 22 26 36 3 0 3 6 8 9 8 2 2 0 10 13 11 17 0 0 0 0 22 17 8 0 53 
38 12 11 13 13 12 9 13 24 0 0 3 12 20 14 8 3 5 0 12 14 19 5 0 0 0 0 22 14 3 0 54 
40 11 6 4 2 2 3 10 23 0 2 2 11 23 13 4 2 4 0 0 0 0 0 8 1 0 9 30 13 0 7 52 
32 3 6 10 13 17 20 24 35 0 4 0 0 12 4 0 3 4 0 0 0 0 0 15 0 5 36 36 6 0 10 50 
44 21 21 23 20 15 11 12 29 0 1 0 0 0 0 0 5 7 0 0 2 0 16 21 11 30 44 27 3 6 18 52 
40 13 10 7 3 2 2 5 22 0 0 0 0 0 0 0 0 5 0 4 1 0 23 31 42 48 35 14 0 10 17 53 
30 0 0 0 2 4 7 6 11 0 0 6 0 8 8 2 3 3 0 14 0 0 9 30 43 34 23 8 0 13 14 51 
35 4 4 6 9 10 10 7 11 2 6 1 0 5 4 0 4 3 0 4 0 1 30 43 28 18 12 0 4 14 17 50 
35 9 12 11 13 12 14 15 11 1 0 0 0 0 0 0 0 0 0 0 0 20 45 33 16 16 5 0 12 13 18 49 
34 9 12 10 8 0 0 0 0 0 0 0 0 2 0 0 0 0 0 14 25 47 36 16 14 16 0 0 0 9 14 47 
33 9 9 0 0 0 0 0 0 0 0 4 6 13 10 7 5 9 15 34 45 41 19 12 15 9 0 2 0 10 9 43 
30 1 0 0 0 0 0 0 0 2 3 3 2 10 9 8 9 14 26 46 37 21 13 13 15 0 0 20 23 24 11 42 
15 0 0 0 0 0 0 3 4 5 4 4 1 4 3 6 23 37 46 44 22 16 15 15 15 0 1 15 18 12 4 37 
5 0 0 0 0 0 2 4 5 5 6 7 7 6 5 16 41 54 45 28 14 15 13 13 2 0 11 15 16 7 3 39 
10 0 1 5 5 2 3 5 6 6 5 8 9 15 32 43 46 37 24 16 14 14 11 10 0 12 12 0 0 0 4 44 
0 0 0 0 0 0 0 0 0 0 0 0 0 0 0 0 0 0 0 0 0 0 0 0 0 0 0 0 0 0 0 0 
