66 0 0 0 0 0 0 0 0 0 0 0 0 0 0 0 0 0 0 0 1 2 1 0 1 1 2 2 2 2 1 0 
45 0 0 0 0 0 0 0 1 1 1 2 2 1 1 1 1 1 1 2 3 3 0 0 0 0 1 1 1 1 0 0 
46 0 0 0 0 0 0 1 1 1 2 3 2 1 1 1 1 1 2 2 2 1 0 0 0 0 1 0 0 0 0 0 
47 0 0 0 1 0 0 1 1 1 2 2 2 1 0 0 0 1 2 1 1 0 0 0 0 0 1 0 0 0 0 0 
48 0 0 0 1 1 1 1 2 2 2 3 2 0 0 0 0 0 1 1 1 0 0 0 0 0 0 0 0 0 0 0 
50 1 1 1 2 2 1 2 3 3 2 2 2 0 0 0 0 1 1 1 1 0 0 0 0 0 0 0 0 0 0 0 
51 1 1 2 2 1 1 2 3 2 3 3 2 1 2 3 3 4 6 6 1 0 1 1 0 0 0 0 0 0 0 0 
53 3 2 2 2 1 1 1 0 0 0 6 4 5 7 8 6 9 22 20 3 6 11 4 0 1 0 0 0 0 0 0 
51 4 6 2 1 1 1 0 0 0 0 6 4 5 7 10 8 11 25 20 7 15 17 6 2 3 1 0 0 0 0 0 
47 10 10 2 1 1 1 0 0 0 0 9 7 6 8 11 10 11 21 14 3 10 12 6 13 15 5 0 0 0 0 0 
42 29 18 8 2 1 1 0 0 0 1 9 6 8 11 12 10 8 21 15 0 0 10 10 19 28 18 2 0 0 0 0 
30 32 32 33 11 1 0 0 0 0 0 4 4 9 11 13 10 10 19 10 0 0 14 11 9 29 21 0 0 0 0 0 
22 9 40 59 24 0 0 0 0 0 1 2 4 9 10 14 12 13 19 6 0 10 18 0 4 33 5 0 3 5 1 0 
26 4 32 44 25 6 0 0 0 0 6 0 4 7 9 14 12 10 17 10 0 17 12 0 0 26 0 0 9 14 9 0 
36 8 13 6 7 7 0 6 0 5 7 0 3 6 8 12 12 9 15 18 7 8 4 0 0 20 9 15 9 11 6 0 
43 9 5 0 0 3 6 10 0 0 2 3 5 6 7 9 11 11 22 25 3 0 0 0 10 22 26 28 0 0 0 0 
44 7 5 5 5 4 4 1 0 0 0 7 7 6 6 6 8 9 26 19 1 5 0 0 11 18 38 21 0 0 0 0 
38 2 2 2 1 2 3 0 0 0 2 9 11 6 2 3 6 8 19 15 13 0 0 0 0 21 43 14 0 0 3 0 
34 0 0 1 2 1 2 0 0 0 2 11 17 4 0 1 6 7 15 20 7 0 0 0 0 28 40 6 0 0 4 0 
32 0 1 2 2 3 3 0 0 0 3 9 13 2 0 2 6 5 11 10 0 3 16 0 0 38 28 0 0 4 7 0 
34 4 5 3 2 1 1 0 0 0 0 4 6 2 0 6 7 0 2 6 0 16 12 0 19 37 6 0 0 9 5 0 
39 3 2 0 0 0 1 0 0 0 0 0 0 1 3 6 6 0 2 4 1 17 12 14 26 11 0 0 0 11 3 0 
32 0 1 0 1 3 4 0 0 0 0 0 0 4 1 3 4 1 8 0 0 17 30 35 10 0 0 0 5 8 5 0 
27 0 3 4 4 4 1 0 0 0 0 0 9 9 0 3 5 2 5 0 0 29 40 16 0 0 0 0 9 7 3 0 
29 3 4 5 6 3 0 0 0 0 0 0 7 5 2 5 7 4 0 0 25 49 23 0 0 0 0 5 10 7 2 0 
30 4 5 5 2 0 0 0 0 0 0 1 2 0 3 4 4 4 3 17 45 28 0 0 0 0 0 8 12 11 2 0 
30 3 0 0 0 0 0 0 0 3 4 4 6 3 1 3 4 5 20 39 29 0 0 2 0 0 0 5 15 13 2 0 
27 0 0 0 0 0 0 4 4 1 0 3 7 5 1 4 5 15 38 29 2 0 2 0 0 0 9 13 9 2 1 0 
17 0 0 0 0 4 4 3 2 1 1 3 5 3 3 8 18 32 29 4 0 3 0 0 0 0 16 17 5 0 0 0 
5 0 0 2 3 2 3 2 2 1 2 4 3 1 6 22 37 26 2 0 2 1 0 0 0 5 11 8 0 0 1 0 
6 2 3 1 0 2 4 4 2 1 4 4 2 7 20 31 23 4 0 0 0 0 0 0 0 11 0 0 2 1 5 0 
6 6 5 5 4 5 6 6 5 5 6 6 7 14 21 13 1 2 3 3 3 1 0 0 9 5 0 1 5 7 7 0 
