0 14 14 15 16 16 15 15 15 15 15 16 16 17 17 17 17 17 16 16 18 17 16 18 18 18 18 18 18 18 18 0 
0 0 0 0 0 0 0 0 0 0 0 0 0 0 0 0 0 0 0 0 0 0 0 2 1 1 2 2 2 3 4 0 
0 0 0 0 0 0 0 0 0 0 0 0 0 0 0 0 0 0 0 0 0 1 3 4 2 3 3 2 4 4 5 0 
0 0 0 0 0 0 0 0 0 0 0 0 0 0 0 0 0 0 0 0 0 2 4 4 4 4 5 4 5 5 5 0 
0 0 0 0 0 0 0 0 0 0 0 0 0 0 1 1 2 2 0 0 1 3 3 4 4 5 6 7 7 5 5 0 
0 0 0 0 0 0 0 0 0 0 0 0 0 0 0 0 0 0 0 0 2 3 4 4 4 5 5 6 6 5 5 0 
0 0 0 0 0 0 0 0 0 0 0 0 0 0 1 1 1 2 4 1 2 6 5 4 4 4 4 5 5 4 5 0 
0 0 0 0 0 0 0 0 0 0 0 0 1 3 5 4 3 7 16 5 4 14 8 3 5 5 5 5 5 5 6 0 
0 0 0 0 0 0 0 0 0 0 1 0 0 0 1 2 0 5 13 3 9 18 8 5 9 7 6 7 7 7 7 0 
0 6 0 0 0 0 1 0 0 10 8 0 3 5 5 6 4 8 14 3 7 16 4 8 20 11 7 7 7 7 8 0 
0 8 1 1 2 2 2 0 0 15 12 3 8 10 9 10 8 10 23 7 0 11 5 5 14 16 6 8 10 11 7 0 
0 0 19 6 2 5 4 3 0 19 17 6 12 12 12 15 13 15 22 6 3 17 7 0 0 17 0 14 12 16 5 0 
0 0 26 9 0 6 0 17 0 23 21 10 16 12 13 17 14 20 23 8 8 30 0 0 2 11 0 15 9 13 1 0 
0 0 13 1 1 10 0 25 1 25 18 11 17 12 14 18 13 18 24 12 15 31 0 0 8 6 0 12 2 6 0 0 
0 5 0 0 0 7 6 19 0 22 15 13 15 12 14 17 16 16 24 17 14 20 7 0 17 7 3 12 0 1 0 0 
0 11 5 1 3 6 16 14 0 17 16 15 13 11 12 15 18 17 28 15 8 20 8 10 30 14 31 12 3 0 4 0 
0 14 16 16 16 16 18 13 0 19 17 15 12 11 12 14 17 16 29 6 18 18 6 22 25 23 33 4 5 6 17 0 
0 15 17 15 15 15 16 11 3 22 15 16 14 9 13 16 19 17 22 13 19 6 14 24 18 31 23 0 5 19 21 0 
0 15 16 16 16 16 15 12 4 23 14 18 16 6 12 18 18 17 18 20 9 17 27 15 22 32 13 0 8 24 17 0 
0 15 14 14 15 15 15 12 1 24 15 15 15 7 14 19 15 14 18 12 8 36 25 11 31 29 0 0 14 24 14 0 
0 13 15 14 14 15 16 15 4 25 17 13 14 10 17 19 13 11 23 20 16 37 6 16 33 14 0 2 24 19 12 0 
0 15 15 14 14 14 14 17 9 24 19 11 14 13 16 17 14 16 31 26 26 27 9 24 16 0 0 13 29 15 12 0 
0 15 16 15 15 16 16 14 8 24 15 5 14 7 9 13 10 18 29 15 26 23 25 18 5 4 5 20 23 14 14 0 
0 15 15 15 15 17 15 12 14 16 5 3 16 2 6 14 9 12 18 10 29 30 15 2 9 9 10 27 18 16 13 0 
0 16 12 13 14 17 15 15 13 10 3 4 9 2 7 12 11 8 10 13 38 23 0 5 14 6 18 26 15 16 13 0 
0 15 12 12 12 14 16 15 9 11 8 5 3 0 5 5 6 4 10 22 24 0 2 16 14 6 24 22 19 13 15 0 
0 14 12 13 11 11 11 9 8 9 7 6 7 1 3 5 5 7 20 18 1 0 14 19 8 13 23 14 20 11 15 0 
0 12 13 13 13 10 8 6 5 4 4 5 7 2 4 5 3 15 20 0 0 13 19 15 5 24 27 15 10 9 16 0 
0 12 13 11 10 8 5 3 2 3 3 2 4 4 6 8 10 13 4 0 14 19 19 11 10 29 26 18 11 12 17 0 
0 13 12 7 4 4 3 3 3 3 2 2 2 3 8 16 13 1 0 12 20 18 17 8 25 27 19 14 11 16 19 0 
0 8 5 3 2 4 3 2 2 3 4 3 3 8 11 10 3 4 12 19 19 18 12 12 34 19 10 17 15 19 20 0 
0 1 0 1 3 3 2 2 2 2 2 2 5 12 15 11 15 26 30 31 29 29 27 32 36 23 20 22 21 26 27 15 
