0 0 0 0 0 0 0 0 0 0 0 0 0 0 0 0 0 0 0 0 0 0 0 0 0 0 0 0 0 0 0 0 
0 0 0 0 0 0 0 0 0 0 0 0 0 0 0 0 0 0 0 0 0 0 0 0 0 0 0 0 0 0 0 0 
0 0 0 0 0 0 0 0 0 0 0 0 0 0 0 0 0 0 0 0 0 0 0 0 0 0 0 0 0 0 0 0 
0 0 0 0 0 0 0 0 0 0 0 0 0 0 0 0 0 0 0 0 0 0 0 0 0 0 0 0 0 0 0 0 
0 0 0 0 0 0 0 0 0 0 0 0 0 0 0 0 0 0 0 0 0 0 0 0 0 0 0 0 0 0 0 0 
0 0 0 0 0 0 0 0 0 0 0 0 0 0 0 0 0 0 0 0 0 0 0 0 0 0 0 0 0 0 0 0 
0 0 0 0 0 0 0 0 0 0 0 0 0 0 0 0 0 0 0 0 0 0 0 0 0 0 0 0 0 0 0 0 
0 0 0 0 0 0 0 0 0 0 0 0 0 0 0 0 0 0 0 0 0 0 0 0 0 0 0 0 0 0 0 0 
0 0 0 0 0 0 0 0 0 4 3 0 2 3 2 0 0 0 0 0 0 0 0 0 0 0 0 0 0 0 0 0 
0 0 0 0 0 0 0 0 0 5 1 0 0 0 0 0 0 0 0 0 0 0 0 0 0 0 0 0 0 0 0 0 
0 0 0 0 0 0 0 0 0 3 0 0 0 0 0 0 0 0 0 0 0 1 0 0 0 0 0 0 0 0 0 0 
0 0 0 0 0 0 0 0 0 2 3 3 5 1 0 0 0 0 0 0 0 5 0 0 0 0 0 0 0 0 0 0 
0 2 0 0 0 0 0 0 0 0 3 4 6 1 0 0 0 0 0 0 0 0 0 0 0 0 0 0 0 0 0 0 
0 4 0 0 0 0 0 1 0 0 3 5 7 1 0 0 0 0 0 0 0 0 0 0 0 0 0 3 0 0 0 4 
0 0 0 0 0 0 0 6 0 0 2 7 9 3 0 1 0 2 0 0 0 0 0 0 0 0 0 0 0 0 0 3 
0 0 0 0 0 0 0 0 0 6 5 7 7 3 1 3 2 0 0 0 0 0 0 0 0 0 0 0 0 0 0 5 
0 0 0 0 0 0 0 0 0 12 9 6 6 4 2 5 6 3 0 0 0 0 0 4 2 0 0 0 0 0 0 9 
0 0 0 0 0 0 0 0 0 12 9 4 2 4 4 6 7 4 0 0 0 0 5 12 11 2 0 0 0 0 0 11 
0 0 0 0 0 0 0 0 2 13 10 5 0 0 7 8 7 3 1 0 0 1 8 13 14 0 0 0 0 0 0 13 
0 0 0 0 0 0 0 0 3 15 10 7 0 0 9 9 6 4 3 6 9 8 3 7 9 0 0 0 0 0 0 14 
0 0 0 0 0 0 0 0 2 18 11 10 7 4 9 9 6 7 10 14 18 10 0 6 0 0 0 0 0 0 0 13 
0 0 0 0 0 0 0 0 4 17 15 13 12 9 10 10 7 7 13 16 15 8 0 0 0 0 0 0 0 0 0 14 
0 0 0 0 0 0 0 0 6 16 12 11 11 9 9 11 10 6 6 14 20 7 0 0 0 0 0 0 0 0 0 14 
0 1 0 0 0 0 0 5 10 15 10 11 9 3 8 10 8 9 8 12 16 0 0 0 0 0 0 0 0 0 0 16 
0 0 0 0 0 0 1 6 9 10 13 16 15 8 12 15 9 10 15 14 5 0 0 0 0 0 0 0 0 0 0 16 
0 0 0 0 0 2 6 7 10 15 15 15 17 17 16 18 17 15 16 6 0 0 0 0 0 0 6 0 0 0 0 16 
0 0 1 4 8 12 15 16 16 15 13 13 12 13 14 14 14 11 2 0 0 0 0 0 0 2 8 4 0 0 0 16 
0 5 8 14 17 18 16 12 10 12 13 12 10 9 13 12 10 2 0 0 0 0 0 0 0 7 1 0 0 0 0 17 
0 13 17 18 16 13 12 11 11 12 13 12 11 11 13 9 0 0 0 0 0 0 0 0 4 10 0 0 0 0 0 16 
3 19 18 13 12 12 11 11 11 11 11 10 12 13 10 0 0 0 0 0 0 0 0 0 5 6 0 0 0 2 2 17 
10 14 11 10 12 13 11 11 11 11 10 10 10 6 0 0 0 0 0 0 0 0 0 4 7 0 2 0 0 1 1 17 
11 13 12 12 14 14 14 13 13 13 13 12 13 10 1 0 3 7 8 9 8 8 10 16 16 9 13 18 13 13 12 13 
