0 0 0 0 0 0 0 0 0 0 0 0 0 0 0 0 0 0 0 0 0 0 0 0 0 0 0 0 0 0 0 0 
0 0 0 0 0 0 0 0 0 0 0 0 0 0 0 0 0 0 0 0 0 0 0 0 0 0 0 0 0 0 0 16 
0 0 0 0 0 0 0 0 0 0 0 0 0 0 0 0 0 0 0 0 0 0 0 0 0 0 0 0 0 0 0 15 
0 0 0 0 0 0 0 0 0 0 0 0 0 0 0 0 0 0 0 0 0 0 0 0 0 0 0 0 0 0 0 15 
0 0 0 0 0 0 0 0 0 0 0 0 0 0 0 0 0 0 0 0 0 0 0 0 0 0 0 0 0 0 0 16 
0 0 0 0 0 0 0 0 0 0 0 0 0 0 0 0 0 0 0 0 0 0 0 0 0 0 0 0 0 0 0 15 
0 0 0 0 0 0 0 0 0 0 0 0 1 3 4 3 3 4 3 0 0 0 0 0 0 0 0 0 0 0 0 15 
0 0 0 0 0 0 0 0 0 26 49 55 59 62 61 59 56 55 43 23 15 12 0 0 0 0 0 0 0 0 0 15 
0 0 0 0 0 0 0 0 7 46 64 65 65 65 63 60 55 50 39 32 30 16 2 0 0 0 0 0 0 0 0 15 
0 0 0 0 0 0 0 0 6 19 16 12 10 9 9 7 6 4 5 8 13 19 24 30 23 5 0 0 0 0 0 15 
20 19 3 0 0 0 0 0 3 7 2 0 3 3 1 0 0 0 0 0 13 33 47 46 35 24 4 0 0 0 0 24 
35 49 44 15 0 0 0 0 2 3 0 0 3 2 1 0 0 0 0 0 10 17 14 12 18 21 12 18 20 20 21 44 
20 50 54 25 0 0 0 21 25 11 0 0 0 0 0 0 0 0 0 0 3 0 0 0 12 12 29 50 56 52 50 58 
0 5 5 15 27 26 43 55 52 26 2 0 0 0 0 0 0 1 2 3 1 0 0 0 4 12 34 44 39 30 21 24 
0 0 0 10 51 63 63 34 25 17 3 3 2 1 1 0 1 1 0 0 0 0 0 0 0 0 0 0 0 0 0 0 
0 0 0 0 0 6 0 0 0 0 9 7 3 1 1 2 4 3 0 0 0 0 0 7 0 0 0 0 0 0 0 12 
0 0 0 0 0 0 0 0 0 2 8 5 0 0 0 0 3 5 0 0 5 0 6 21 11 11 0 0 0 12 20 28 
0 0 0 0 0 0 0 2 10 9 4 1 0 0 0 0 0 1 0 10 0 0 21 26 26 23 6 5 16 21 11 21 
0 0 1 3 4 5 6 8 11 9 3 0 0 0 0 1 1 1 2 2 8 28 25 10 10 0 0 0 15 14 4 17 
0 6 6 4 3 0 0 0 2 6 0 0 0 0 4 4 2 3 7 17 40 42 10 0 0 0 0 0 18 13 4 15 
0 0 0 0 0 0 0 0 5 3 1 3 8 15 13 4 1 4 14 21 25 12 0 3 0 0 0 5 15 1 0 12 
0 0 0 0 2 7 10 11 10 5 3 6 12 18 14 7 6 8 6 3 6 0 0 0 0 0 0 14 8 0 0 10 
0 9 12 13 13 10 6 6 15 15 4 4 8 4 4 5 5 6 0 0 6 4 0 0 0 0 2 14 3 0 0 11 
0 10 9 7 3 0 0 8 17 5 0 7 6 0 0 2 1 0 0 10 13 0 0 0 0 0 13 13 0 0 0 12 
0 0 0 0 0 0 0 3 0 0 9 15 12 18 21 17 16 15 19 28 6 0 0 0 0 8 19 8 0 0 0 11 
0 0 0 0 0 4 13 20 26 27 19 11 8 14 17 15 16 19 17 1 0 0 0 0 1 13 19 12 6 0 0 12 
0 0 0 4 16 31 43 44 36 20 8 1 0 0 0 0 0 0 0 0 0 0 0 0 6 21 19 10 6 2 2 15 
0 3 15 29 40 40 31 18 8 2 0 0 0 0 0 0 0 0 0 0 0 0 0 0 15 25 8 0 0 0 3 15 
5 26 37 37 28 16 6 2 1 1 0 0 0 1 0 0 0 0 0 0 0 0 0 3 20 17 0 0 0 0 5 16 
24 37 27 14 6 3 2 1 0 0 0 0 0 1 0 0 0 0 0 0 0 0 0 11 22 2 0 0 0 6 7 14 
15 15 5 1 2 2 1 0 0 0 0 0 0 0 0 0 0 0 0 0 0 0 5 21 14 0 0 6 13 10 2 8 
17 25 24 25 24 22 22 23 24 23 22 22 21 15 10 24 52 75 82 81 81 83 86 79 58 54 62 64 65 60 52 57 
