83 60 63 65 66 68 69 71 72 73 74 78 75 76 76 136 
13 11 12 10 9 9 9 9 6 7 8 2 7 7 5 56 
15 11 10 8 10 14 14 12 14 13 10 6 1 0 1 55 
19 13 12 11 7 0 0 0 0 0 7 5 8 4 3 58 
14 14 11 24 2 0 0 0 0 0 0 0 0 6 6 59 
0 3 14 25 0 0 0 0 0 0 0 0 0 0 0 44 
0 0 11 0 0 0 0 0 0 4 5 37 0 0 0 0 
63 57 0 2 2 0 0 0 0 6 44 21 30 85 109 77 
40 31 36 43 0 0 0 0 0 3 4 0 0 13 0 5 
0 0 0 0 0 0 8 0 0 0 0 0 0 38 0 11 
18 6 10 2 0 0 0 0 0 0 2 0 103 69 0 22 
0 0 0 0 0 0 0 0 0 0 0 91 113 0 0 24 
0 0 0 0 0 0 0 0 0 0 124 120 0 0 0 20 
0 0 0 0 0 0 2 8 2 126 145 0 0 0 13 9 
0 0 0 0 0 0 0 0 142 120 0 0 0 0 17 0 
0 0 0 0 0 1 10 75 138 1 0 0 0 4 0 17 
