14 0 0 0 0 0 0 0 0 0 0 0 0 0 0 57 
4 0 0 0 0 0 1 0 2 0 0 10 5 6 2 45 
4 0 0 0 0 0 8 6 6 5 5 4 4 8 4 46 
8 0 0 6 7 14 24 22 20 21 8 16 3 5 6 46 
36 13 2 7 45 27 22 24 35 51 23 31 16 6 10 52 
71 22 2 14 51 13 11 9 21 38 22 30 48 47 18 60 
12 91 59 14 115 15 11 5 19 36 42 35 0 51 19 51 
23 0 22 86 55 33 7 13 30 48 50 81 0 66 9 44 
9 22 15 26 48 26 15 21 28 52 51 33 0 53 13 60 
11 18 21 25 47 17 44 16 23 36 38 27 0 36 32 43 
13 23 17 24 56 16 54 32 23 19 51 65 0 30 19 43 
10 20 18 15 50 18 28 22 35 47 19 39 15 22 21 40 
17 22 21 16 14 7 31 30 32 33 0 18 24 15 26 42 
19 19 8 17 24 22 17 14 17 4 11 28 30 25 41 45 
30 19 19 13 14 4 21 8 4 14 18 26 35 33 24 46 
28 19 17 15 14 13 19 11 24 31 38 48 36 24 60 50 
