0 0 0 0 0 0 0 0 0 0 7 1 0 0 0 51 
0 0 0 0 0 0 0 0 0 0 0 0 0 0 0 41 
0 0 0 0 0 0 0 0 0 0 0 0 0 0 0 43 
0 0 0 8 21 35 26 20 9 42 26 0 0 0 0 43 
25 0 0 14 2 0 0 0 0 14 41 0 25 0 0 42 
31 41 0 9 47 49 0 5 0 50 35 0 28 15 28 26 
0 47 40 109 56 49 25 11 0 45 106 0 70 36 24 0 
0 24 0 55 11 5 21 6 0 58 74 0 61 0 0 26 
0 0 0 1 57 8 0 0 1 63 12 0 42 67 0 56 
0 0 0 5 60 17 8 20 0 29 0 0 62 3 34 23 
0 0 0 2 63 20 22 23 0 10 60 0 46 0 36 11 
0 0 0 0 43 24 56 19 0 27 44 0 0 17 35 13 
0 0 0 10 25 8 58 30 4 19 36 0 0 29 4 5 
0 0 0 0 0 0 16 2 0 14 0 0 0 24 22 20 
0 0 0 0 0 0 14 15 0 0 0 0 12 22 0 34 
0 3 13 10 6 11 12 1 0 6 0 0 48 20 0 27 
