40 0 0 0 0 0 0 0 0 0 0 0 0 0 0 64 
0 0 0 0 0 0 0 0 0 0 2 0 0 0 0 0 
0 0 0 0 0 0 0 0 0 0 0 0 0 0 0 0 
0 0 0 0 24 0 0 0 0 0 4 0 0 0 0 0 
0 0 0 0 118 28 4 5 26 0 9 0 0 1 0 0 
0 0 3 0 115 33 13 0 26 8 74 0 50 0 0 0 
62 107 0 43 92 25 28 3 20 0 46 28 91 45 0 0 
14 103 9 62 45 3 28 11 20 8 59 0 94 14 21 0 
0 0 0 0 91 23 10 11 14 22 3 35 58 0 24 0 
0 0 0 0 76 32 0 40 15 31 0 40 89 0 18 0 
0 0 0 0 93 22 15 21 19 27 7 0 56 0 24 0 
0 0 0 0 43 16 19 17 24 0 49 0 0 17 26 0 
0 0 0 0 13 29 52 25 0 10 19 0 0 48 0 0 
0 0 0 0 8 8 8 20 21 0 0 0 26 34 30 0 
0 0 8 1 0 15 16 0 20 0 0 0 49 32 9 0 
0 0 7 0 0 0 8 6 0 2 0 0 19 38 0 0 
