0 0 0 0 0 0 0 0 0 0 0 0 0 0 0 29 
0 0 0 0 0 0 0 0 0 0 0 0 0 0 0 0 
0 0 0 0 6 14 16 15 18 5 0 0 0 0 0 0 
0 0 0 6 16 0 0 0 0 0 0 0 0 0 0 0 
0 0 0 0 31 75 82 83 82 66 44 8 0 0 0 2 
16 0 2 9 12 0 14 9 11 19 30 64 31 0 0 0 
39 67 6 0 19 5 5 0 0 0 50 19 12 34 77 79 
15 42 94 110 57 0 5 0 0 24 40 0 25 106 106 46 
0 0 1 0 8 14 16 3 0 9 54 0 14 32 17 28 
5 11 47 51 12 19 14 0 1 0 42 38 44 15 14 0 
41 52 12 10 2 0 0 9 0 20 67 54 86 0 32 6 
11 22 28 25 72 14 34 27 16 20 42 43 0 0 15 1 
10 7 9 22 18 24 22 48 29 84 79 0 0 29 4 0 
8 0 34 65 76 29 18 12 8 46 0 10 0 30 34 0 
16 64 64 19 2 0 0 38 42 0 7 0 41 29 0 4 
53 22 0 2 0 0 31 78 0 0 0 16 26 12 37 0 
