149 26 24 27 26 27 26 28 31 31 29 34 30 31 32 44 
119 10 6 12 9 11 7 9 11 14 10 13 7 8 9 13 
122 11 8 14 12 15 10 12 12 12 9 5 5 4 8 13 
125 13 12 13 7 0 0 0 0 0 0 15 14 5 6 14 
120 22 13 6 61 0 0 0 0 0 4 0 0 11 3 12 
50 0 22 6 84 0 13 0 2 8 23 0 8 13 0 0 
4 17 10 0 67 0 19 3 0 3 45 26 24 47 0 38 
62 37 0 59 52 0 15 5 2 11 53 24 46 53 22 27 
80 5 8 14 39 0 9 0 0 5 35 0 0 0 46 0 
72 0 0 1 45 0 4 20 0 3 0 0 20 0 31 21 
73 0 0 0 45 0 0 10 0 0 18 23 16 7 22 19 
73 0 0 0 22 0 0 2 0 0 21 5 12 3 0 18 
75 4 0 0 0 0 18 12 0 12 20 6 6 2 4 21 
67 0 0 0 12 7 7 20 9 0 1 0 0 0 16 22 
28 0 3 8 9 13 12 23 0 2 9 0 8 0 14 0 
10 0 5 0 5 4 5 0 0 4 0 8 27 17 9 23 
