100 0 0 0 0 0 0 0 0 0 0 0 0 0 0 0 
93 0 0 0 0 0 0 0 0 0 0 0 0 0 0 0 
93 0 0 0 0 0 0 0 0 0 0 0 0 0 0 0 
93 0 0 0 0 38 50 55 58 79 24 17 0 0 0 0 
108 0 0 0 0 0 0 0 0 11 40 54 60 0 0 0 
140 128 0 0 0 0 0 0 0 6 0 9 88 28 3 0 
0 114 67 0 0 0 0 0 0 14 0 0 25 0 14 0 
49 0 0 0 0 0 0 0 7 32 0 0 10 58 0 0 
58 0 0 0 0 0 0 0 2 32 0 0 37 61 0 0 
48 0 0 0 0 0 14 0 0 23 3 0 21 17 0 0 
50 0 0 0 0 0 13 4 9 0 21 26 0 0 0 0 
41 0 0 0 0 0 7 0 0 9 31 43 0 0 0 0 
39 0 0 0 0 0 26 22 33 24 17 0 0 0 19 0 
42 0 0 0 0 0 3 0 0 10 0 0 0 0 0 0 
45 0 0 1 0 0 1 6 0 0 0 0 0 0 0 0 
21 34 30 36 33 32 38 36 67 86 88 63 71 52 58 68 
