104 97 98 97 98 99 99 99 99 100 101 97 98 96 96 97 
0 2 2 2 1 1 1 0 2 1 1 0 0 0 1 0 
0 1 1 1 2 3 2 2 3 3 2 2 1 2 2 0 
0 0 0 7 19 46 55 55 53 38 14 6 2 1 1 0 
4 1 0 0 0 0 0 0 0 0 18 35 31 5 0 0 
24 25 0 0 0 0 0 0 0 0 0 0 0 31 43 29 
0 0 54 34 10 4 3 0 11 15 10 0 4 0 0 0 
0 0 0 0 0 2 0 0 2 7 16 6 16 37 58 47 
13 51 63 46 8 0 0 0 0 7 14 0 17 23 22 0 
1 20 17 0 0 0 8 9 5 13 19 14 25 0 1 0 
28 40 32 42 0 1 0 2 4 0 10 0 16 5 2 1 
0 0 0 0 8 20 24 33 16 28 13 0 23 2 0 0 
0 0 29 53 31 14 0 4 19 1 0 18 0 4 15 0 
13 14 12 0 11 8 14 12 7 8 26 0 0 0 0 0 
5 0 5 4 1 0 0 0 3 20 6 7 0 8 19 2 
19 20 14 15 15 19 53 90 70 41 42 20 33 35 25 29 
