3 0 0 0 0 0 0 0 0 0 0 0 0 0 0 0 
0 0 0 0 0 0 0 0 0 0 0 0 0 0 0 0 
0 0 0 0 0 0 0 0 0 0 0 0 0 0 0 0 
0 0 0 0 0 2 8 9 9 10 6 1 0 0 0 0 
0 0 0 0 0 47 29 27 23 11 27 0 2 0 0 0 
9 0 0 0 0 18 3 0 0 0 36 43 14 0 4 0 
19 10 0 25 25 30 10 0 0 0 42 10 5 31 43 22 
0 0 0 48 0 24 23 0 6 17 0 0 17 12 0 0 
0 0 0 0 6 39 14 0 19 6 0 25 45 6 7 31 
0 3 2 0 5 41 0 29 22 7 53 44 65 0 32 25 
0 0 0 0 21 53 24 33 12 42 59 22 68 0 32 0 
0 19 14 10 47 57 39 21 20 37 81 24 0 28 33 0 
0 4 0 4 36 49 32 31 27 96 101 0 0 38 17 0 
0 6 58 67 57 44 27 30 38 68 0 0 10 54 8 0 
22 72 67 41 15 16 14 33 30 0 0 0 64 39 0 22 
33 39 26 22 21 18 40 32 2 42 42 73 72 48 49 30 
