0 0 0 0 0 0 0 0 0 0 0 0 0 0 0 0 
0 0 0 0 0 0 0 0 0 0 0 0 0 0 0 0 
0 0 0 0 0 0 0 0 0 0 0 0 0 0 0 0 
0 0 0 0 0 0 0 0 0 0 0 0 0 0 0 0 
0 0 0 0 33 62 61 55 51 28 13 0 0 0 0 0 
2 0 0 0 10 13 1 0 0 9 18 39 18 0 0 0 
64 10 0 0 0 0 0 0 0 0 0 29 22 52 65 30 
23 76 66 33 58 0 0 0 0 0 1 0 12 39 60 14 
0 0 0 0 0 2 17 3 0 0 0 2 0 0 0 0 
1 10 10 8 22 0 0 1 0 0 1 32 7 10 0 3 
20 3 0 0 0 13 9 0 0 3 26 9 0 0 0 1 
24 7 0 0 13 18 34 29 14 11 4 0 0 0 0 2 
3 0 0 0 0 33 71 52 51 38 0 0 0 0 0 2 
0 0 30 37 38 10 34 39 36 0 0 0 0 26 30 2 
21 31 32 14 11 16 33 17 0 0 0 0 0 0 0 6 
26 7 6 5 1 0 0 0 0 0 0 3 0 28 18 0 
