55 0 0 0 0 0 0 0 0 2 0 7 0 0 0 57 
21 5 2 3 1 1 1 0 1 2 7 3 4 6 0 16 
24 5 3 4 2 0 4 1 1 1 0 0 2 2 2 15 
27 4 3 3 52 0 1 0 8 17 33 18 2 2 2 15 
36 18 0 8 125 10 0 0 10 54 8 41 0 10 0 13 
30 42 21 18 115 38 0 0 13 67 71 25 15 82 0 38 
73 38 63 105 99 44 5 4 22 67 54 89 0 148 14 54 
23 33 29 49 125 22 3 1 24 13 71 65 34 72 54 69 
35 4 0 12 91 0 14 11 17 68 80 98 32 105 59 20 
24 4 0 9 93 0 58 8 7 11 87 97 5 126 44 31 
19 9 6 6 80 10 44 0 36 21 38 91 61 111 8 46 
36 2 1 32 71 47 36 18 13 98 0 79 60 51 29 20 
26 9 13 20 15 22 52 0 28 43 92 98 75 0 21 30 
21 22 19 0 1 1 25 0 24 42 88 5 89 0 57 15 
55 0 2 4 3 0 21 0 20 82 0 76 58 29 37 2 
23 11 6 0 2 0 7 9 40 6 7 45 48 41 15 14 
