0 0 0 0 0 0 0 0 0 0 0 0 0 0 0 40 
0 0 0 0 0 0 0 0 0 0 0 0 0 0 0 0 
0 0 0 0 0 0 0 0 0 0 0 0 0 0 0 0 
0 0 0 0 32 71 48 42 57 45 34 0 0 0 0 0 
17 0 0 0 72 51 3 1 0 0 17 38 37 0 0 0 
66 88 0 0 16 0 8 0 0 0 29 35 10 1 5 19 
53 69 32 71 56 0 0 0 0 0 8 0 28 31 20 26 
0 0 46 60 0 24 0 0 0 0 0 41 17 14 0 62 
0 5 0 0 21 6 0 0 0 21 28 63 44 0 73 68 
3 0 0 0 12 0 0 3 0 0 85 28 16 0 39 0 
0 0 1 1 9 0 17 0 0 21 0 30 0 47 29 0 
5 0 0 1 31 21 4 0 0 1 41 11 22 31 0 0 
2 0 0 11 62 37 16 24 8 77 0 39 4 40 7 0 
0 37 45 38 17 0 0 0 16 0 29 19 55 2 0 7 
32 47 0 0 0 0 7 35 19 26 26 5 56 0 2 16 
18 0 0 0 0 0 0 0 36 15 0 43 4 22 29 0 
