106 21 22 20 20 19 23 21 21 19 31 19 19 19 17 8 
66 5 5 0 0 1 2 2 2 1 5 3 3 1 0 0 
66 2 4 0 2 0 3 2 2 1 0 3 1 2 0 0 
67 1 2 2 2 0 0 0 0 14 2 23 1 1 0 0 
70 33 0 6 0 0 0 8 22 50 40 70 17 19 0 0 
41 49 35 9 0 3 5 29 32 62 1 45 33 73 0 0 
15 148 76 0 0 0 21 33 37 57 33 84 41 35 0 0 
56 71 0 37 0 0 19 28 24 88 68 21 49 99 75 10 
56 18 19 35 0 1 34 21 28 93 35 0 20 121 0 0 
46 9 13 15 0 38 58 0 26 67 70 0 79 154 0 0 
46 26 27 14 0 21 27 12 30 13 62 85 159 89 26 3 
46 0 17 24 0 17 43 5 17 37 21 150 121 0 28 0 
28 22 26 0 0 0 15 0 4 0 189 165 0 0 35 0 
50 22 0 0 0 0 10 1 13 160 173 21 0 35 67 0 
44 0 5 10 0 0 12 8 138 149 26 27 0 82 48 0 
0 11 0 7 1 6 7 108 129 0 11 0 51 52 0 0 
