19 1 2 1 1 0 0 3 0 0 6 0 3 3 3 5 
14 0 0 0 0 0 0 0 2 0 3 6 0 0 0 0 
13 0 0 0 0 0 0 0 0 2 0 0 0 0 0 0 
12 0 0 0 32 18 15 15 21 22 0 0 0 0 0 0 
13 0 0 0 4 44 50 55 48 66 45 21 0 0 0 0 
80 31 6 0 0 2 15 12 0 17 21 39 82 22 9 0 
63 120 38 47 53 8 2 4 18 23 16 14 23 33 41 24 
0 42 92 48 77 29 12 5 23 19 11 28 0 11 11 2 
10 0 12 12 0 14 4 22 26 21 6 27 38 26 11 4 
13 17 6 12 8 18 21 13 12 38 41 9 14 28 21 0 
19 14 5 11 0 12 32 19 0 20 45 10 0 9 10 15 
19 17 10 15 13 22 0 19 28 34 40 39 0 3 19 0 
10 6 10 17 19 0 33 23 29 9 8 3 0 21 7 1 
5 8 2 15 27 8 0 0 0 0 0 0 19 21 62 0 
7 5 5 0 0 0 5 0 0 3 0 0 8 37 3 2 
15 1 0 2 0 0 15 9 13 2 0 2 16 29 54 11 
