0 0 0 0 1 2 2 2 5 5 4 5 7 6 7 111 
0 0 0 0 0 0 0 0 0 0 0 0 0 1 3 102 
0 0 0 0 0 0 0 0 0 0 0 0 0 1 3 102 
0 0 0 5 0 0 0 0 0 0 0 4 2 0 3 103 
0 0 0 26 101 38 0 0 0 0 0 0 1 4 2 105 
0 0 0 33 127 61 0 0 0 0 13 0 0 0 0 111 
0 0 0 51 119 65 5 0 0 0 33 13 0 0 0 72 
17 0 0 32 25 24 10 0 0 0 0 40 20 0 0 93 
0 4 1 23 78 34 1 0 0 0 6 62 0 0 62 94 
0 0 0 27 74 22 0 21 0 0 23 82 7 0 44 69 
0 0 0 27 83 33 0 14 0 3 0 14 5 43 51 60 
0 0 1 20 66 29 0 0 0 0 0 0 17 57 19 61 
0 0 0 38 52 44 0 0 0 0 0 0 50 56 0 64 
0 12 25 19 31 3 0 0 0 0 0 0 65 42 0 62 
0 26 14 0 0 0 0 0 0 0 0 27 71 0 24 61 
0 0 0 0 0 0 3 0 0 0 3 45 26 1 9 60 
