165 131 132 129 126 125 123 123 119 121 119 114 117 113 110 116 
104 81 79 76 71 70 68 65 61 64 64 59 55 52 51 84 
102 77 72 68 70 74 73 70 70 63 61 57 56 55 54 83 
96 70 67 80 68 76 71 62 57 50 42 50 51 52 52 81 
85 60 62 74 34 49 34 27 25 12 16 39 44 45 45 73 
54 44 53 64 37 10 0 0 0 0 3 46 42 40 46 74 
14 25 65 27 50 10 5 0 0 0 6 22 24 19 45 69 
23 25 19 25 31 0 8 1 0 3 21 2 0 12 40 42 
34 16 18 18 7 6 0 0 0 5 12 0 3 38 33 13 
35 14 16 12 5 1 1 0 6 0 0 0 9 21 7 17 
32 10 10 9 0 12 9 0 2 0 0 21 52 32 6 10 
29 13 8 0 17 26 27 16 20 20 0 40 45 2 8 3 
26 8 10 16 19 16 11 9 13 5 49 35 12 6 9 3 
27 7 21 34 29 14 9 8 0 24 49 7 3 14 4 5 
23 23 18 18 18 15 10 0 23 32 6 10 0 10 0 4 
36 45 32 29 29 30 27 32 38 12 25 10 20 15 7 6 
