76 54 46 42 34 38 51 71 69 66 67 71 41 31 42 39 39 77 62 30 74 71 50 43 47 60 38 44 29 35 35 43 
76 33 24 23 20 20 31 36 25 17 21 27 7 11 26 23 21 41 25 23 38 0 0 0 0 33 33 24 7 20 22 27 
44 0 11 40 40 35 37 39 25 14 21 26 8 11 28 26 24 38 27 27 0 0 0 0 0 42 60 7 4 22 22 28 
22 0 0 33 23 30 33 36 30 18 22 26 9 14 27 22 20 32 29 10 0 0 0 0 0 39 60 0 4 23 23 29 
31 13 17 28 0 0 0 0 12 20 22 25 11 14 33 35 35 40 41 7 0 0 0 0 0 31 32 0 9 22 24 30 
47 26 36 38 2 0 0 0 0 0 13 23 21 44 89 113 112 97 84 31 0 0 0 0 0 32 21 0 14 21 23 34 
66 24 31 38 13 0 0 0 0 0 0 36 61 103 134 138 119 96 89 33 0 0 0 0 0 26 29 10 12 19 37 83 
99 20 19 55 45 0 0 0 0 0 0 57 101 89 75 60 28 10 22 1 0 0 0 0 0 23 31 19 16 45 96 161 
164 27 21 85 67 0 0 0 0 0 1 77 87 17 3 5 0 0 0 0 0 4 4 3 12 35 27 18 15 99 148 134 
194 54 47 69 44 12 0 0 0 0 7 62 0 0 0 0 0 0 0 0 0 1 8 6 29 46 8 12 28 125 111 54 
137 36 55 9 2 33 17 0 0 1 6 0 0 0 0 0 0 0 0 0 0 0 10 6 50 73 41 50 89 106 53 33 
96 0 11 0 0 5 21 4 3 21 3 0 0 0 0 0 0 0 0 0 0 0 17 11 74 98 96 105 104 65 41 27 
95 0 0 4 2 0 20 20 9 22 0 0 21 27 22 46 29 0 15 19 7 8 24 32 85 85 71 70 47 26 33 24 
95 6 12 15 2 4 16 31 18 18 3 21 33 33 29 83 63 0 19 19 17 22 43 74 90 56 31 19 18 18 30 23 
94 17 19 21 11 9 5 18 30 31 14 29 38 31 73 97 54 0 15 23 23 31 45 75 74 35 22 18 25 20 28 16 
91 22 21 27 18 21 14 0 31 47 18 11 27 21 52 13 7 20 22 36 34 32 16 36 36 26 29 30 33 20 28 16 
94 22 15 22 21 25 20 0 16 31 37 0 24 51 0 0 0 25 29 43 34 40 5 23 20 28 37 30 22 8 18 22 
93 17 9 13 21 18 16 0 0 0 56 12 33 64 0 0 2 21 25 16 18 45 15 27 28 40 23 0 0 0 0 15 
88 16 15 17 19 20 21 7 0 0 41 41 32 49 20 20 33 40 22 0 21 41 12 30 41 60 15 0 0 0 0 13 
86 20 20 31 34 20 20 22 0 0 26 43 17 23 18 27 47 46 10 4 41 33 10 30 45 75 42 21 60 71 19 47 
83 19 14 40 49 10 17 49 34 11 28 37 12 11 13 21 24 7 0 21 35 23 15 28 44 71 45 55 94 88 36 63 
90 19 16 16 12 8 18 46 66 27 16 3 0 3 10 10 1 8 12 21 24 13 13 14 34 63 21 27 52 46 29 67 
85 16 22 0 0 12 13 0 54 27 14 2 0 3 16 16 11 37 22 26 41 19 10 0 16 56 0 5 33 30 20 84 
73 10 19 0 0 6 3 0 27 59 26 40 28 24 32 29 25 19 1 18 36 29 16 0 6 32 0 0 38 30 4 83 
83 12 18 7 0 5 8 0 0 62 30 36 43 34 32 25 28 16 10 21 17 19 20 2 0 0 0 0 49 25 12 61 
93 10 14 9 0 13 24 0 0 32 43 36 41 33 31 28 37 30 34 44 35 29 29 0 0 0 0 39 58 20 28 47 
82 4 12 0 0 19 31 4 28 28 59 36 24 25 33 47 49 27 25 43 48 48 40 0 11 6 0 67 57 15 32 49 
84 16 30 18 20 36 21 17 53 25 53 12 24 24 36 52 34 16 17 22 26 42 34 0 19 20 13 88 55 16 30 52 
99 27 31 43 56 30 8 19 19 7 41 23 60 30 35 41 14 9 25 15 0 27 20 3 27 22 29 88 44 21 35 49 
103 23 20 26 26 0 5 24 18 19 56 62 66 17 22 24 4 5 23 9 2 27 14 16 39 27 32 70 36 20 35 42 
103 21 22 17 0 0 9 33 36 26 68 77 30 3 6 2 0 4 19 0 7 29 9 19 49 37 26 49 37 18 31 34 
19 0 0 0 0 0 0 0 0 0 0 0 0 0 0 0 0 0 0 0 0 0 0 0 0 0 0 0 0 0 0 0 
