0 23 34 42 45 39 36 42 62 67 67 62 71 51 32 38 41 31 66 63 9 60 90 80 70 55 53 24 39 35 34 29 
0 37 34 23 18 8 0 0 12 24 22 29 55 36 14 18 6 0 41 12 0 29 42 42 36 27 19 23 38 16 16 24 
0 69 63 23 4 0 0 0 9 20 12 23 53 36 11 15 3 0 13 0 15 43 36 33 29 10 7 49 38 13 16 23 
0 20 15 15 60 48 19 12 20 17 9 24 51 32 11 22 16 0 0 10 43 33 20 26 12 0 27 89 42 14 17 24 
0 6 0 0 9 11 19 42 58 45 17 21 45 37 17 7 0 0 0 2 42 27 19 25 0 0 29 106 48 13 16 22 
0 15 0 0 10 0 0 0 16 51 49 38 52 19 0 0 0 0 0 0 44 28 25 27 0 0 11 79 57 25 17 22 
0 13 0 0 7 13 17 14 0 7 33 40 18 0 0 5 44 49 32 71 81 29 19 19 0 0 19 58 50 41 28 0 
0 17 13 0 0 24 16 26 17 1 13 4 0 1 27 35 59 66 73 125 115 38 19 13 0 0 4 56 67 36 0 0 
0 27 0 0 10 63 14 17 18 21 5 0 0 29 6 12 41 20 65 128 110 54 31 18 0 0 0 56 89 0 0 30 
0 88 0 0 77 80 13 5 10 21 0 0 30 106 54 44 49 55 85 87 91 72 45 34 0 0 14 64 34 0 0 99 
0 129 34 10 65 97 66 19 6 0 0 0 49 34 11 23 43 93 80 23 42 57 42 33 0 0 0 0 0 0 0 114 
0 51 72 44 0 66 98 62 15 0 0 0 0 0 0 0 0 39 18 0 0 4 29 32 0 0 19 0 0 0 26 120 
0 16 26 29 14 20 51 64 26 0 35 27 19 15 10 0 0 33 25 12 0 0 5 0 0 0 39 35 23 20 33 120 
0 22 10 14 21 10 33 61 48 26 43 14 0 9 12 0 17 71 26 25 13 0 0 0 0 0 9 21 22 19 31 125 
0 29 18 18 24 4 1 43 63 38 44 24 14 45 0 0 37 73 21 22 10 0 0 0 0 9 17 19 11 17 28 127 
0 24 22 18 26 5 0 14 45 60 53 38 31 0 0 81 156 108 35 6 0 0 0 0 0 27 15 7 5 17 32 125 
0 17 32 37 36 16 7 12 9 78 65 52 12 0 0 14 33 66 65 18 19 0 0 0 0 8 14 15 19 35 53 129 
0 28 28 21 22 24 19 6 0 59 70 68 0 0 26 0 0 5 41 57 44 0 0 0 0 0 0 38 52 55 88 158 
0 22 23 18 23 21 20 11 0 19 43 85 18 8 68 35 0 0 9 59 2 0 13 0 0 0 0 38 18 0 7 81 
0 22 33 16 0 16 40 30 22 0 0 42 57 31 62 40 0 0 55 41 0 0 19 0 0 0 23 21 0 0 9 36 
0 19 31 15 17 43 36 30 18 0 0 8 56 33 36 30 23 51 63 22 0 16 12 0 0 0 64 73 26 53 81 54 
0 13 5 9 63 66 24 46 57 33 0 15 78 68 35 21 28 10 5 3 0 14 13 0 0 0 41 43 28 74 96 55 
0 30 6 7 37 35 20 43 50 51 0 0 0 29 18 16 20 10 34 13 0 0 0 0 0 0 45 41 17 54 105 66 
0 17 18 27 35 11 24 38 31 50 40 0 0 7 15 23 9 16 43 19 21 31 12 0 0 0 91 48 1 46 82 69 
0 6 19 33 42 0 11 12 0 35 78 34 20 12 15 34 25 17 1 0 0 26 30 0 0 0 83 0 0 50 55 71 
0 26 23 50 66 0 8 35 0 0 53 18 3 21 22 22 10 24 14 0 0 0 0 13 0 0 24 0 0 49 45 81 
0 41 17 62 65 0 7 61 0 0 0 49 49 42 35 13 13 37 32 18 12 0 4 32 0 2 0 0 0 42 52 96 
0 18 18 41 0 0 5 49 10 0 0 61 30 19 17 7 35 49 16 4 31 24 30 44 0 10 0 0 0 32 38 97 
0 31 46 61 25 11 20 15 30 11 0 28 2 33 14 9 45 51 18 4 11 1 41 42 0 1 0 0 0 36 31 98 
0 30 28 32 50 59 17 0 4 0 0 0 15 66 22 22 55 46 22 35 14 0 26 28 0 0 0 0 0 31 33 108 
0 36 23 12 43 46 17 5 16 14 0 0 54 78 38 40 54 33 16 46 22 0 26 29 0 0 0 0 0 28 32 114 
0 120 116 112 102 74 60 64 89 65 46 141 210 174 128 92 77 65 75 89 51 47 66 42 49 75 39 36 131 195 215 316 
