0 0 0 0 0 0 0 0 0 0 0 0 0 0 0 0 0 0 0 0 0 0 0 0 0 0 0 0 0 0 0 0 
0 4 13 13 13 1 0 0 11 16 9 19 46 27 4 12 1 0 0 0 0 23 36 33 8 0 8 26 29 9 11 23 
0 33 4 0 0 0 0 0 18 24 12 20 46 27 5 12 3 0 0 0 21 50 39 36 0 0 0 58 38 9 11 22 
16 53 0 0 0 0 0 0 6 22 14 20 42 24 4 12 1 0 0 10 55 51 33 28 0 0 0 74 42 10 10 22 
0 21 0 0 24 4 0 0 0 10 16 22 39 24 0 4 0 0 0 24 59 35 25 19 0 0 5 72 44 15 9 21 
0 0 0 0 19 17 27 35 21 12 10 19 27 0 0 0 0 0 0 23 65 33 24 16 0 0 18 62 39 19 9 18 
0 0 0 0 13 25 15 28 36 31 9 0 0 0 0 0 0 0 0 32 81 43 29 22 0 0 3 48 42 22 0 0 
0 17 0 0 0 56 23 19 21 22 0 0 0 0 0 0 0 0 4 63 84 41 29 22 0 0 0 36 34 0 0 0 
0 39 0 0 0 75 37 19 10 9 0 0 0 5 9 23 55 70 83 75 61 34 20 9 0 0 0 28 0 0 0 0 
0 6 0 0 0 52 50 29 15 5 0 0 23 67 36 40 62 108 134 77 37 23 15 0 0 0 24 17 0 0 0 93 
0 0 0 10 0 2 39 45 20 0 0 49 139 134 87 75 103 148 143 84 39 12 10 0 0 0 16 0 0 0 0 124 
0 42 39 50 19 4 21 43 17 7 67 105 112 98 80 81 114 129 94 65 39 0 0 0 0 0 0 0 0 0 17 129 
0 69 47 38 34 18 4 26 28 29 64 44 16 12 6 0 36 64 25 23 20 0 0 0 0 0 0 0 0 0 25 130 
0 41 28 29 34 11 0 0 30 41 53 23 5 3 0 0 3 64 18 15 9 0 0 0 0 0 1 12 12 11 24 129 
0 21 18 21 31 18 0 0 7 29 40 4 0 0 0 0 23 78 27 11 0 0 0 0 0 0 16 13 5 11 28 134 
0 13 14 15 24 11 9 0 0 6 46 31 0 0 0 0 16 37 24 0 0 0 0 0 0 5 8 5 0 11 31 135 
0 10 16 10 11 4 15 19 0 0 39 65 0 0 76 110 40 0 4 0 0 0 0 0 0 0 0 1 9 21 31 125 
0 19 28 17 13 17 27 42 24 3 0 51 0 0 71 61 10 0 6 19 0 0 0 0 0 0 10 42 54 64 61 114 
0 19 21 16 15 18 27 53 62 22 0 8 4 0 29 15 0 0 34 49 0 0 3 0 0 0 57 104 90 103 113 114 
0 10 13 3 5 24 22 43 74 36 0 0 33 13 19 0 0 0 40 21 0 0 1 0 0 0 43 58 8 34 84 82 
0 12 2 0 0 39 16 3 35 24 0 0 43 36 15 0 4 33 32 0 0 0 0 0 0 0 0 0 0 0 58 65 
0 11 6 2 18 29 0 0 0 25 4 9 33 37 28 37 49 34 26 5 0 7 0 0 0 0 8 0 0 22 57 68 
0 8 21 54 45 11 20 5 0 48 59 48 51 42 31 34 18 0 14 0 0 20 24 11 0 0 36 15 0 29 43 54 
0 17 24 61 57 8 49 58 0 0 41 13 18 15 10 16 20 26 30 0 0 12 30 21 0 0 81 5 0 34 44 56 
0 22 23 62 75 9 46 83 0 0 28 10 0 8 13 24 32 45 40 20 16 18 21 24 6 49 106 0 0 31 49 82 
0 27 25 58 72 0 9 80 33 0 2 15 8 18 26 25 14 20 7 0 14 15 21 40 34 60 53 0 0 25 41 101 
0 36 37 70 59 0 0 44 12 0 0 8 22 25 11 0 0 16 1 0 0 0 18 46 10 13 0 0 0 25 29 102 
0 28 30 44 19 0 0 0 0 0 0 31 32 29 0 0 13 30 15 3 0 0 22 42 0 0 0 0 0 28 26 102 
0 7 0 0 0 0 0 0 6 0 0 0 0 27 1 1 33 26 12 31 27 0 24 30 0 0 0 0 0 20 23 107 
0 15 7 0 7 28 13 8 12 0 0 0 0 43 18 18 39 20 6 32 23 0 18 8 0 0 0 0 0 16 25 114 
0 16 18 29 43 29 1 0 0 0 0 0 27 57 42 38 37 15 7 30 6 0 14 0 0 0 0 0 0 18 32 122 
0 56 54 60 59 40 28 24 34 22 0 47 97 90 77 64 49 34 31 40 22 20 40 24 11 29 33 33 72 102 108 141 
