0 0 1 2 0 0 0 0 0 0 0 0 9 0 0 0 0 0 0 0 0 0 0 0 0 0 0 2 5 0 0 17 
18 18 15 11 5 4 8 22 23 24 19 23 10 9 17 12 6 24 0 0 44 36 13 12 0 0 0 29 14 12 14 21 
75 28 0 0 0 0 4 14 19 17 17 24 10 7 14 9 4 17 0 20 55 22 15 10 0 0 0 31 7 13 14 20 
74 24 6 4 0 0 0 1 0 4 17 24 8 5 18 14 5 16 25 49 32 7 12 8 0 0 8 7 9 13 13 20 
23 5 19 43 20 12 20 18 0 0 8 21 11 6 4 0 0 5 26 44 17 3 12 7 0 30 28 0 1 16 12 20 
0 0 6 35 21 29 34 38 28 0 0 4 0 0 0 0 0 0 14 41 29 17 13 7 3 31 28 0 0 14 13 19 
0 6 12 15 16 32 23 27 41 25 0 0 0 0 0 0 0 0 18 37 24 23 19 14 14 22 10 0 2 0 0 2 
0 27 3 0 12 41 27 14 13 18 0 0 0 0 16 26 33 28 36 14 0 13 20 13 14 21 9 0 0 0 0 35 
0 20 0 0 21 24 33 16 9 3 0 0 33 54 44 46 42 66 76 4 0 4 10 2 0 28 30 0 0 0 0 115 
0 0 1 57 6 0 30 28 20 0 0 89 132 66 61 61 59 98 88 28 0 0 5 0 0 46 51 0 0 0 66 101 
71 0 32 96 7 0 0 27 15 6 74 174 129 88 93 88 101 93 50 56 28 0 0 0 0 5 0 0 0 61 64 65 
118 36 35 40 52 10 0 0 7 29 89 92 37 52 75 80 78 34 14 45 47 15 0 0 0 0 0 0 27 62 47 66 
98 53 31 20 58 33 0 0 6 38 33 12 11 16 13 9 29 17 10 25 34 36 0 0 0 0 0 17 44 32 37 59 
65 22 28 34 35 36 15 0 0 22 0 0 8 2 0 0 28 23 15 15 12 10 0 0 25 46 37 34 21 21 37 60 
50 13 23 26 25 39 38 0 0 0 0 0 9 0 0 16 23 0 18 3 0 2 0 0 35 43 32 23 21 23 43 62 
46 10 13 17 12 23 46 28 0 0 7 20 0 0 59 86 0 0 1 0 0 34 46 38 33 16 15 17 26 25 42 58 
42 21 20 14 4 21 45 42 26 0 0 19 0 38 134 71 0 0 0 3 2 28 45 51 33 7 12 28 42 37 40 52 
52 26 20 15 12 25 36 46 71 5 0 0 8 38 38 19 29 12 0 19 0 13 25 39 22 28 57 75 81 81 68 50 
54 16 14 21 18 13 25 46 79 30 0 0 17 33 0 0 10 31 42 6 0 27 10 14 11 44 86 79 55 71 76 57 
50 18 7 0 13 27 17 28 50 34 18 0 10 34 0 0 6 51 31 0 11 36 6 8 4 26 19 0 0 30 47 67 
51 20 0 0 22 27 0 0 0 23 51 19 0 22 7 12 50 49 0 0 31 26 5 8 2 22 0 0 0 24 13 63 
43 19 21 49 29 0 2 0 0 32 81 65 12 15 27 40 30 4 4 17 29 27 21 21 9 33 15 0 21 14 0 51 
52 18 38 67 31 0 32 30 0 6 56 59 32 8 17 21 5 14 19 6 17 34 44 33 15 47 37 11 18 17 0 40 
60 21 34 50 42 30 47 43 1 0 14 22 27 15 12 14 30 56 25 19 25 22 38 32 45 103 54 0 9 27 0 59 
45 30 30 41 37 32 30 39 41 0 0 21 11 23 27 21 28 34 22 39 45 23 21 35 83 133 15 0 22 21 7 87 
45 31 35 40 16 24 19 23 53 32 0 1 18 20 20 4 8 7 5 20 30 25 29 37 65 79 0 0 40 14 13 83 
61 20 42 39 0 26 18 0 0 41 0 10 27 9 0 0 17 17 8 5 3 16 40 25 24 21 0 22 49 19 17 65 
43 4 13 0 0 38 19 0 0 37 54 9 0 1 0 9 30 14 16 30 14 13 32 8 14 0 0 29 51 19 22 63 
29 8 0 0 0 47 21 2 24 14 35 0 0 7 6 26 24 2 12 40 27 20 18 0 15 0 0 41 41 13 25 72 
37 12 11 11 28 21 4 5 4 0 0 0 21 5 17 31 16 1 13 17 8 25 7 0 9 8 6 50 29 17 30 72 
46 10 17 40 34 0 0 0 2 0 0 21 42 2 28 32 5 0 15 3 0 23 10 0 0 17 33 47 24 23 36 68 
158 77 75 72 57 54 64 77 77 93 157 161 98 63 63 58 48 56 61 35 47 68 49 56 81 93 136 194 186 162 149 61 
