27 26 23 20 21 24 28 30 32 33 31 24 23 24 21 23 36 38 33 28 13 8 7 10 15 17 23 22 24 23 23 21 
22 16 12 8 6 9 12 14 15 16 13 8 8 11 10 12 24 32 22 0 0 0 0 0 0 0 1 9 11 12 13 15 
21 15 15 8 5 6 10 11 13 15 12 8 8 11 11 13 24 30 12 0 0 0 0 0 0 0 0 5 7 11 13 16 
24 18 16 1 0 0 1 3 2 5 9 8 9 11 10 12 22 26 3 0 0 0 0 0 0 0 0 0 5 10 13 16 
30 27 19 0 0 0 0 0 0 0 0 7 8 13 13 14 23 27 3 0 0 0 0 0 0 0 0 0 2 10 14 16 
32 33 20 0 0 0 0 0 0 0 0 3 15 26 33 36 39 38 12 0 0 0 0 0 0 0 0 0 0 10 15 15 
31 29 18 0 0 0 0 0 0 0 0 4 25 38 44 42 38 33 10 0 0 0 0 0 0 0 0 0 0 12 25 12 
30 29 20 0 0 0 0 0 0 0 0 7 16 26 25 17 12 7 0 0 0 0 0 0 0 0 0 0 5 27 36 12 
36 39 30 4 0 0 0 0 0 0 0 5 4 6 0 0 0 0 0 0 0 0 0 0 0 0 0 0 16 32 29 15 
51 48 33 12 0 0 0 0 0 0 1 0 0 0 0 0 0 0 0 0 0 0 0 0 0 0 0 0 19 26 21 6 
56 44 27 18 0 0 0 0 0 0 0 2 0 0 0 0 0 0 0 0 1 0 0 0 0 0 1 19 23 30 18 0 
47 39 30 18 0 0 0 0 0 1 11 24 21 22 20 9 4 6 8 10 11 1 0 0 3 16 26 34 34 34 17 3 
44 42 40 24 12 0 0 0 0 6 24 37 45 47 50 38 28 30 28 25 18 8 0 0 10 21 26 28 30 28 19 4 
47 46 44 35 24 9 0 0 0 7 25 40 48 51 57 46 34 38 34 30 23 15 7 3 13 19 18 21 21 24 19 5 
46 45 43 39 33 21 4 0 0 3 22 35 40 55 49 46 35 33 36 30 27 17 8 4 12 18 17 19 20 23 19 6 
44 41 41 38 37 29 11 2 0 0 13 28 34 36 27 30 28 23 34 29 25 12 1 0 7 15 19 22 23 24 20 6 
41 37 34 34 34 31 18 9 3 8 5 26 32 17 19 16 19 17 23 25 25 10 0 0 7 16 20 22 21 20 18 3 
36 31 29 29 28 29 23 14 11 18 11 23 35 25 25 22 22 18 8 17 21 9 0 0 11 14 12 9 4 0 3 0 
35 29 26 25 27 28 28 20 19 22 22 18 34 34 28 30 27 16 7 16 17 10 0 0 14 13 7 5 0 0 0 0 
35 28 29 28 26 30 32 25 22 22 23 14 23 31 28 29 23 14 16 18 19 11 0 0 15 19 19 23 20 10 11 6 
35 29 31 29 25 31 36 32 23 18 17 10 11 21 22 17 11 10 13 16 18 9 0 1 14 22 28 32 32 24 21 14 
35 31 25 23 24 24 32 33 13 7 1 1 0 6 8 4 4 3 6 11 8 4 0 0 11 16 22 24 26 25 22 13 
35 30 22 19 21 16 16 23 4 0 0 0 0 0 0 0 0 0 1 3 0 0 0 0 7 6 14 19 21 20 25 7 
34 28 23 15 17 10 2 10 9 0 0 0 0 0 0 0 0 0 0 0 0 0 0 0 2 0 5 13 16 18 22 3 
33 30 25 13 15 7 0 0 14 0 0 3 0 0 0 0 0 0 0 0 0 0 0 0 0 0 1 10 16 19 14 5 
32 29 25 16 15 9 0 0 14 15 0 0 0 0 0 4 10 11 8 2 0 0 0 0 0 0 4 14 18 20 12 5 
32 26 22 21 19 12 2 11 19 33 4 0 0 0 3 16 22 19 12 6 2 0 0 0 0 3 12 17 18 19 15 3 
34 29 29 33 28 19 10 13 26 32 3 0 0 0 9 23 29 22 11 4 2 0 0 0 5 10 19 19 19 19 18 2 
34 31 36 37 30 21 9 9 28 24 5 0 0 0 13 26 30 25 12 5 5 0 2 4 10 16 20 20 19 20 18 4 
34 30 31 30 23 14 7 16 30 28 12 0 0 0 12 24 27 24 14 9 9 7 9 12 19 22 22 20 17 19 16 5 
34 29 28 25 21 8 10 22 33 35 16 0 0 0 6 17 20 18 12 11 9 8 11 21 29 30 27 21 15 18 15 5 
23 10 11 12 9 1 0 9 16 8 0 0 0 0 0 4 6 5 5 4 3 3 4 12 18 14 3 0 0 0 0 2 
