80 20 15 14 18 37 55 49 25 20 22 3 0 6 24 21 45 52 4 38 91 39 7 13 25 15 2 14 8 21 20 0 
82 0 0 10 17 34 50 40 16 10 17 0 0 0 18 16 38 53 30 43 41 1 0 0 28 39 7 0 0 19 15 0 
51 0 21 40 32 39 51 42 16 13 23 3 0 0 21 19 39 59 45 26 0 0 1 1 41 76 9 0 0 19 16 0 
27 6 46 53 21 30 40 42 23 14 20 3 0 3 19 15 36 59 42 1 0 0 9 8 49 93 12 0 0 18 16 0 
33 21 49 50 21 34 28 27 28 16 14 2 0 3 26 31 49 70 47 0 0 5 8 13 51 81 13 0 0 12 18 0 
50 29 52 39 11 20 16 13 23 24 19 7 6 53 96 95 84 80 45 0 0 0 6 15 54 72 15 0 0 1 16 0 
67 18 46 41 6 3 13 4 7 25 46 58 79 116 118 83 43 30 1 0 0 0 3 13 52 75 26 0 0 3 49 23 
90 0 46 76 6 0 11 12 12 20 68 128 108 64 57 35 0 0 0 0 0 0 0 12 50 82 42 0 0 61 126 7 
141 0 56 105 0 0 0 17 18 21 87 153 68 0 30 24 0 0 0 0 0 0 0 14 54 73 34 0 40 143 111 0 
192 0 30 62 0 0 0 3 15 28 89 92 0 0 5 6 0 0 0 0 0 0 0 16 57 42 2 21 98 151 33 0 
194 0 0 0 21 0 0 0 14 32 34 0 0 0 3 0 0 0 0 0 22 21 8 31 78 51 25 82 126 96 5 0 
160 0 0 0 15 11 0 0 7 18 0 0 0 1 19 17 0 0 0 5 30 54 35 54 113 87 60 74 66 37 0 0 
134 0 9 0 0 18 18 0 0 0 0 5 21 16 33 50 0 0 1 3 19 55 68 90 124 81 44 27 18 23 0 0 
131 3 14 5 0 18 33 7 0 0 0 19 32 33 67 83 0 0 3 5 20 64 111 127 101 49 26 23 26 26 0 0 
131 8 12 8 0 13 30 30 1 0 0 16 25 55 113 75 0 0 0 15 32 71 114 122 70 24 22 29 34 25 0 0 
133 16 14 13 5 16 18 31 39 0 0 0 30 64 60 0 0 0 0 25 32 48 79 110 70 33 31 34 32 21 0 0 
137 14 8 13 12 13 1 12 43 10 0 0 48 35 0 0 47 29 0 14 23 35 54 100 82 61 40 24 16 9 0 0 
131 7 6 19 17 7 0 0 17 35 8 0 34 26 0 4 51 52 7 0 27 39 30 82 94 73 19 0 0 0 0 0 
129 14 10 14 17 12 0 0 0 43 69 0 0 19 0 0 47 48 0 0 50 39 25 78 102 68 0 0 0 0 0 0 
127 15 15 28 21 2 0 0 0 40 103 30 0 2 1 19 41 12 0 17 52 26 26 75 105 77 0 4 48 0 0 0 
124 17 27 45 7 0 19 19 0 25 87 50 0 0 12 15 4 0 4 33 37 24 32 74 110 88 16 23 35 0 0 0 
127 18 21 18 2 0 25 42 0 0 25 31 0 0 4 2 8 26 26 35 35 24 30 60 109 88 18 28 26 0 0 0 
121 15 6 0 13 31 4 25 30 0 0 23 23 17 15 10 23 29 12 40 41 16 18 49 117 92 3 31 36 0 0 0 
113 19 5 0 0 40 0 0 70 10 0 18 19 25 22 10 5 0 5 37 37 10 6 39 102 60 0 62 62 0 0 0 
115 13 7 0 0 51 4 0 67 59 0 2 18 14 12 2 0 0 13 33 33 24 10 21 56 17 3 127 85 0 0 0 
114 0 1 0 0 57 18 0 33 90 28 7 18 6 6 12 12 1 18 32 30 34 18 6 31 15 53 160 87 0 0 0 
106 0 0 0 0 60 30 0 37 86 74 0 0 4 19 27 5 0 13 34 33 30 4 0 38 30 79 164 80 4 0 0 
114 9 3 0 19 45 33 28 27 39 56 0 2 10 34 26 0 0 7 21 27 27 0 0 43 46 100 156 62 6 0 0 
126 6 14 19 8 0 18 26 11 35 62 36 21 0 24 16 0 0 5 0 19 37 0 2 42 56 112 139 47 11 0 0 
134 3 11 13 0 0 21 33 25 53 88 59 1 0 7 6 0 4 8 0 16 41 14 21 41 52 104 121 47 14 0 0 
138 4 4 0 0 2 31 43 26 53 105 46 0 0 0 0 0 17 12 0 22 33 12 33 48 40 80 113 58 14 0 0 
48 0 0 0 0 0 0 0 0 0 0 0 0 0 0 0 0 0 0 0 0 0 0 0 2 0 0 0 0 0 0 0 
