9 2 2 2 4 6 6 1 0 0 0 0 0 3 5 5 4 0 0 9 19 17 20 19 14 6 5 8 8 7 6 4 
4 0 0 0 0 0 0 0 0 0 0 0 0 0 0 0 0 0 0 8 14 15 17 17 11 0 0 0 2 1 0 0 
4 0 0 0 0 2 0 0 0 0 0 0 0 0 0 0 0 0 0 12 20 24 24 22 16 3 0 0 0 1 0 0 
3 0 4 7 7 7 3 0 0 0 0 0 0 0 0 0 0 0 4 16 28 35 33 27 22 8 0 0 0 0 0 0 
6 1 8 10 13 16 15 8 0 0 0 0 0 0 0 0 0 0 4 18 35 44 40 31 26 11 0 0 0 0 0 0 
9 4 9 12 18 22 23 23 19 6 0 0 0 0 0 0 0 0 0 9 32 44 42 33 26 10 0 0 0 0 0 0 
10 6 8 9 16 24 29 30 27 18 3 0 0 0 0 0 0 0 0 0 15 37 39 33 26 9 0 0 0 0 0 0 
7 0 4 6 9 19 32 35 32 26 14 0 0 0 0 0 0 0 0 0 0 24 31 30 25 10 0 0 0 0 0 0 
0 0 0 3 0 10 30 39 40 31 20 3 0 0 0 0 0 0 0 0 0 11 22 25 23 10 0 0 0 0 0 0 
0 0 0 0 0 0 22 37 40 33 22 0 0 0 0 0 0 0 0 0 0 3 12 18 17 3 0 0 0 0 0 0 
0 0 0 0 0 0 7 26 32 29 17 0 0 0 0 0 0 0 0 0 0 0 5 10 4 0 0 0 0 0 0 0 
0 0 0 0 0 0 0 11 21 16 0 0 0 0 0 0 0 0 0 0 3 2 4 5 0 0 0 0 0 0 0 0 
0 0 0 0 0 0 0 0 10 4 0 0 0 0 0 0 0 0 0 0 3 7 3 0 0 0 0 0 0 0 0 0 
0 0 0 0 0 0 0 0 1 0 0 0 0 0 0 0 0 0 0 0 1 5 3 0 0 0 0 0 0 0 0 0 
0 0 0 0 0 0 0 0 0 0 0 0 0 0 0 0 0 0 0 0 2 7 5 0 0 0 0 0 0 0 0 0 
0 0 0 0 0 0 0 0 0 0 0 0 0 3 1 0 0 0 0 0 0 5 3 0 0 0 0 0 0 0 0 0 
0 0 0 0 0 0 0 0 0 0 0 0 0 0 0 0 0 0 0 0 0 0 2 0 0 0 0 0 0 0 0 0 
0 0 0 0 0 0 0 0 0 0 0 0 0 0 0 0 0 0 0 0 0 0 0 0 0 0 0 0 0 0 0 0 
0 0 0 0 0 0 0 0 0 0 0 0 0 0 0 0 0 0 0 0 0 0 0 0 0 0 0 0 0 0 0 0 
0 0 0 0 0 0 0 0 0 0 0 0 0 0 0 0 0 0 0 0 0 0 0 0 0 0 0 0 0 0 0 0 
0 0 0 0 0 0 0 0 0 0 0 0 0 0 0 0 0 0 0 0 0 0 0 0 0 0 0 0 0 0 0 0 
0 0 0 0 0 0 0 0 0 0 0 0 0 0 0 0 0 0 0 0 0 0 0 0 0 0 0 0 0 0 0 0 
0 0 0 0 0 0 0 0 0 0 0 0 0 0 0 0 0 0 0 0 0 0 0 0 0 0 0 0 0 0 0 0 
0 0 0 0 0 0 0 0 0 0 0 0 0 0 0 0 0 0 0 0 0 0 0 0 0 0 0 0 0 0 0 0 
0 0 0 0 0 2 0 0 0 0 0 0 0 0 0 0 0 0 0 0 0 0 0 0 0 0 0 0 0 0 0 0 
0 0 0 0 2 13 8 3 2 0 0 0 0 0 0 0 0 0 0 0 0 0 0 0 0 0 4 0 0 0 0 0 
0 0 0 0 3 18 12 4 3 0 0 0 0 0 0 0 0 0 0 0 0 0 0 0 5 5 11 0 0 0 0 0 
0 0 0 0 0 14 14 9 0 0 0 0 0 0 0 0 0 0 0 0 0 0 0 0 9 6 7 0 0 0 0 0 
0 0 0 0 0 8 15 6 0 0 0 0 0 0 0 0 0 0 0 0 0 0 0 0 7 3 1 0 0 0 0 0 
0 0 0 0 0 4 12 0 0 0 0 0 0 0 0 0 0 0 4 5 6 0 0 0 0 0 0 0 0 0 0 0 
0 0 0 0 0 7 12 0 0 0 0 0 0 0 0 0 0 3 10 12 16 12 3 0 0 0 0 0 0 0 0 0 
5 0 0 0 4 17 20 6 0 3 3 0 0 0 0 3 9 17 18 20 25 20 13 9 0 0 3 0 0 0 0 0 
