52 55 45 36 34 39 49 57 59 60 59 51 42 36 34 36 48 58 58 61 61 56 44 43 46 48 48 41 35 31 32 26 
22 8 4 3 3 5 2 0 0 0 0 0 0 0 2 2 6 5 6 6 0 0 0 0 0 2 12 12 2 3 3 4 
0 0 0 15 30 28 18 2 0 0 0 0 0 0 3 4 8 8 0 0 0 0 0 0 0 3 7 6 0 4 4 5 
0 0 0 0 0 4 6 1 0 0 0 0 0 0 2 0 2 2 0 0 0 0 0 0 0 0 0 0 2 5 5 5 
16 12 7 0 0 0 0 0 0 0 0 0 0 1 10 19 26 22 0 0 0 0 0 0 0 0 0 0 2 9 6 6 
33 35 26 2 0 0 0 0 0 0 0 0 11 51 94 122 128 106 55 0 0 0 0 0 0 0 0 0 0 9 8 6 
36 30 17 1 0 0 0 0 0 0 0 8 66 112 126 113 92 67 29 0 0 0 0 0 0 0 0 0 0 11 41 34 
42 27 17 15 1 0 0 0 0 0 0 27 56 49 8 0 0 0 0 0 0 0 0 0 0 0 0 0 7 58 103 76 
65 50 40 29 9 0 0 0 0 0 0 10 0 0 0 0 0 0 0 0 0 0 0 1 0 0 0 0 26 87 92 27 
66 60 51 9 0 0 1 0 0 0 0 0 0 0 0 0 0 0 0 0 0 0 0 3 2 0 0 0 21 46 3 0 
5 0 0 0 0 0 2 0 0 0 0 0 0 0 0 0 0 0 0 0 0 0 0 2 14 15 17 44 48 13 0 0 
0 0 0 0 0 0 0 0 6 0 0 0 0 0 0 0 0 0 0 0 0 0 0 4 30 51 72 77 38 0 0 0 
0 0 0 0 0 0 0 0 7 0 0 0 5 10 18 13 1 2 6 8 0 0 0 6 22 10 0 0 0 0 0 0 
2 0 0 0 0 0 0 0 0 2 5 21 25 27 41 46 29 17 13 13 12 10 17 24 9 0 0 0 0 0 0 0 
10 0 0 0 0 0 0 0 0 12 23 28 25 47 60 55 22 14 23 19 24 19 9 0 0 0 0 0 0 0 0 0 
11 0 0 0 0 0 0 0 0 3 13 13 15 14 0 0 0 0 38 36 31 6 0 0 0 0 0 0 0 0 0 0 
12 0 0 0 0 0 0 0 0 0 0 14 17 0 0 0 0 0 23 34 29 6 0 0 0 0 0 0 0 0 0 0 
5 0 0 0 0 0 0 0 0 0 0 24 35 8 0 0 0 0 0 0 3 3 0 0 0 0 0 0 0 0 0 0 
3 0 0 0 0 0 0 0 0 0 0 6 29 12 8 25 21 0 0 0 0 0 0 0 0 0 0 0 0 0 0 0 
6 0 0 0 0 0 0 0 0 0 0 0 0 0 0 22 23 0 0 0 7 0 0 0 0 0 0 0 0 0 0 0 
4 0 0 0 0 0 0 15 26 12 0 0 0 0 0 0 0 0 0 0 0 0 0 0 0 0 0 0 10 0 0 0 
10 0 0 0 0 0 0 11 16 10 0 0 0 0 0 0 0 0 0 0 0 0 0 0 0 0 0 0 0 0 0 0 
5 0 0 0 0 0 0 0 0 0 0 0 0 0 0 0 0 0 0 0 0 0 0 0 0 0 0 0 0 0 0 0 
0 0 0 0 0 0 0 0 0 0 6 0 0 0 0 0 0 0 0 0 0 0 0 0 0 0 0 0 0 0 0 0 
9 0 0 0 0 0 0 0 0 0 0 1 0 0 0 0 0 0 0 0 0 0 0 0 0 0 0 0 0 0 0 0 
11 0 0 0 0 0 0 0 0 0 0 1 0 0 0 0 2 9 12 5 0 0 0 0 0 0 0 0 0 0 0 0 
0 0 0 0 0 0 0 10 21 11 0 0 0 0 0 13 18 9 7 7 7 1 0 0 0 0 0 0 0 0 0 0 
11 0 1 19 35 24 1 12 33 13 0 0 0 0 2 8 4 0 0 0 0 0 0 0 0 0 8 0 0 0 0 0 
20 0 12 35 44 21 0 0 0 0 0 0 0 3 0 0 0 0 0 0 0 0 0 0 1 3 4 0 0 0 0 0 
16 0 0 0 0 0 0 0 0 5 7 0 0 0 0 0 0 0 0 0 0 0 0 3 14 7 0 0 0 0 0 0 
10 0 0 0 0 0 0 5 10 15 9 0 0 0 0 0 0 0 0 0 3 0 0 4 16 7 0 0 0 0 0 0 
0 0 0 0 0 0 0 0 0 0 0 0 0 0 0 0 0 0 0 0 0 0 0 0 0 0 0 0 0 0 0 0 
