0 25 25 25 23 16 8 7 14 16 17 25 34 26 20 20 5 0 19 27 14 27 36 32 26 28 31 22 21 16 17 19 
0 22 26 27 28 23 13 9 11 12 12 17 30 27 21 22 10 0 8 33 32 31 29 29 23 21 34 32 27 18 19 17 
0 5 10 22 36 33 22 16 18 17 13 16 29 26 21 23 12 0 7 36 42 32 22 25 20 14 37 47 31 20 19 17 
0 2 0 3 22 25 24 22 28 29 20 18 28 26 21 22 11 0 6 36 46 32 20 21 21 10 29 55 38 22 18 16 
0 8 9 11 23 16 16 17 24 35 29 21 27 25 21 26 18 0 10 39 49 32 20 19 23 17 23 49 43 26 19 16 
0 9 11 19 31 23 21 24 21 25 27 24 28 25 22 32 37 26 27 53 59 34 21 20 23 24 29 40 40 30 20 16 
0 13 11 19 35 27 17 25 30 27 20 19 22 16 9 11 18 20 25 54 64 40 26 25 23 20 31 42 37 29 22 23 
0 22 13 15 41 44 18 18 27 32 18 0 6 11 0 0 0 1 3 32 53 42 33 32 32 23 29 42 40 26 17 32 
0 35 14 5 42 62 31 18 19 26 13 0 0 15 0 0 1 4 0 5 30 36 35 36 37 31 32 37 29 4 12 32 
0 30 23 2 24 61 55 31 18 16 1 0 0 0 0 0 0 8 6 0 1 21 30 35 34 35 35 24 10 0 8 28 
0 0 14 8 0 34 65 51 24 11 0 0 0 0 0 0 0 0 6 0 0 3 25 34 28 35 45 23 9 0 0 24 
0 0 0 3 1 10 43 58 31 13 12 0 0 0 0 0 0 3 8 9 0 0 17 29 13 14 25 17 4 0 0 23 
0 0 0 0 6 8 20 48 43 19 10 0 0 0 0 0 5 12 6 12 14 5 10 20 0 0 0 0 0 0 0 20 
0 0 0 0 0 3 6 29 48 31 19 4 0 0 0 0 11 22 3 8 14 11 8 13 3 0 0 0 0 0 0 17 
0 0 0 0 0 0 1 10 34 40 29 10 1 0 0 0 13 30 10 9 12 8 3 0 0 0 0 0 0 0 0 15 
0 0 0 0 0 0 5 4 8 31 40 19 3 0 0 0 0 20 25 15 16 14 8 0 0 0 0 0 0 0 0 16 
0 0 0 0 0 0 3 6 0 5 34 35 0 5 6 0 0 0 24 21 19 20 23 0 0 0 0 0 0 0 0 15 
0 0 0 0 0 0 0 6 0 0 2 41 12 2 19 10 0 0 12 20 10 11 32 9 0 0 0 0 0 0 0 5 
0 0 0 1 0 0 0 9 0 0 0 19 22 0 13 18 11 5 17 19 4 8 30 14 0 0 8 12 8 20 17 5 
0 0 0 2 2 1 0 8 17 0 0 0 22 2 5 13 11 13 18 14 4 9 25 14 0 0 15 26 19 36 49 22 
0 0 0 0 3 9 0 6 35 33 0 0 20 15 6 9 13 12 10 8 5 11 23 14 0 0 0 7 6 24 49 32 
0 0 0 0 0 2 0 0 28 54 23 0 8 20 18 22 24 20 22 18 12 14 18 11 0 0 0 0 0 6 35 35 
0 0 0 2 0 0 6 0 11 57 51 27 18 24 29 33 30 28 36 28 25 29 25 13 0 0 0 0 0 0 20 30 
0 0 0 9 4 0 7 11 0 35 61 43 38 35 35 38 39 33 32 25 23 33 34 21 0 0 0 0 0 0 14 17 
0 0 0 12 19 0 8 25 0 0 49 44 41 43 39 36 36 38 36 32 25 25 31 26 1 0 0 0 0 0 16 14 
0 1 0 8 23 0 7 33 7 0 22 48 45 47 41 32 25 32 36 38 40 33 31 31 13 0 0 0 0 0 14 22 
0 1 0 7 17 0 7 28 21 0 0 46 53 45 32 19 16 24 27 29 38 39 38 34 12 6 6 0 0 0 6 25 
0 3 6 14 19 10 8 10 7 4 1 43 56 47 23 6 8 18 23 23 24 26 33 34 10 5 3 0 0 0 2 22 
0 3 0 3 15 20 12 5 0 2 5 36 51 53 21 1 3 8 17 26 20 11 21 28 11 3 0 0 0 0 2 20 
0 3 0 0 3 16 14 5 0 1 4 30 44 49 20 0 2 4 8 22 21 9 14 18 9 3 0 0 0 0 1 19 
0 0 2 1 1 10 10 0 0 0 0 20 38 39 22 5 3 4 5 16 16 10 12 5 0 0 0 0 0 0 0 19 
0 0 0 0 0 0 0 0 0 0 0 0 0 0 0 0 0 0 0 0 0 0 0 0 0 0 0 0 0 0 0 0 
