48 1 0 0 0 19 38 31 14 11 10 0 0 0 5 5 39 36 0 19 53 4 0 0 2 0 0 0 0 5 5 0 
55 0 0 0 0 17 34 26 10 7 11 0 0 0 4 4 34 35 6 26 17 0 0 3 20 12 0 0 0 5 3 0 
39 0 10 12 2 16 28 17 0 1 11 0 0 0 4 3 29 41 29 11 0 0 6 9 38 46 0 0 0 5 3 0 
15 12 45 37 9 15 21 11 0 0 4 0 0 0 3 0 26 47 32 0 0 8 16 13 52 68 0 0 0 3 4 0 
18 14 42 30 17 30 24 16 2 0 0 0 0 0 5 7 31 55 33 0 0 15 17 19 55 64 0 0 0 0 4 0 
29 18 38 21 10 21 18 20 23 12 2 0 0 24 50 45 43 52 23 0 0 11 16 22 54 52 0 0 0 0 4 0 
44 14 33 21 4 11 20 13 14 24 27 22 43 80 85 60 33 26 0 0 0 0 11 19 53 55 1 0 0 0 21 0 
62 0 38 47 0 0 18 18 13 21 60 100 88 57 52 36 13 19 0 0 0 0 2 13 47 61 16 0 0 28 89 0 
88 0 58 78 0 0 2 23 24 25 93 142 60 15 42 29 7 5 0 0 0 0 0 11 46 56 14 0 22 112 88 0 
119 0 51 56 0 0 0 12 26 42 115 109 14 13 41 31 9 0 0 12 6 0 0 15 50 33 1 7 98 132 18 0 
147 5 2 12 25 0 0 0 23 52 74 21 0 28 50 41 0 0 0 25 33 20 2 25 60 23 9 63 120 84 2 0 
131 25 0 7 34 7 0 0 14 28 0 0 12 22 40 34 0 0 0 13 37 46 21 49 90 58 45 73 69 43 0 0 
102 12 23 18 12 28 6 0 0 0 0 9 17 15 30 35 0 0 2 0 20 49 48 85 109 75 53 41 35 38 0 0 
97 14 23 13 13 33 31 0 0 0 0 7 16 15 57 58 0 0 0 0 14 52 86 108 88 50 37 37 41 42 1 0 
98 15 17 11 8 24 41 24 0 0 0 4 9 32 92 46 0 0 0 2 21 63 102 106 61 30 29 38 44 42 0 0 
101 18 16 10 8 21 30 41 31 0 0 0 13 72 70 8 0 0 0 7 22 45 81 103 65 35 34 41 42 40 0 0 
104 17 14 11 14 19 12 36 51 1 0 0 39 33 0 12 49 11 0 0 12 23 57 91 78 61 44 38 34 34 0 0 
99 9 10 19 17 11 3 19 37 45 0 0 33 8 0 13 49 36 1 0 23 25 32 72 87 72 34 15 12 16 0 0 
96 15 13 16 15 14 1 0 8 66 48 0 5 6 0 1 37 35 0 0 46 25 24 68 92 60 0 0 1 0 0 0 
97 19 14 22 21 7 2 0 0 54 84 14 0 0 0 15 36 5 0 22 46 17 27 66 95 55 0 0 21 0 0 0 
96 20 32 42 3 0 15 0 0 25 72 26 0 0 6 14 2 0 3 31 28 16 29 66 102 71 11 23 22 0 0 0 
97 21 33 29 3 3 26 20 0 0 25 23 0 0 0 0 0 5 10 19 22 17 29 61 105 74 23 37 25 0 0 0 
94 22 12 0 21 27 8 21 0 0 0 8 5 0 0 0 7 3 0 16 14 4 13 54 116 80 19 44 38 0 0 0 
89 26 6 0 12 33 0 15 38 0 0 0 0 0 0 0 0 0 0 23 13 0 0 44 112 59 11 78 62 0 0 0 
87 19 6 0 0 38 0 0 65 22 0 0 0 0 0 0 0 0 0 15 14 2 0 25 71 16 37 133 80 0 0 0 
84 6 4 0 0 49 2 0 52 59 0 0 0 0 0 0 0 0 0 3 1 6 0 4 33 12 84 158 80 6 0 0 
76 2 0 0 3 58 11 0 39 74 41 0 0 0 0 15 0 0 0 6 1 0 0 0 32 26 99 157 75 16 0 0 
79 9 0 0 19 40 22 31 27 50 31 0 0 0 20 18 0 0 1 7 7 3 0 0 38 40 113 144 59 17 0 0 
91 9 9 11 6 0 22 31 15 44 36 14 0 0 17 9 0 0 0 0 12 19 0 6 39 54 123 126 50 21 0 0 
96 6 16 18 0 0 24 28 26 53 63 40 0 0 6 0 0 5 2 0 14 24 3 21 38 59 118 113 53 26 0 0 
101 8 8 1 0 8 33 41 27 56 89 32 0 0 0 0 0 15 6 0 22 22 10 34 46 51 97 110 62 27 0 0 
56 2 0 0 0 14 28 25 11 45 58 0 0 0 0 0 8 17 4 4 22 12 9 33 31 22 53 66 30 6 0 0 
