0 13 16 15 19 16 9 4 18 23 21 14 33 27 10 16 20 0 21 46 0 15 40 38 29 17 33 13 22 13 13 6 
0 17 20 14 14 12 0 0 6 14 11 6 30 23 5 10 12 0 17 26 0 35 40 45 34 13 18 21 29 9 9 5 
0 26 25 10 15 14 2 0 4 12 6 4 28 24 4 7 9 0 10 16 32 50 40 43 39 3 0 44 31 8 9 5 
0 19 13 0 27 26 18 7 9 15 6 5 27 22 3 8 11 0 5 25 57 54 41 40 40 0 0 59 36 9 9 4 
0 14 8 0 28 22 21 25 21 23 15 8 24 24 7 10 10 0 0 34 70 55 44 43 35 0 0 54 38 13 9 4 
0 18 6 0 34 30 28 32 26 26 22 14 30 25 0 0 7 7 0 41 84 61 47 45 31 0 3 40 34 20 11 2 
0 24 12 7 31 43 36 40 34 28 22 19 24 4 0 2 25 37 22 60 96 64 46 43 29 0 4 34 32 26 21 0 
0 37 29 0 13 62 41 43 39 33 34 6 0 10 12 11 32 42 28 64 93 61 48 41 29 0 0 28 43 32 0 0 
0 57 41 0 12 82 49 44 39 41 43 0 0 39 23 11 32 29 40 56 71 58 49 43 27 0 0 24 57 1 0 0 
0 66 37 0 31 70 61 48 40 45 27 0 10 56 30 23 26 31 63 44 40 49 43 46 20 0 19 28 38 0 0 5 
0 42 30 35 30 40 67 62 43 32 2 0 31 34 15 12 14 44 54 27 20 25 32 45 8 0 30 21 0 0 0 10 
0 15 21 44 19 27 48 68 47 13 12 15 10 10 3 0 7 35 26 11 13 3 15 43 0 0 25 15 0 4 4 17 
0 16 13 17 24 27 24 50 49 13 29 17 2 4 14 0 1 35 17 12 14 3 6 24 0 0 17 21 24 22 9 22 
0 19 11 9 22 20 20 30 49 29 34 11 0 2 16 0 2 57 15 13 15 10 0 0 0 0 12 21 23 24 11 24 
0 19 15 10 19 16 17 23 39 36 40 14 2 25 0 0 14 63 22 13 15 6 0 0 0 10 13 18 15 24 12 27 
0 15 18 11 21 16 14 27 18 28 47 31 13 12 0 15 39 48 38 11 12 2 4 0 0 10 11 12 11 24 14 29 
0 13 20 16 21 16 16 33 6 24 33 60 14 0 7 31 11 8 37 15 20 3 15 0 0 0 5 14 17 28 19 25 
0 17 22 15 13 18 16 28 9 27 5 66 19 0 39 31 3 0 12 29 27 0 26 0 0 0 0 19 23 23 22 13 
0 16 19 16 15 15 15 22 22 26 0 35 35 0 38 38 11 0 5 44 11 0 31 1 0 0 1 28 9 0 6 0 
0 15 23 17 8 18 19 16 33 28 0 0 39 15 28 31 6 0 30 37 0 5 29 5 0 0 10 30 0 0 9 0 
0 14 25 8 6 38 22 6 26 26 0 0 29 23 17 13 6 17 30 14 2 12 22 7 0 0 16 29 0 0 32 0 
0 17 14 7 20 35 20 3 5 36 0 0 15 25 12 7 14 6 8 5 0 10 14 13 0 0 19 22 2 13 39 0 
0 20 9 19 27 8 11 18 0 27 15 0 0 7 3 5 11 0 13 5 0 7 7 18 0 0 30 25 1 11 42 0 
0 15 8 22 38 0 4 35 0 0 32 0 1 0 0 3 2 0 12 0 0 5 13 19 0 0 57 25 0 12 44 0 
0 16 9 18 53 0 1 36 0 0 28 11 0 1 0 5 2 7 3 0 0 0 7 19 0 0 75 0 0 17 34 0 
0 25 12 17 65 5 0 42 19 0 0 11 0 2 4 9 0 10 5 0 0 0 0 23 4 4 65 0 0 22 21 0 
0 28 10 26 59 5 4 52 16 0 0 11 14 9 11 4 2 19 12 0 0 0 0 35 10 17 52 0 0 23 14 2 
0 22 14 33 32 3 16 36 11 23 0 26 15 15 8 0 16 29 15 0 0 0 3 43 11 19 39 0 0 23 10 0 
0 23 23 28 21 30 31 17 20 27 0 22 0 31 13 0 25 33 15 12 12 0 10 39 10 19 21 0 0 23 7 0 
0 24 22 17 22 49 32 13 19 21 0 0 3 48 22 8 29 32 16 31 28 0 15 28 8 18 9 0 2 22 6 2 
0 24 21 16 33 42 31 11 14 29 0 0 31 50 32 22 31 30 17 42 34 3 23 24 3 14 10 0 0 21 6 7 
0 27 26 27 40 35 33 16 17 21 0 12 58 52 45 34 30 30 30 47 34 21 34 19 1 14 11 0 5 32 27 47 
