51 10 8 7 8 23 43 49 38 34 36 20 0 1 14 12 32 46 8 20 73 57 40 36 38 22 0 6 2 11 10 0 
35 2 0 1 3 4 6 5 5 2 9 12 4 0 3 2 0 2 24 30 5 16 41 31 36 42 20 0 0 4 1 1 
1 12 26 27 9 2 3 3 0 0 6 10 5 0 2 0 0 3 33 26 2 30 40 33 38 65 27 0 0 3 1 2 
0 0 32 57 41 34 18 15 10 0 0 7 6 3 3 2 0 8 25 16 21 40 40 34 34 63 43 0 0 1 2 2 
0 0 0 3 18 40 38 38 47 27 2 5 7 2 3 2 0 2 16 15 33 46 36 32 30 34 43 26 0 0 1 1 
15 1 3 4 12 14 17 21 47 59 33 12 8 15 30 30 6 0 5 6 13 35 36 31 31 24 30 38 12 0 0 3 
26 0 7 18 17 11 31 23 14 33 50 49 55 68 70 72 53 32 25 7 1 19 29 26 26 40 40 25 11 2 7 12 
38 0 5 46 21 0 23 37 32 22 46 105 99 41 31 35 31 40 51 46 26 17 17 19 15 34 48 30 9 27 60 13 
61 0 10 68 27 0 3 33 46 37 50 90 43 0 19 31 23 18 24 72 62 24 18 21 22 25 30 35 46 101 61 0 
92 4 0 23 49 29 0 12 34 43 53 32 3 36 42 39 40 2 0 62 76 39 27 27 35 14 7 42 81 85 0 0 
63 81 0 0 75 87 6 0 18 36 1 0 0 12 23 33 19 0 6 13 44 55 33 31 41 12 0 42 55 0 5 24 
0 36 21 0 26 72 67 8 10 11 0 0 0 0 0 0 0 0 9 0 0 41 48 43 64 63 64 48 8 0 22 21 
0 0 17 29 0 28 75 47 1 0 0 0 1 0 0 0 0 0 5 0 0 2 47 59 59 62 63 30 2 20 33 26 
0 0 0 2 3 18 52 69 15 0 0 0 0 0 10 40 0 0 0 0 0 0 47 63 16 8 14 18 32 32 37 30 
13 7 0 1 0 0 24 65 56 13 0 0 0 2 37 9 0 0 0 0 1 14 47 58 18 5 16 22 32 30 32 27 
14 12 3 5 0 0 0 34 82 44 0 0 1 33 35 5 50 31 0 2 1 0 1 35 36 31 26 25 28 29 31 27 
18 10 9 13 14 6 0 5 52 65 23 0 20 0 0 0 66 80 19 2 0 0 0 10 30 50 40 24 23 28 36 35 
18 3 2 12 16 2 0 0 1 57 77 0 0 0 0 0 0 38 40 0 17 20 0 0 22 37 21 8 8 14 28 51 
10 13 12 7 7 10 5 0 0 20 92 56 0 5 19 0 0 4 1 0 29 16 9 13 23 19 0 0 0 0 0 35 
16 16 12 12 11 4 8 0 0 0 47 70 0 0 25 19 12 0 0 25 16 5 21 22 25 25 0 0 16 0 0 0 
13 13 24 41 12 0 14 18 0 0 0 39 15 0 18 21 0 0 23 27 0 9 21 19 30 47 59 61 40 10 0 0 
15 9 16 11 21 26 18 45 37 0 0 13 40 8 0 0 0 7 10 0 0 11 22 20 33 39 38 45 33 32 14 0 
19 13 0 0 13 51 4 8 50 0 0 0 8 16 0 0 12 18 0 0 1 0 0 3 32 46 25 37 41 42 34 14 
4 14 7 0 0 27 3 0 57 53 0 0 0 4 8 4 0 0 6 18 16 2 0 0 14 27 16 63 62 30 28 31 
9 0 8 0 0 12 13 0 20 85 13 0 4 0 1 2 0 0 0 0 0 15 7 0 0 0 20 82 62 34 20 10 
20 0 6 4 0 17 34 0 0 43 55 0 0 0 0 2 9 2 0 0 0 0 3 0 0 0 42 66 45 39 23 0 
12 3 0 0 3 13 33 19 0 0 72 18 0 5 14 21 6 0 6 10 3 0 0 0 6 17 30 37 34 37 31 12 
9 9 0 1 7 0 25 68 21 0 20 19 18 8 23 16 0 0 2 7 16 13 0 0 17 29 35 32 21 28 29 22 
32 12 25 49 16 0 16 37 3 0 14 53 44 0 7 2 0 14 10 0 0 22 15 13 11 27 39 30 27 33 26 16 
29 8 15 28 11 0 19 14 6 11 39 62 27 3 1 2 5 16 20 2 0 9 20 25 10 14 23 26 37 36 27 14 
28 14 5 0 1 31 31 33 18 11 53 45 11 23 0 0 14 19 20 18 19 12 17 27 22 5 0 24 46 31 26 16 
0 34 28 17 22 37 32 28 21 25 38 47 58 58 27 21 30 28 28 34 27 17 20 22 22 11 0 15 50 59 59 73 
