29 0 0 0 0 0 0 0 0 0 0 0 0 0 0 0 0 0 0 0 0 0 0 0 0 0 0 0 0 0 0 0 
37 0 1 11 9 11 17 23 19 17 21 20 4 7 17 16 14 31 25 0 0 0 13 10 23 31 0 0 0 16 15 19 
29 15 30 27 10 5 11 13 7 12 21 23 8 9 20 17 15 33 24 0 0 8 24 18 31 45 0 0 4 17 17 18 
36 48 53 26 0 0 0 0 0 0 7 19 10 10 14 10 8 23 13 0 3 21 27 20 22 42 4 0 0 15 16 17 
34 28 27 37 25 22 0 0 0 0 0 14 7 8 22 25 23 32 27 12 13 17 15 18 14 29 32 0 0 11 16 17 
28 7 6 14 6 15 19 23 34 21 1 5 19 45 69 52 18 7 8 0 0 11 12 13 15 28 41 17 0 0 15 16 
32 0 4 18 3 6 20 12 21 40 44 45 48 34 0 0 0 0 0 0 0 6 16 11 17 40 34 9 1 7 38 27 
47 0 21 47 0 0 19 20 15 19 55 76 5 0 0 0 0 0 0 0 0 0 13 13 19 47 43 8 9 48 61 0 
73 0 28 48 0 0 4 22 21 17 44 59 0 0 5 21 16 7 29 47 14 0 5 13 17 30 32 21 41 56 0 0 
97 0 0 10 16 0 0 10 24 33 29 10 0 4 22 35 24 0 22 76 47 11 3 8 15 9 19 51 54 19 0 0 
110 0 0 0 66 14 0 0 27 31 0 5 53 86 86 74 45 41 51 69 76 47 17 18 34 37 46 84 32 1 11 14 
89 43 17 10 48 55 2 0 6 6 0 64 106 84 89 93 87 88 72 48 61 70 37 26 49 46 15 0 0 0 11 10 
65 34 66 34 19 62 64 0 0 0 10 36 36 19 28 52 42 26 22 13 15 47 63 42 42 19 0 0 0 9 23 9 
69 23 28 29 28 38 53 21 0 0 7 15 20 21 32 34 0 0 11 11 11 35 73 43 13 9 11 23 27 24 26 7 
65 12 12 19 16 21 42 52 13 0 0 0 0 24 30 11 0 0 3 15 16 21 31 17 0 4 23 31 32 22 23 9 
66 17 12 17 14 18 22 52 52 0 0 0 14 15 0 0 7 0 0 13 5 0 11 44 44 31 31 29 26 20 23 10 
63 12 5 13 9 7 5 22 54 38 0 0 34 0 0 65 114 52 0 0 0 0 11 55 67 56 29 10 11 13 27 12 
57 9 13 25 16 7 15 9 36 72 44 0 9 15 9 32 47 58 5 0 7 11 0 32 61 50 15 0 4 11 38 41 
64 24 16 13 19 19 20 0 15 61 93 0 0 21 2 0 14 33 15 18 35 23 3 29 46 35 5 25 62 59 75 103 
62 20 19 26 21 10 16 5 0 30 93 35 0 7 20 8 1 0 13 31 22 16 12 24 37 45 29 49 68 30 10 63 
60 22 27 26 0 0 32 35 1 0 43 52 0 5 20 0 0 4 33 16 5 19 19 27 39 49 23 0 0 0 0 8 
61 22 12 6 17 9 13 28 0 0 0 39 20 0 4 5 27 51 31 14 18 23 16 18 34 42 18 7 6 10 0 0 
55 12 2 5 49 39 0 17 36 0 0 46 66 43 25 25 31 17 0 19 24 16 19 26 54 51 8 21 34 24 5 0 
59 26 19 1 14 39 0 7 85 25 0 14 23 30 23 15 2 12 20 24 24 8 12 21 40 37 9 54 50 18 9 11 
56 18 27 4 0 49 32 0 68 71 0 0 10 7 13 13 11 26 38 36 45 41 21 3 6 41 58 100 64 24 0 22 
50 0 19 10 0 45 35 0 19 106 44 1 9 3 17 32 35 19 14 18 27 44 31 4 15 66 70 82 52 29 3 18 
55 8 13 21 11 41 42 16 6 66 62 0 0 6 29 28 9 0 2 12 11 11 7 6 32 48 34 61 47 25 17 11 
68 26 26 40 21 14 40 26 0 0 26 10 16 22 28 12 0 1 6 13 15 12 8 5 31 38 23 43 31 22 28 15 
62 4 19 12 0 0 11 13 4 4 52 53 20 0 5 8 7 14 3 0 24 39 27 12 27 37 23 37 26 19 18 15 
65 6 12 6 0 0 17 31 32 28 56 29 0 0 0 8 6 11 8 0 8 33 34 22 22 26 20 43 34 21 15 13 
68 10 5 4 20 21 21 27 9 10 42 5 0 0 0 5 12 12 12 6 4 12 14 23 27 11 14 55 45 20 20 16 
13 0 0 0 5 9 0 0 0 0 0 0 0 0 0 9 12 2 8 5 0 4 4 3 0 0 0 0 0 0 0 37 
