85 34 24 18 18 36 62 69 54 50 52 33 0 10 26 24 47 69 29 46 106 71 39 37 45 35 14 22 11 20 20 3 
84 0 0 0 0 3 18 7 0 0 0 0 0 0 0 0 1 22 0 14 29 0 0 0 0 9 0 0 0 0 0 0 
40 0 0 16 14 19 25 8 0 0 0 0 0 0 0 0 0 27 16 3 0 0 0 0 0 45 0 0 0 0 0 0 
5 0 0 28 6 15 22 11 0 0 0 0 0 0 0 0 0 28 17 0 0 0 0 0 9 60 0 0 0 0 0 0 
19 0 21 22 0 0 0 0 0 0 0 0 0 0 2 3 16 42 28 0 0 0 0 0 16 48 0 0 0 0 0 0 
43 16 42 33 0 0 0 0 0 0 0 0 0 26 90 105 100 96 61 0 0 0 0 0 21 39 0 0 0 0 0 0 
67 10 35 31 0 0 0 0 0 0 0 13 53 118 152 130 87 64 28 0 0 0 0 0 16 38 0 0 0 0 25 21 
100 0 29 61 0 0 0 0 0 0 21 92 104 74 50 2 0 0 0 0 0 0 0 0 15 41 0 0 0 34 122 51 
164 0 40 103 0 0 0 0 0 0 52 127 47 0 0 0 0 0 0 0 0 0 0 0 31 46 0 0 0 131 140 0 
217 0 33 65 0 0 0 0 0 3 53 65 0 0 0 0 0 0 0 0 0 0 0 2 42 27 0 0 45 139 33 0 
192 0 0 0 0 0 0 0 0 8 0 0 0 0 0 0 0 0 0 0 0 0 0 3 59 37 0 38 90 80 0 0 
132 0 0 0 0 0 0 0 0 0 0 0 0 0 0 0 0 0 0 0 0 0 0 19 95 82 55 84 68 5 0 0 
108 0 0 0 0 0 0 0 0 0 0 0 0 0 1 19 0 0 0 0 0 18 28 50 102 58 13 0 0 0 0 0 
113 0 0 0 0 0 0 0 0 0 0 0 2 1 36 75 0 0 0 0 0 39 83 92 74 0 0 0 0 0 0 0 
117 0 0 0 0 0 0 0 0 0 0 0 5 29 93 80 0 0 0 0 12 53 94 89 24 0 0 0 0 0 0 0 
118 0 0 0 0 0 0 0 0 0 0 0 2 33 43 0 0 0 0 11 18 32 42 41 0 0 0 0 0 0 0 0 
124 0 0 0 0 0 0 0 0 0 0 0 16 7 0 0 0 0 0 8 10 19 10 23 0 0 0 0 0 0 0 0 
119 0 0 0 0 0 0 0 0 0 0 0 17 11 0 0 0 3 0 0 0 21 0 25 4 0 0 0 0 0 0 0 
115 0 0 0 0 0 0 0 0 0 13 0 0 5 0 0 27 20 0 0 4 17 0 25 27 0 0 0 0 0 0 0 
115 0 0 0 0 0 0 0 0 0 38 0 0 0 0 0 29 0 0 0 24 5 0 22 36 8 0 0 0 0 0 0 
111 0 0 3 0 0 0 0 0 0 40 0 0 0 0 0 0 0 0 0 10 0 0 19 39 20 0 0 4 0 0 0 
116 0 0 0 0 0 0 7 0 0 0 0 0 0 0 0 0 0 0 0 0 0 0 1 33 12 0 0 0 0 0 0 
111 0 0 0 0 0 0 0 0 0 0 0 0 0 0 0 0 0 0 0 0 0 0 0 27 8 0 0 0 0 0 0 
98 0 0 0 0 0 0 0 0 0 0 0 0 0 0 0 0 0 0 0 0 0 0 0 19 0 0 0 0 0 0 0 
103 0 0 0 0 0 0 0 0 0 0 0 0 0 0 0 0 0 0 0 0 0 0 0 0 0 0 2 0 0 0 0 
108 0 0 0 0 22 0 0 0 26 0 0 0 0 0 0 0 0 0 2 0 0 0 0 0 0 0 79 15 0 0 0 
96 0 0 0 0 37 9 0 7 54 23 0 0 0 0 0 0 0 0 10 3 0 0 0 0 0 12 118 12 0 0 0 
103 0 0 0 0 41 19 0 23 30 30 0 0 0 0 0 0 0 0 0 0 0 0 0 12 15 53 124 0 0 0 0 
122 0 0 2 13 7 2 0 0 0 29 0 0 0 0 0 0 0 0 0 0 0 0 0 19 26 67 105 0 0 0 0 
129 0 0 0 0 0 0 0 0 9 63 26 0 0 0 0 0 0 0 0 0 9 0 0 25 26 59 74 0 0 0 0 
132 0 0 0 0 0 0 15 0 24 83 21 0 0 0 0 0 0 0 0 0 18 0 1 30 15 35 49 0 0 0 0 
24 0 0 0 0 0 0 0 0 0 0 0 0 0 0 0 0 0 0 0 0 0 0 0 0 0 0 0 0 0 0 0 
