19 29 20 20 13 2 0 9 21 20 22 43 38 16 14 12 0 15 47 8 0 19 28 19 18 42 34 27 14 12 11 34 
0 30 28 28 18 0 0 0 13 11 13 44 47 18 13 11 0 0 35 5 0 13 30 19 9 45 53 36 17 10 11 41 
0 4 17 41 43 20 0 11 22 12 11 41 46 19 14 14 0 0 11 10 10 14 23 16 0 22 77 56 22 11 13 42 
0 0 0 0 10 11 4 18 38 23 10 39 46 20 12 9 0 0 0 25 32 21 18 15 0 0 80 82 27 11 13 42 
8 8 0 0 1 0 0 0 20 34 22 40 43 18 22 31 7 0 19 53 43 23 17 9 0 0 57 92 43 14 14 45 
15 7 0 9 12 0 4 0 0 9 23 43 54 51 69 94 82 49 67 93 56 22 16 0 0 0 49 78 52 22 12 48 
16 6 0 19 32 6 11 11 0 0 6 51 67 47 36 51 55 41 82 125 82 32 18 0 0 0 46 71 52 31 28 97 
28 21 0 30 72 23 6 13 15 0 0 7 25 0 0 7 22 12 60 127 102 53 30 8 0 0 31 68 60 52 39 158 
60 68 0 18 103 66 13 5 10 4 0 0 3 0 0 6 26 15 20 85 95 64 44 20 0 0 14 57 37 24 12 184 
32 121 0 0 99 123 48 7 5 0 0 0 0 0 0 0 10 24 1 11 48 53 45 17 0 0 4 36 0 0 23 222 
0 72 32 0 37 113 97 35 12 0 0 0 0 0 0 0 0 25 9 0 0 25 40 10 2 52 69 44 0 0 53 236 
0 2 37 19 0 44 105 71 18 2 0 0 20 0 0 0 25 45 28 0 0 0 24 0 0 56 79 31 0 0 68 236 
0 3 16 22 2 11 74 93 35 26 23 9 8 8 0 26 61 40 25 14 0 0 1 0 0 7 20 13 9 16 75 240 
0 18 9 21 13 0 21 80 67 56 41 17 9 12 0 22 81 44 21 18 0 0 0 0 0 0 9 13 21 20 72 239 
0 23 14 24 18 0 0 37 84 88 49 16 8 2 0 26 109 74 23 22 0 0 0 0 0 9 15 14 20 20 72 236 
0 24 21 31 26 12 0 0 48 101 70 13 11 0 0 0 63 97 44 29 4 0 0 0 0 17 25 18 22 23 77 237 
0 19 13 22 25 14 11 0 0 69 112 33 0 0 0 0 0 59 54 32 11 0 0 0 0 0 18 14 13 11 65 238 
0 21 18 15 19 17 26 0 0 0 115 79 0 39 55 5 0 3 36 20 1 14 0 0 0 0 0 0 0 0 4 205 
0 25 22 12 17 25 36 22 0 0 37 92 13 37 68 27 0 2 35 20 0 13 0 0 0 0 21 10 15 18 0 163 
0 20 24 32 33 22 34 54 20 0 0 59 35 25 51 32 1 12 42 20 0 11 0 0 0 17 87 74 66 87 42 145 
0 16 10 16 45 33 29 78 80 0 0 22 53 28 21 3 0 12 24 0 0 10 0 0 0 3 64 52 51 105 78 150 
0 16 0 0 24 42 7 30 81 13 0 0 21 21 9 6 12 27 11 0 0 0 0 0 0 0 30 17 35 101 99 176 
0 11 13 1 0 18 1 0 59 68 6 0 7 19 21 23 7 13 6 0 12 6 0 0 0 0 9 0 29 82 80 206 
0 5 26 28 0 0 16 0 0 91 49 23 16 14 22 26 6 1 0 0 0 18 10 0 0 0 0 0 17 75 51 211 
0 6 28 55 0 0 41 0 0 41 62 26 27 17 18 20 28 27 5 0 0 5 18 0 0 0 0 0 2 70 50 205 
0 13 22 64 0 0 47 24 0 0 70 47 30 26 30 33 43 39 18 9 3 6 21 0 0 2 0 0 0 57 67 212 
0 21 27 60 8 0 42 63 0 0 27 43 27 28 33 36 43 34 9 8 14 14 34 4 0 15 0 0 0 40 68 226 
0 35 58 85 38 0 21 35 12 0 0 49 57 35 20 27 42 41 13 0 0 12 46 13 0 5 0 0 5 38 60 231 
0 31 41 59 43 9 4 6 7 0 6 50 76 45 13 26 42 37 30 13 0 1 43 20 0 0 0 0 12 38 59 231 
0 34 22 19 36 28 10 18 21 0 3 38 76 60 17 25 37 25 34 35 0 1 30 18 4 0 0 0 14 31 60 230 
0 35 28 24 33 30 7 12 18 0 0 37 74 68 25 21 28 17 34 37 5 7 13 0 9 0 0 0 9 28 62 229 
0 0 0 0 0 0 0 0 0 0 0 0 0 0 0 0 0 0 0 0 0 0 0 0 0 0 0 0 0 0 0 102 
