0 0 0 0 0 0 0 0 0 0 0 0 0 0 0 0 0 0 0 0 0 0 0 0 0 0 0 0 0 0 0 0 
13 0 0 0 1 13 21 19 12 15 14 0 0 3 11 11 28 28 0 0 10 24 12 15 16 0 0 0 5 13 12 4 
68 39 17 0 0 0 0 3 3 11 14 2 0 3 10 9 24 26 0 0 27 33 27 19 28 0 0 0 0 13 11 2 
74 52 45 12 0 0 0 0 0 0 8 2 0 0 9 12 27 31 6 8 25 26 24 18 31 20 0 0 0 12 11 1 
28 15 31 36 30 28 27 30 5 0 0 0 0 3 4 0 0 10 0 0 4 14 17 17 28 44 5 0 0 7 10 0 
1 0 1 10 11 30 36 46 49 26 3 0 0 0 0 0 0 0 0 0 0 13 17 20 32 43 13 0 0 0 9 0 
0 0 7 0 0 19 25 24 42 54 32 0 0 0 0 0 0 0 0 0 0 3 17 23 46 47 4 0 0 0 0 0 
0 0 15 0 0 0 29 22 17 29 39 0 0 0 0 0 0 0 0 0 0 0 3 14 40 50 9 0 0 0 0 0 
0 0 0 0 0 0 17 27 17 18 33 5 0 7 38 38 26 33 60 6 0 0 0 0 12 31 22 0 0 0 0 0 
0 0 0 4 0 0 0 17 27 26 39 69 96 88 91 81 53 61 95 77 9 0 0 0 0 14 36 14 0 0 0 0 
92 0 0 42 14 0 0 0 18 19 66 154 159 150 156 137 113 105 91 103 81 20 0 0 0 0 0 0 0 0 0 0 
136 42 18 20 41 8 0 0 0 12 65 111 79 78 104 107 93 63 42 58 81 56 6 0 0 0 0 0 0 1 0 0 
108 55 44 10 35 40 0 0 0 7 26 28 22 14 29 10 0 0 4 13 38 62 28 0 0 0 0 0 0 4 0 0 
77 16 22 18 19 32 18 0 0 0 0 2 8 5 3 0 0 0 3 5 16 36 18 0 0 7 10 16 7 4 0 0 
64 0 9 9 9 27 39 5 0 0 0 0 0 4 0 0 0 0 0 0 4 17 32 20 10 10 14 13 5 3 0 0 
64 0 0 0 0 5 24 39 0 0 0 0 9 3 31 68 6 0 0 0 0 20 76 88 55 15 2 0 1 1 0 0 
57 1 6 5 0 0 12 44 40 0 0 0 9 5 92 120 74 0 0 0 0 3 57 98 78 28 0 0 12 17 0 0 
63 10 11 13 3 7 9 33 76 53 0 0 0 0 1 26 56 32 0 0 5 0 19 72 67 34 26 45 66 79 74 0 
68 6 1 10 13 3 0 11 68 95 20 0 0 0 0 0 9 14 7 18 10 3 9 44 48 25 30 64 68 62 85 5 
64 5 2 0 0 0 1 0 21 81 75 0 0 8 0 0 0 4 12 0 5 9 8 36 44 12 0 0 0 0 0 0 
64 12 6 0 0 0 0 0 0 5 73 26 0 1 0 0 23 41 16 3 20 14 10 35 45 13 0 0 0 0 0 0 
54 7 10 34 26 0 0 0 0 0 64 83 28 14 20 30 42 19 9 23 26 25 25 52 66 33 0 0 0 0 0 0 
63 11 13 45 58 14 11 46 0 0 26 66 54 27 17 15 14 5 13 20 10 17 38 73 93 51 25 27 6 0 0 0 
73 23 15 17 59 57 32 74 54 0 0 0 13 13 5 0 11 39 40 42 33 11 25 60 105 94 86 70 16 0 0 0 
50 18 15 0 45 65 25 45 108 10 0 0 0 2 10 12 13 23 30 48 59 37 19 44 108 134 114 84 27 0 0 0 
43 10 17 0 23 54 7 6 92 88 0 0 0 0 8 5 0 0 0 10 25 28 16 40 82 94 75 79 33 0 0 0 
62 11 16 11 11 43 11 0 0 61 0 0 0 3 0 0 0 0 0 3 0 0 4 27 44 32 38 65 30 0 0 0 
50 0 0 0 0 6 15 0 0 25 30 0 0 0 0 0 0 0 1 22 27 11 1 11 30 15 21 44 20 0 0 0 
34 0 0 0 0 0 17 8 17 24 30 0 0 0 0 1 0 0 0 16 46 35 9 0 19 18 26 44 14 0 0 0 
43 0 0 0 0 0 12 13 2 6 0 0 0 0 0 10 0 0 0 0 19 29 9 0 3 14 43 61 16 0 0 0 
54 0 0 7 16 0 7 0 0 2 0 0 0 0 2 22 8 3 0 0 0 12 10 7 0 4 52 73 21 0 0 0 
156 113 105 96 82 75 88 103 101 121 178 185 143 106 96 90 76 76 73 52 58 74 69 82 102 112 164 237 248 232 214 107 
