81 29 28 33 26 27 33 45 27 19 24 43 10 13 38 28 11 58 31 0 64 52 20 18 26 45 9 35 19 33 31 50 
93 23 20 31 28 23 33 46 37 26 32 56 22 15 37 30 10 57 42 10 45 19 26 10 19 58 37 26 11 35 32 54 
81 20 24 44 29 18 29 50 43 27 38 56 25 14 38 32 13 44 35 30 22 11 25 12 1 65 76 0 10 35 32 54 
52 18 21 63 26 22 23 46 50 29 36 53 25 17 39 32 14 31 36 30 5 9 21 15 0 62 105 0 3 33 32 55 
45 17 7 53 17 30 30 31 52 39 31 48 27 14 35 30 14 20 42 25 0 8 15 9 0 51 99 22 3 25 32 56 
57 13 16 44 8 13 19 11 31 46 42 47 21 8 33 32 11 2 38 16 0 0 18 6 0 51 75 35 16 17 27 62 
75 2 15 45 20 0 18 8 7 22 41 50 22 22 30 30 9 0 36 11 0 0 16 6 0 54 74 35 21 15 15 103 
111 0 0 56 52 0 14 17 14 7 0 49 53 8 15 37 20 8 55 34 0 0 5 5 0 48 78 46 11 7 26 168 
182 0 0 71 70 0 0 13 19 4 0 52 66 0 16 51 30 27 29 47 9 0 2 1 0 40 58 47 0 31 59 158 
233 0 0 39 62 3 0 0 15 0 0 64 34 0 19 38 42 38 0 35 46 16 14 0 8 43 19 30 0 67 63 139 
202 29 0 0 46 64 0 0 3 2 0 42 12 5 26 41 56 31 3 19 44 49 31 0 24 49 0 0 5 45 61 150 
152 38 41 0 19 56 48 0 0 28 8 14 38 15 13 42 53 27 26 21 14 53 50 0 38 50 7 0 3 13 61 140 
137 19 39 31 0 15 63 25 0 40 16 25 40 29 4 48 49 4 24 22 1 20 47 0 42 44 19 10 3 16 66 136 
132 20 28 36 8 7 37 55 7 30 16 27 38 36 1 78 60 0 27 26 8 3 30 31 41 32 27 26 28 23 67 138 
127 25 25 37 16 6 15 49 40 30 6 23 37 5 28 73 61 0 16 30 12 4 15 49 51 24 30 24 34 22 66 135 
121 33 25 38 17 13 10 11 59 53 0 2 29 3 58 33 58 28 0 30 13 7 0 52 65 37 30 21 29 18 65 132 
121 34 23 36 25 21 19 0 44 59 43 0 19 45 12 6 63 88 14 25 7 21 0 44 55 52 40 21 26 20 65 144 
123 32 22 31 37 24 29 0 18 28 104 0 0 70 2 0 23 69 53 14 7 46 0 22 40 63 48 30 36 40 66 174 
117 33 26 25 31 31 34 12 0 0 114 36 0 58 22 0 7 49 51 0 23 50 0 17 31 77 46 16 48 64 44 182 
111 32 20 25 34 22 31 40 0 0 85 95 0 33 35 10 22 44 19 0 32 36 0 16 24 86 45 0 48 70 0 139 
107 31 13 38 48 0 26 66 24 0 41 98 34 24 37 33 35 37 27 27 33 33 10 11 23 87 46 7 42 62 0 112 
111 24 19 30 46 24 18 60 70 0 9 66 65 33 39 42 36 54 42 36 45 35 23 4 20 88 32 18 51 66 13 115 
112 22 33 16 20 62 30 14 106 19 4 38 62 54 50 45 31 64 27 33 59 29 27 0 17 106 17 17 58 65 14 151 
100 27 46 25 0 63 56 0 87 89 0 36 36 45 52 42 30 42 25 37 62 42 23 0 9 114 0 23 79 61 0 188 
106 19 46 44 0 52 73 0 16 134 16 20 43 34 46 36 37 27 24 37 50 57 41 0 7 91 0 47 95 54 8 175 
122 10 39 54 0 33 79 0 0 94 75 24 49 38 35 27 42 26 21 38 38 46 57 3 17 55 0 55 90 42 35 150 
120 16 42 41 0 22 73 5 0 9 105 43 30 37 29 32 35 14 16 43 41 41 52 0 28 37 0 53 82 32 51 149 
114 24 43 25 0 13 40 23 23 0 83 35 41 24 26 44 28 11 14 32 34 48 50 0 26 27 0 63 64 27 51 163 
123 20 29 31 18 0 9 34 22 0 63 34 65 0 17 48 24 13 26 15 6 57 47 0 21 12 0 69 51 27 51 162 
131 20 19 31 34 0 10 35 21 0 45 45 59 0 13 46 24 13 38 13 0 47 37 8 20 0 0 65 52 28 57 156 
134 24 21 27 21 12 12 36 26 0 38 64 28 8 14 35 27 19 44 10 0 41 21 9 29 0 0 51 63 27 61 151 
90 35 34 37 16 18 10 34 33 0 31 55 19 23 17 23 25 19 33 9 5 28 12 13 43 21 0 35 60 38 63 126 
