0 0 3 3 3 0 0 0 0 0 0 1 15 8 0 0 0 0 10 0 0 0 0 0 0 0 8 1 9 2 2 6 
0 11 10 7 3 0 0 0 10 14 8 14 27 14 1 4 0 0 13 0 0 0 0 0 0 0 2 16 14 3 4 12 
0 25 11 0 0 0 0 0 13 17 8 14 27 14 2 6 1 0 0 0 0 0 0 0 0 0 0 33 17 2 4 12 
0 20 1 0 0 0 0 0 6 12 8 14 26 13 2 7 1 0 0 0 0 0 0 0 0 0 0 41 20 2 4 13 
0 11 0 0 0 0 0 0 0 0 6 15 24 15 1 0 0 0 0 0 0 0 0 0 0 0 2 40 19 5 4 12 
0 8 0 0 0 0 0 0 0 0 0 13 24 2 0 0 0 0 0 0 4 0 0 0 0 0 0 34 20 9 6 11 
0 6 0 0 0 0 0 0 0 0 0 0 0 0 0 0 0 0 0 22 23 0 0 0 0 0 0 21 23 15 3 0 
0 18 0 0 0 9 0 0 0 0 0 0 0 0 0 0 18 18 21 46 38 1 0 0 0 0 0 16 24 3 0 0 
0 39 0 0 0 22 0 0 0 0 0 0 0 7 1 11 27 22 43 48 31 11 0 0 0 0 0 11 19 0 0 36 
0 42 0 0 10 16 3 0 0 0 0 0 12 31 5 11 22 37 50 36 21 13 3 0 0 0 0 12 0 0 0 79 
0 48 6 9 13 12 7 0 0 0 0 0 40 34 14 12 28 57 46 19 15 4 0 0 0 0 0 0 0 0 21 96 
0 49 42 24 6 12 10 8 0 0 7 31 37 24 11 10 33 49 30 10 4 0 0 0 0 0 0 0 0 0 33 99 
0 44 41 29 14 3 4 7 4 5 33 31 25 20 16 0 19 43 19 13 0 0 0 0 0 0 0 1 9 21 37 99 
0 38 30 28 25 5 0 0 7 19 34 23 17 21 8 0 23 51 20 17 5 0 0 0 0 0 14 22 22 23 36 101 
0 31 27 28 28 10 0 0 4 17 33 18 14 19 0 0 39 55 27 14 3 0 0 0 0 12 23 22 17 22 36 103 
0 26 26 25 29 13 0 0 0 14 31 29 12 0 0 21 47 37 27 8 0 0 0 0 0 17 20 19 17 23 38 102 
0 23 26 25 23 16 8 3 0 19 24 43 4 0 15 35 28 23 20 7 5 0 0 0 0 7 15 18 22 28 40 96 
0 24 25 21 19 20 19 12 4 18 18 36 5 0 33 21 0 3 12 22 6 0 0 0 0 0 16 32 33 34 48 86 
0 22 21 17 18 18 24 22 21 11 6 26 15 13 34 17 0 0 16 28 0 0 0 0 0 0 30 51 35 31 47 72 
0 18 21 11 9 27 28 29 32 4 0 14 30 25 31 13 0 0 28 13 0 0 0 0 0 0 39 44 17 28 51 56 
0 18 18 4 12 34 29 23 25 0 0 2 29 28 23 10 5 21 23 3 0 0 0 0 0 0 39 30 11 41 60 56 
0 18 10 11 29 28 20 20 13 13 0 5 23 24 16 13 17 9 11 1 0 3 0 0 0 0 33 26 22 54 65 58 
0 17 12 22 30 15 15 24 11 21 10 0 15 16 10 11 7 0 6 0 0 1 0 0 0 0 34 24 19 51 66 53 
0 18 19 29 27 2 17 26 6 7 24 0 1 4 3 6 1 7 9 0 0 0 1 0 0 0 47 9 3 46 56 60 
0 19 21 32 31 0 11 20 2 0 24 14 0 0 2 10 9 13 6 0 0 5 1 0 0 0 39 0 0 46 44 72 
0 23 22 37 32 0 0 24 0 0 11 12 7 6 7 9 10 17 5 0 0 0 0 2 0 3 6 0 0 42 39 79 
0 27 22 47 27 0 0 21 0 0 0 15 13 9 7 2 12 21 10 0 0 0 0 10 0 0 0 0 0 39 41 80 
0 23 25 36 11 0 0 4 0 0 0 16 3 9 3 4 24 26 8 2 4 0 8 11 0 0 0 0 0 36 40 84 
0 21 24 21 3 0 0 0 14 0 0 0 0 14 4 12 33 27 6 7 7 0 13 8 0 0 0 0 3 34 37 88 
0 23 20 17 20 17 0 0 13 0 0 0 0 24 12 20 35 21 6 15 3 0 11 4 0 0 0 0 5 31 37 93 
0 24 20 20 30 14 0 0 10 0 0 0 25 31 21 27 27 11 4 17 0 0 9 3 0 0 0 0 1 29 38 96 
0 36 35 35 28 12 3 12 26 8 0 23 49 42 31 26 20 9 12 14 0 0 11 7 13 18 0 1 35 55 68 118 
