0 20 20 20 12 0 0 0 18 20 20 47 57 22 7 9 0 0 40 0 0 11 38 27 16 35 35 23 18 8 8 37 
0 28 22 10 3 0 0 0 5 5 0 21 34 12 3 5 0 0 0 0 2 18 16 13 0 0 27 41 21 2 4 25 
0 9 0 0 4 0 0 0 10 2 0 17 31 12 1 3 0 0 0 2 29 15 9 8 0 0 42 68 18 2 4 26 
1 0 0 0 0 2 0 0 10 11 2 18 28 10 3 4 0 0 0 22 30 9 4 4 0 0 37 82 28 4 4 27 
0 0 0 0 0 0 0 0 0 13 15 20 28 10 0 0 0 0 0 33 29 11 11 0 0 0 17 61 38 9 3 27 
0 0 0 0 8 0 2 0 0 0 6 20 13 0 0 0 0 0 17 72 60 20 13 0 0 0 12 35 37 22 3 29 
0 4 0 0 22 13 4 13 6 0 0 0 0 0 0 0 31 36 67 118 93 35 15 0 0 0 6 38 35 16 0 40 
0 33 0 0 42 46 3 0 6 0 0 0 0 0 0 14 28 16 37 90 84 46 25 5 0 0 0 34 25 0 0 99 
0 71 0 0 67 85 19 0 0 0 0 0 0 30 0 0 13 25 22 28 48 46 32 5 0 0 0 21 0 0 0 183 
0 79 3 0 41 82 57 13 2 0 0 0 28 10 0 0 13 60 39 0 1 28 26 1 0 2 13 0 0 0 44 185 
0 18 67 32 0 33 89 50 6 0 0 28 29 0 0 0 20 48 21 0 0 0 10 0 0 6 11 0 0 0 33 161 
0 0 25 27 0 0 48 68 18 18 50 20 0 0 0 0 10 10 0 0 0 0 0 0 0 0 0 0 5 16 37 165 
0 5 0 1 15 0 0 46 41 39 36 0 0 4 0 0 27 26 12 16 0 0 0 0 0 0 0 21 24 2 31 167 
0 5 0 7 7 0 0 18 56 51 29 2 0 0 0 0 69 64 14 12 0 0 0 0 0 0 0 0 0 0 29 167 
0 8 6 10 11 0 0 0 29 59 39 9 4 0 0 0 76 72 19 5 0 0 0 0 0 6 0 0 0 0 34 166 
0 3 5 10 10 1 0 0 0 52 73 26 0 0 0 23 29 57 36 3 0 0 0 0 0 0 0 0 0 0 35 166 
0 5 7 5 7 7 19 0 0 7 82 50 0 12 54 0 0 0 30 21 5 2 0 0 0 0 0 0 1 1 27 161 
0 13 8 0 1 12 22 14 0 0 24 67 0 23 54 0 0 0 11 27 0 0 0 0 0 0 0 15 14 7 3 123 
0 2 5 3 2 7 20 39 18 0 0 41 37 15 39 22 0 0 26 10 0 0 0 0 0 0 38 25 0 11 0 61 
0 2 2 0 7 15 18 44 41 0 0 0 47 20 12 2 0 26 35 0 0 0 0 0 0 0 36 7 0 37 40 73 
0 0 0 0 32 39 0 12 43 0 0 0 31 21 0 1 21 25 0 0 0 0 0 0 0 0 0 0 11 73 74 104 
0 0 0 0 10 17 0 0 39 57 2 0 2 19 10 13 3 0 0 0 0 0 0 0 0 0 0 0 4 47 56 124 
0 2 19 25 0 0 16 0 0 59 32 0 0 0 0 4 0 0 8 0 0 3 0 0 0 0 0 0 0 28 27 137 
0 0 15 39 0 0 25 0 0 21 44 9 2 0 0 8 13 14 0 0 0 11 12 0 0 0 0 0 0 33 15 132 
0 2 10 50 11 0 15 14 0 0 46 17 7 7 8 12 23 20 0 0 0 0 4 0 0 0 0 0 0 24 28 137 
0 20 14 52 18 0 9 48 0 0 0 19 6 16 15 6 7 14 3 0 0 0 0 4 0 0 0 0 0 11 34 148 
0 18 26 47 8 0 0 26 0 0 0 30 32 12 0 0 23 27 2 0 0 0 24 10 0 0 0 0 0 6 26 155 
0 7 23 27 0 0 0 0 15 0 0 17 19 7 0 7 35 29 9 0 0 0 30 13 0 0 0 0 0 8 17 152 
0 16 6 5 33 38 3 0 12 0 0 0 18 37 4 16 30 14 18 24 0 0 14 7 0 0 0 0 0 4 22 156 
0 18 7 4 34 32 0 0 0 0 0 0 44 56 18 18 22 5 15 30 0 0 0 0 0 0 0 0 0 0 26 159 
0 16 18 25 18 2 0 0 2 0 0 6 60 52 34 19 8 0 14 21 0 0 4 0 0 0 0 0 0 1 29 157 
0 12 16 25 16 6 6 4 9 0 0 26 45 34 32 15 3 4 17 20 8 15 15 0 0 8 0 0 0 11 24 78 
