65 36 33 29 26 34 47 51 39 40 41 31 12 21 34 28 33 53 33 38 78 48 20 20 23 20 12 29 24 28 30 19 
57 14 13 19 19 18 18 16 12 12 16 16 8 14 24 17 7 23 38 45 27 0 7 5 12 20 19 12 8 20 20 17 
36 6 19 30 24 19 19 13 4 5 14 16 8 13 23 15 6 27 52 43 2 0 4 8 18 36 19 0 10 19 20 17 
7 11 45 57 26 15 11 10 5 1 6 12 9 15 24 16 7 27 48 30 0 0 9 13 23 44 17 0 7 18 19 17 
18 19 32 38 17 24 20 14 11 0 0 9 11 13 19 15 12 29 47 32 10 7 8 15 27 32 11 0 3 16 19 18 
35 26 40 38 16 12 9 12 24 12 0 0 0 13 42 49 38 41 54 34 10 12 11 17 29 22 4 4 6 10 19 19 
45 26 37 35 21 14 18 12 9 12 8 5 25 63 75 63 38 22 22 5 0 11 16 19 28 29 8 0 6 7 13 39 
59 19 29 47 29 1 19 20 15 10 16 48 63 35 8 0 0 0 0 0 0 12 18 21 24 31 20 2 0 12 62 65 
76 6 39 72 27 0 14 23 25 14 17 60 26 0 0 0 0 0 0 0 5 14 21 27 30 34 16 3 4 64 79 9 
88 0 41 52 14 2 10 20 20 15 29 39 0 0 0 0 0 0 0 2 17 15 25 26 35 27 1 1 31 71 2 0 
74 21 4 0 35 33 0 4 14 21 14 0 0 0 0 0 0 0 0 0 21 26 25 23 31 13 0 29 49 15 0 0 
29 4 0 0 28 36 19 0 10 12 0 0 0 0 0 1 0 0 7 7 20 43 34 21 39 37 34 39 15 0 0 0 
18 0 1 15 2 21 39 15 0 0 0 3 17 14 6 17 19 12 20 17 17 36 40 29 43 34 21 0 0 0 0 0 
27 0 0 3 8 24 37 27 0 0 0 5 14 15 24 53 16 0 19 20 20 32 50 40 17 0 0 0 0 0 0 0 
37 0 0 1 2 13 30 32 10 0 0 12 15 9 40 39 2 0 15 21 26 48 55 28 0 0 0 0 0 0 0 0 
38 4 1 3 0 11 20 24 32 9 0 1 7 40 55 0 0 0 6 28 29 37 23 7 0 0 0 0 0 0 0 0 
43 7 3 2 2 12 11 7 28 14 0 0 25 19 0 0 29 39 12 21 16 23 11 2 0 0 0 0 0 0 0 0 
45 0 0 5 7 1 4 0 5 14 22 0 20 15 0 5 21 34 27 2 12 37 11 0 0 8 0 0 0 0 0 0 
40 5 6 4 0 1 4 0 0 9 42 11 0 20 11 9 16 29 12 0 26 38 14 2 1 3 0 0 0 0 0 10 
44 8 2 3 12 4 0 0 0 0 37 28 0 0 13 22 34 17 0 11 33 27 18 8 0 0 0 0 10 3 0 9 
42 6 9 24 6 0 2 16 12 12 25 19 0 0 18 28 10 0 7 24 17 18 18 9 3 11 2 5 10 0 0 1 
43 6 12 11 0 0 13 36 35 0 2 13 4 0 4 2 0 11 23 14 16 21 20 7 0 1 0 0 0 0 0 1 
45 3 0 0 0 18 0 6 28 0 0 0 14 11 10 11 22 31 7 12 18 12 13 0 3 9 0 0 0 0 0 6 
36 7 4 0 0 15 0 0 30 24 0 16 13 22 20 16 17 13 13 25 21 8 4 2 9 7 0 0 0 0 0 13 
40 5 7 0 0 16 2 0 20 44 2 13 20 18 17 8 3 3 15 19 20 20 14 4 0 0 0 7 7 0 0 0 
47 0 7 5 0 30 23 0 0 38 22 12 24 11 2 3 21 23 21 19 13 20 25 1 0 0 0 28 2 0 0 0 
41 0 4 0 5 42 29 0 0 31 65 17 0 0 3 18 23 19 23 26 21 21 16 0 11 13 10 28 2 0 0 0 
38 7 2 2 29 44 31 24 20 13 40 1 3 4 11 16 9 10 19 26 18 17 12 4 22 23 20 30 0 0 0 0 
54 9 17 30 32 17 16 10 0 12 33 27 29 0 0 3 4 17 20 5 6 23 13 9 23 26 27 24 0 0 0 0 
53 3 11 22 14 4 8 0 5 30 47 44 17 0 0 0 2 15 22 5 5 20 15 17 21 24 25 14 0 0 0 0 
52 2 1 0 6 20 13 10 16 24 51 33 0 0 0 0 2 14 20 11 17 21 10 12 20 19 14 10 0 0 0 0 
32 0 0 0 0 18 9 1 0 12 22 0 0 0 0 0 8 14 11 9 20 13 0 10 12 0 0 0 0 0 0 0 
