0 0 4 6 7 6 0 0 0 0 0 0 8 9 7 9 4 0 0 0 0 1 6 9 6 2 4 1 9 7 7 7 
9 15 16 14 13 15 14 14 12 14 15 14 12 15 18 16 9 8 6 0 32 47 36 35 30 15 0 16 19 16 15 14 
29 27 20 7 7 7 9 7 5 10 12 14 13 15 16 14 7 9 9 18 52 47 40 33 34 16 0 20 17 17 16 12 
34 18 18 13 22 16 14 10 2 5 13 15 13 12 14 14 9 12 17 41 56 43 38 32 32 26 13 13 17 17 15 12 
14 7 15 28 31 26 25 31 23 13 14 14 11 16 18 10 2 8 19 41 51 41 36 34 31 36 34 11 13 18 14 10 
0 2 9 28 32 39 39 42 45 33 18 13 14 6 0 0 0 0 3 30 47 45 37 35 36 42 36 14 11 16 15 9 
0 4 17 27 24 40 40 41 48 45 32 14 0 0 0 0 0 0 8 26 39 43 38 35 42 45 31 15 13 16 17 0 
0 10 28 18 8 37 39 38 39 41 44 8 0 0 3 2 8 13 24 24 25 32 37 35 42 45 31 16 19 8 0 0 
0 1 20 8 13 26 39 41 39 42 39 6 5 24 21 20 20 17 46 33 13 25 28 34 36 39 41 24 22 0 0 5 
0 0 0 31 34 2 30 42 44 42 24 22 55 46 42 41 26 36 54 42 20 20 23 33 32 37 50 36 0 0 5 16 
19 0 0 48 34 7 17 38 43 27 21 65 64 48 54 48 42 53 38 38 37 20 21 31 27 30 23 6 0 6 10 0 
24 0 10 18 31 38 16 23 29 16 33 47 17 18 31 31 36 28 14 20 32 28 24 30 17 8 0 0 0 14 2 0 
16 5 7 0 32 42 25 7 15 17 17 2 0 0 9 1 0 8 5 11 20 35 34 17 10 2 0 0 9 5 1 0 
9 0 0 4 15 25 34 14 10 16 2 0 0 0 0 0 0 7 3 7 14 27 27 0 6 10 6 8 2 1 0 0 
6 0 0 0 4 17 31 33 11 3 0 0 0 6 0 0 0 0 5 5 8 14 24 15 12 11 7 6 1 1 0 0 
7 0 0 0 0 7 21 40 18 0 0 10 7 0 0 37 20 0 2 1 3 15 40 33 21 7 2 0 0 0 0 0 
4 0 0 2 0 3 17 33 29 19 0 15 7 0 42 40 15 0 0 2 10 13 34 36 25 5 0 0 4 6 8 0 
9 4 4 4 0 6 13 18 36 33 0 0 6 6 15 8 16 15 0 18 13 10 26 36 21 1 4 14 22 24 34 12 
15 4 2 6 8 3 6 6 28 31 13 0 0 11 0 4 12 12 17 24 4 17 24 26 15 2 12 30 24 16 32 18 
15 4 8 3 0 5 6 0 12 22 23 0 0 13 0 0 0 17 31 6 4 23 23 23 16 6 4 0 0 0 9 9 
14 6 6 0 0 8 4 0 0 3 28 14 0 8 2 0 17 32 14 0 16 24 21 24 13 2 0 0 0 0 0 0 
9 5 0 12 19 0 0 1 0 8 32 39 15 12 12 18 29 11 5 12 16 24 23 30 20 5 0 0 0 0 0 0 
14 6 4 19 23 0 0 26 8 3 29 33 25 15 15 20 17 12 22 20 14 21 28 35 27 7 11 8 0 0 0 0 
18 7 8 9 23 16 11 31 34 0 16 18 22 19 18 19 18 34 29 25 28 21 28 29 27 23 38 17 0 0 0 0 
8 8 9 5 24 26 16 16 47 11 3 22 15 20 23 25 22 28 23 25 32 26 22 24 32 53 45 10 0 2 0 7 
6 8 10 11 22 29 16 15 36 39 0 2 12 21 27 20 9 11 14 17 23 23 17 28 34 49 24 13 10 4 0 7 
17 7 7 20 14 25 26 15 0 29 0 5 27 27 21 2 3 8 14 16 15 15 19 29 28 30 17 15 12 4 0 0 
14 0 6 3 0 14 33 1 0 17 26 33 20 22 9 0 7 10 11 20 25 17 22 23 24 24 11 12 14 2 0 0 
5 0 4 0 0 21 30 9 14 11 35 23 7 17 7 2 6 7 8 22 28 19 23 15 21 22 9 15 12 0 0 0 
7 1 1 0 6 22 23 15 3 7 24 6 18 13 7 5 4 6 9 19 19 20 20 10 15 16 13 23 8 0 0 0 
11 1 1 5 19 13 19 7 0 12 15 8 30 8 9 13 7 7 12 17 12 18 20 14 8 6 17 26 5 2 0 0 
50 32 31 35 37 39 39 33 28 29 61 84 72 50 44 39 32 35 46 37 36 47 36 23 24 28 39 64 69 63 65 66 
