5 0 0 0 0 0 0 0 0 0 0 0 0 0 0 0 0 0 0 0 0 0 0 0 0 0 0 1 0 0 0 10 
5 0 0 0 3 3 6 4 2 0 0 0 0 0 1 3 7 3 0 0 0 2 13 10 4 5 10 1 4 7 6 11 
7 0 0 2 4 6 5 6 5 0 1 1 0 1 2 3 7 0 0 0 2 16 21 18 0 0 13 0 4 7 6 11 
22 17 0 0 0 0 0 0 4 4 2 1 0 1 0 0 4 0 0 0 10 28 27 21 2 0 2 0 0 5 5 11 
20 18 10 10 7 8 5 0 0 7 6 1 0 0 1 6 13 6 4 2 10 28 29 18 8 1 0 0 2 3 5 12 
18 6 3 2 9 16 22 16 2 1 7 4 1 2 0 0 3 0 0 0 3 21 28 17 6 6 0 0 1 2 2 12 
19 3 0 0 11 9 17 22 18 9 5 6 0 0 0 0 0 0 0 0 0 15 24 18 4 0 0 0 0 1 0 30 
26 0 0 0 16 5 16 20 21 17 0 0 0 0 0 0 0 0 0 0 0 12 16 16 7 0 0 0 0 0 0 19 
35 0 0 0 0 3 13 19 21 16 0 0 0 0 0 2 2 9 0 0 5 4 8 5 4 0 0 0 0 0 0 0 
9 0 0 0 0 9 7 16 23 16 7 6 0 0 1 0 6 14 7 2 6 1 1 0 0 0 0 0 0 0 0 0 
0 0 0 0 0 0 2 10 19 24 28 21 26 29 20 17 22 18 30 21 5 6 2 0 0 2 0 0 0 0 0 0 
21 0 3 5 0 0 0 4 10 30 42 36 46 44 36 39 37 31 34 31 11 1 1 0 0 0 0 0 0 0 0 0 
33 20 8 12 0 0 0 3 8 25 22 20 15 16 11 25 24 10 15 14 12 0 0 0 0 0 0 0 0 0 0 5 
28 17 14 13 3 0 0 0 9 15 19 20 16 13 1 7 11 2 13 10 8 0 0 0 0 0 0 0 0 0 0 6 
22 13 11 11 8 2 0 0 3 9 7 8 9 0 15 4 6 12 9 12 5 0 0 0 0 0 0 0 0 0 0 7 
20 12 9 10 8 7 4 0 0 2 5 1 7 0 0 0 0 17 4 7 3 0 0 0 0 0 0 0 0 0 0 9 
21 7 3 3 7 4 6 0 0 0 18 0 1 33 29 29 10 6 0 0 0 8 2 8 0 0 0 0 0 0 0 10 
18 8 9 5 8 7 10 12 4 0 11 7 0 20 20 27 15 0 4 0 0 0 0 4 0 0 0 0 0 0 0 0 
19 8 7 5 6 11 10 20 15 0 0 9 0 0 5 8 11 9 7 0 8 0 0 0 0 1 0 0 4 13 0 0 
15 6 2 8 11 4 6 18 17 13 0 6 2 0 1 0 0 1 0 5 6 0 0 0 0 0 0 0 0 0 0 0 
17 7 0 0 7 4 3 7 10 8 0 1 8 0 0 0 0 0 0 4 0 0 0 0 0 0 0 0 0 0 0 0 
21 6 7 0 0 11 0 0 0 0 0 0 0 0 0 3 3 9 3 1 1 0 0 0 0 0 0 0 0 0 0 0 
14 5 16 14 0 11 8 0 0 0 0 6 1 0 0 0 0 0 0 0 0 0 0 0 0 7 0 0 0 0 0 0 
18 10 12 16 2 11 21 0 0 0 0 0 0 0 0 0 0 0 0 0 0 0 0 1 3 13 0 4 5 0 0 0 
24 9 10 19 7 17 28 24 0 0 0 0 0 0 0 0 0 0 0 0 0 0 0 1 16 23 13 24 10 0 0 0 
21 7 8 13 5 9 21 32 13 0 0 0 0 0 0 0 0 0 0 0 0 0 0 2 27 25 18 22 8 0 0 0 
16 11 16 9 12 7 13 23 39 0 0 0 0 0 0 0 0 0 0 0 0 0 0 0 16 14 11 17 4 0 0 0 
21 13 16 14 20 8 0 8 12 0 0 0 0 0 0 1 0 0 1 0 0 0 0 0 9 5 2 10 0 0 0 0 
15 2 0 0 3 0 2 19 9 5 0 0 0 0 0 7 3 1 10 8 0 0 0 5 8 0 0 2 0 0 0 0 
17 4 0 0 1 3 16 25 16 0 0 0 0 0 2 8 6 5 12 12 12 12 3 7 8 0 0 0 0 0 0 0 
15 4 8 12 3 11 14 14 6 0 0 0 0 0 5 8 11 13 17 12 14 15 7 5 8 2 0 0 0 0 0 0 
0 0 2 6 5 8 8 6 2 0 0 0 0 0 6 9 10 9 8 10 10 8 12 9 1 2 3 0 0 0 0 0 
