63 59 57 53 49 56 76 96 100 100 101 89 61 49 50 50 63 90 81 70 102 115 100 88 83 72 52 48 45 45 45 37 
48 36 24 18 15 15 15 16 17 18 20 23 19 17 19 16 9 22 40 40 28 15 18 16 21 33 30 24 15 16 16 18 
22 22 29 31 24 17 16 15 10 9 14 20 18 15 17 14 7 20 44 39 13 3 9 10 19 44 39 16 13 15 16 18 
0 0 20 54 58 50 35 28 19 12 13 19 18 17 20 18 13 26 38 26 4 0 8 13 16 42 48 22 14 15 17 20 
5 4 2 6 5 18 26 32 37 24 12 18 20 19 18 12 5 16 29 20 11 12 14 17 15 18 31 27 16 14 16 19 
29 29 30 26 13 6 0 0 12 26 22 20 20 21 38 51 47 44 50 39 20 17 16 18 18 9 11 25 25 17 18 22 
38 32 34 33 20 15 18 8 0 0 13 28 48 85 124 148 145 123 99 64 27 14 13 12 13 18 20 20 23 21 22 22 
46 30 29 41 30 8 13 18 13 1 16 65 102 108 94 76 62 55 61 55 35 22 16 10 3 9 23 26 23 31 62 73 
63 32 37 67 58 15 8 15 23 20 25 61 66 27 9 7 1 0 5 33 41 36 28 24 16 13 19 26 44 89 114 94 
101 70 51 65 66 37 12 11 16 20 26 35 24 14 6 2 3 0 0 4 37 39 38 35 32 20 9 23 53 96 70 42 
71 99 60 20 52 75 39 12 11 15 0 0 0 0 0 0 0 0 0 0 4 28 31 31 33 21 1 25 48 42 30 41 
0 22 30 3 14 52 59 29 20 13 0 0 0 0 0 0 0 0 0 0 0 13 32 35 53 75 91 95 75 41 32 40 
0 0 0 18 5 12 46 43 22 8 0 0 14 16 8 2 1 9 18 10 0 4 28 35 57 82 97 80 44 28 31 41 
8 4 7 11 11 18 43 56 30 11 5 7 10 16 29 58 48 21 22 21 13 11 32 43 38 31 22 18 21 22 32 45 
24 20 16 16 13 10 21 47 46 30 24 27 27 33 43 52 43 18 18 20 21 31 50 56 39 21 14 14 21 22 28 42 
23 23 20 20 18 16 10 24 55 54 30 22 22 38 68 61 62 44 24 27 28 23 11 9 16 18 16 19 24 23 28 40 
25 25 26 28 27 28 20 9 34 57 38 10 27 11 0 0 0 52 47 40 32 15 0 0 0 20 29 28 27 24 32 44 
28 19 12 16 23 20 15 0 0 31 60 27 25 20 0 0 0 25 41 34 32 38 11 0 0 14 19 14 5 0 12 41 
18 17 19 17 17 16 18 0 0 0 59 62 31 40 41 26 11 11 13 7 19 33 18 3 8 12 0 0 0 0 0 3 
25 25 24 19 18 22 24 13 0 0 17 51 29 25 36 40 39 29 16 17 27 30 23 15 15 22 3 0 3 2 0 6 
21 21 28 45 39 16 21 31 14 0 0 25 18 11 27 39 28 12 17 29 26 24 19 12 15 39 63 78 82 67 28 29 
22 19 21 26 32 24 30 64 71 26 0 10 24 16 10 0 0 0 5 9 9 17 20 16 16 26 34 42 46 49 37 35 
31 25 11 0 0 25 16 24 47 14 0 0 0 0 0 0 10 25 15 10 8 2 0 0 0 18 17 18 24 38 48 53 
14 15 15 0 0 9 0 0 30 41 15 8 1 8 15 16 10 7 8 17 25 15 0 0 0 4 0 9 26 29 33 59 
16 11 15 6 0 0 0 0 1 53 36 28 23 16 16 15 5 0 0 0 0 10 11 0 0 0 0 0 23 30 22 41 
31 16 17 18 0 10 20 0 0 15 32 17 20 15 7 6 16 21 16 5 0 0 5 0 0 0 0 9 24 31 25 33 
25 14 9 13 6 16 29 14 0 0 50 44 22 15 18 29 37 33 31 30 23 18 12 0 0 5 4 14 22 28 33 40 
15 13 12 11 15 18 32 50 52 30 36 21 8 8 24 36 35 26 17 19 26 25 20 8 15 27 24 28 22 19 28 45 
39 35 47 68 64 38 27 28 25 14 19 29 38 24 22 24 24 29 24 3 0 13 21 16 17 29 31 33 27 25 27 42 
36 28 32 45 45 27 16 7 10 21 41 53 53 28 18 19 21 28 31 18 4 8 19 25 25 26 25 26 24 26 28 40 
35 29 22 12 15 24 24 30 38 40 57 56 40 27 13 11 16 22 27 26 23 21 22 30 35 28 13 16 23 23 24 37 
21 26 25 19 18 27 24 25 28 28 42 43 31 27 12 8 17 24 30 29 28 25 15 17 30 26 6 4 17 20 23 46 
