51 10 18 25 24 33 48 58 46 43 46 37 10 16 30 26 34 60 28 12 64 64 45 40 41 29 0 13 16 28 27 21 
82 12 5 5 3 12 26 30 16 15 20 17 0 0 19 13 14 47 22 3 42 26 14 9 19 19 0 0 0 17 14 14 
95 38 31 12 0 0 6 17 5 4 16 16 0 0 16 9 9 39 32 25 29 13 18 8 22 43 0 0 0 15 13 13 
48 8 39 69 45 35 27 24 3 0 9 14 0 0 18 17 20 47 44 29 5 0 12 9 20 69 33 0 0 14 14 13 
26 0 13 40 14 32 44 54 46 10 0 5 0 0 14 0 0 12 23 0 0 1 11 12 21 67 48 0 0 3 12 12 
32 4 22 36 4 17 18 18 42 44 24 8 0 0 0 0 0 0 0 0 0 1 16 16 31 58 27 0 0 0 11 14 
45 0 30 36 0 5 25 13 14 26 32 9 0 0 7 24 19 18 18 0 0 0 9 14 37 69 30 0 0 0 0 0 
59 0 20 33 0 0 20 23 15 10 26 46 28 39 71 64 39 37 47 0 0 0 0 2 20 58 38 0 0 0 0 0 
85 0 0 51 0 0 0 21 25 17 24 78 62 19 36 41 15 11 35 22 0 0 0 0 11 43 37 5 0 11 26 30 
172 0 0 64 32 0 0 0 23 20 37 114 102 69 80 70 43 27 17 47 32 4 0 2 20 36 23 18 3 72 56 0 
222 21 0 30 53 3 0 0 2 12 40 99 53 37 74 81 64 32 1 32 58 41 12 0 19 0 0 0 0 48 26 0 
171 40 36 0 30 49 0 0 0 12 4 5 0 0 0 17 6 0 0 0 24 55 36 7 38 17 0 0 22 41 17 0 
135 7 22 9 15 27 20 0 0 4 0 2 19 14 11 11 0 0 1 5 8 44 49 14 53 53 38 38 33 22 15 0 
120 0 11 14 6 24 47 13 0 0 0 0 7 9 11 42 0 0 9 11 8 27 43 24 38 31 22 21 17 14 17 0 
121 7 11 14 2 14 37 43 0 0 0 0 18 16 14 27 0 0 0 7 6 31 74 88 63 25 16 14 17 13 15 0 
117 11 6 8 0 3 15 36 37 0 0 0 21 25 98 121 72 0 0 0 1 28 66 100 74 29 10 6 16 10 12 0 
115 16 16 24 9 12 17 20 61 35 0 0 17 19 20 15 47 34 0 0 2 12 16 70 66 44 26 17 26 25 29 0 
124 18 7 15 15 13 11 1 47 59 23 0 0 23 0 0 25 54 19 14 20 33 9 50 52 50 38 40 55 59 73 32 
116 11 5 12 16 8 3 0 12 50 93 0 0 31 0 0 6 24 9 0 16 34 6 36 47 50 9 0 5 0 0 22 
116 18 9 1 0 0 11 0 0 10 93 37 0 20 2 0 13 29 7 0 22 32 12 38 52 52 0 0 0 0 0 0 
112 19 15 28 15 0 3 0 0 0 59 62 0 0 12 25 43 40 14 16 39 31 13 32 52 70 16 0 21 0 0 0 
106 11 15 45 48 2 9 41 8 0 39 83 49 20 20 19 11 1 0 19 31 29 32 48 73 79 19 16 33 4 0 0 
120 24 16 11 27 35 20 46 54 0 0 8 16 10 8 3 7 28 16 21 20 4 19 35 76 94 23 30 34 4 0 0 
107 21 22 0 12 62 29 18 86 5 0 0 1 8 13 7 7 31 27 46 57 22 8 14 72 117 42 65 56 4 0 12 
94 9 20 0 0 51 20 0 76 91 0 1 10 7 16 13 6 0 0 17 37 35 19 13 58 96 15 72 67 6 0 11 
108 6 22 6 0 51 34 0 15 100 13 0 0 1 2 0 0 0 0 6 3 9 12 4 29 38 0 91 78 7 0 0 
116 6 14 3 0 43 41 0 0 33 57 6 9 7 2 0 1 0 13 29 16 11 9 0 25 22 0 91 67 9 1 0 
95 0 0 0 0 7 33 4 13 30 81 8 0 0 0 15 7 0 2 28 40 36 13 0 28 28 14 92 52 0 3 0 
108 2 13 3 0 9 27 24 25 15 56 0 0 0 1 19 0 0 4 3 16 41 18 0 20 27 33 99 45 4 4 0 
118 0 8 23 25 4 10 10 0 2 46 10 3 0 0 20 3 6 17 0 0 30 12 0 15 18 45 101 43 9 9 0 
128 4 1 5 8 1 13 22 11 17 60 33 0 0 0 18 9 9 19 0 3 30 14 16 26 11 38 92 49 10 11 0 
171 119 112 98 75 75 87 109 111 120 199 213 147 106 83 73 69 76 85 57 61 81 61 74 114 117 139 213 241 226 220 154 
