0 0 0 0 3 8 11 6 5 5 4 0 0 4 4 6 19 6 0 0 0 0 0 0 0 0 0 0 0 4 5 0 
2 8 9 6 4 6 5 7 15 19 18 12 17 16 13 15 16 8 8 0 0 0 2 5 7 0 0 0 9 10 11 7 
14 38 27 0 0 0 0 0 2 12 14 12 17 16 12 13 13 7 6 0 0 0 1 4 11 1 0 0 11 10 12 7 
5 32 36 19 9 0 0 0 0 0 5 10 16 15 12 16 16 10 0 0 0 0 0 0 9 4 0 1 9 9 12 7 
2 8 3 0 4 6 5 9 4 0 0 6 15 16 8 1 0 0 0 0 0 0 0 0 2 0 6 15 6 7 10 5 
0 0 0 0 0 0 0 2 17 18 6 1 4 0 0 0 0 0 0 0 0 0 0 0 2 0 5 19 9 7 11 4 
0 0 0 0 0 0 0 0 0 13 14 0 0 0 0 0 0 0 0 0 0 0 0 0 7 5 4 9 9 8 3 0 
0 0 4 0 0 0 0 0 0 0 13 9 0 0 0 0 6 17 11 7 1 0 0 0 0 3 8 8 5 0 0 0 
0 0 4 0 0 0 0 0 0 0 14 2 0 0 9 12 18 20 37 42 18 0 0 0 0 0 10 17 24 0 0 0 
0 0 0 0 0 0 0 0 0 6 20 8 38 65 50 43 41 31 52 64 39 12 0 0 0 0 20 32 35 0 0 0 
10 39 0 8 38 4 0 0 0 5 13 24 66 81 74 70 58 58 58 52 50 28 3 3 0 0 0 0 0 0 3 5 
0 54 32 24 30 33 3 0 0 0 0 23 39 28 29 30 30 40 31 18 30 30 12 11 0 0 0 0 0 0 9 3 
0 26 38 30 20 32 18 0 0 0 10 26 24 16 11 0 0 15 15 9 12 18 15 12 0 9 13 0 0 10 10 1 
0 16 16 17 26 29 25 2 0 0 4 5 5 5 11 0 0 6 10 11 10 7 7 0 0 3 15 19 17 14 10 1 
0 12 9 12 17 17 23 19 0 0 0 3 3 8 0 0 0 0 0 6 8 9 14 7 0 13 22 24 17 13 7 2 
0 9 7 6 10 7 7 25 19 0 0 4 7 21 14 33 39 5 0 0 0 0 15 23 27 27 22 19 13 12 5 0 
0 9 14 14 12 8 6 25 31 21 0 2 15 0 0 38 58 27 2 0 0 0 3 16 32 34 23 17 17 22 18 3 
0 9 12 15 12 10 10 19 29 49 8 0 0 0 0 8 15 22 16 11 17 0 1 8 23 23 27 38 47 58 66 37 
0 12 12 12 11 11 9 8 20 50 36 6 0 0 8 0 0 0 6 23 15 0 7 8 15 7 17 40 43 38 62 50 
0 13 11 3 0 8 14 4 6 24 29 17 4 8 15 6 0 0 14 23 2 2 14 12 14 2 4 14 9 4 31 25 
0 13 19 12 0 5 14 0 0 0 8 16 11 10 20 20 14 21 33 19 4 10 14 12 14 11 28 27 7 5 26 7 
0 9 15 19 22 17 17 22 3 0 12 40 42 28 21 16 17 18 16 11 11 20 23 25 22 8 24 25 14 20 26 0 
0 15 5 11 35 26 14 37 24 8 2 18 34 31 19 18 28 19 18 17 6 12 18 28 29 9 25 27 18 26 37 0 
0 18 11 12 29 24 13 42 50 21 11 10 15 22 20 21 23 29 44 41 32 22 15 22 26 15 48 44 19 18 40 0 
0 10 12 7 20 12 2 21 57 44 28 21 19 18 23 28 21 23 29 28 38 40 26 18 14 13 55 34 9 20 28 0 
0 10 15 13 25 10 0 0 27 45 27 7 10 16 19 22 17 18 16 11 16 25 19 14 1 7 40 9 1 24 19 0 
0 16 11 19 27 6 0 0 0 10 20 8 13 22 24 15 7 14 20 18 19 15 6 14 5 3 13 0 0 27 25 0 
0 7 0 0 0 0 0 13 0 4 4 17 12 15 19 8 7 11 13 22 34 24 11 16 6 4 8 0 0 21 26 3 
0 6 11 8 0 0 2 8 8 11 1 17 0 4 8 3 10 14 1 3 26 24 17 14 2 9 10 0 3 21 21 2 
0 6 12 14 1 0 0 0 3 8 2 2 0 5 4 6 12 10 0 0 6 3 12 12 0 8 11 0 12 22 20 4 
0 9 5 3 9 8 2 3 4 11 4 0 3 12 4 8 11 2 0 0 0 0 8 16 6 5 10 10 15 21 20 8 
37 80 74 63 60 54 54 58 65 82 98 113 121 98 70 59 54 48 43 45 40 36 45 52 57 65 79 107 139 154 149 118 
