0 0 0 0 0 0 0 0
1086 0 0 0 0 0 641 0
0 0 970 0 0 0 0 0
0 34 1361 1116 111 0 0 0
0 0 0 0 0 0 0 0
0 0 0 0 0 0 0 0
248 0 0 0 0 0 0 0
284 0 233 43 0 0 112 282
