0 0 0 0 0 0 0 0
0 0 0 0 0 0 0 0
0 0 48 0 208 636 0 0
0 0 463 0 0 486 1151 0
0 0 537 0 0 0 0 0
0 0 0 0 0 0 0 0
0 0 0 0 0 0 0 0
0 0 0 0 0 0 0 0
