0 0 0 0 0 0 0 0
0 0 0 0 0 0 0 0
0 0 1798 0 0 0 0 0
15 400 878 0 0 344 0 0
0 0 507 0 0 0 0 0
0 0 81 0 0 0 0 0
0 0 0 0 0 0 0 0
0 0 0 0 0 0 0 0
