0 0 0 0 0 0 0 0
0 0 0 0 0 0 0 0
0 0 0 0 290 0 0 357
0 0 0 0 359 0 0 0
0 0 0 0 0 0 0 0
639 958 0 0 0 0 0 0
0 752 0 0 0 0 0 0
0 182 0 0 0 0 0 0
