777 0 331 224 150 0 159 0
1439 0 222 728 249 298 0 0
728 0 0 0 0 0 153 0
0 0 0 0 0 0 0 0
0 0 0 0 0 0 0 0
0 0 0 0 0 0 0 0
188 0 0 0 0 0 0 104
0 0 0 0 0 0 195 1411
