0 0 0 0 0 0 0 0
0 0 0 0 0 0 0 0
0 0 554 313 0 0 0 0
0 0 720 725 0 0 0 0
0 36 526 266 0 0 0 0
0 0 0 0 0 0 469 866
0 0 0 0 0 0 0 471
0 0 0 0 0 0 0 0
