0 0 0 0 0 0 0 0
0 0 0 202 323 0 0 0
0 0 1658 1828 3416 49 879 75
0 1393 3253 0 1022 0 765 1397
0 10 2159 0 0 0 0 0
0 0 0 0 0 0 0 0
0 91 0 0 0 0 0 0
0 0 0 0 0 0 0 0
