0 0 0 0 0 0 0 415
0 0 0 0 227 0 0 0
0 0 0 0 327 0 0 0
0 0 0 0 0 0 0 0
0 0 0 0 0 0 0 0
0 0 0 0 0 164 0 0
0 0 0 0 965 356 0 0
242 40 0 0 482 0 0 0
