0 0 0 0 0 0 0 0
0 0 0 0 0 0 0 0
0 0 0 0 0 0 0 0
0 0 0 0 0 0 0 0
0 0 0 0 0 0 281 0
573 0 0 0 0 222 1087 0
0 0 0 0 0 768 0 0
0 922 190 0 0 481 0 0
