0 0 0 0 252 520 0 0
1116 0 0 0 0 1222 1433 0
0 0 0 0 0 0 718 0
0 0 45 0 0 0 330 0
170 0 0 0 0 0 0 0
0 0 0 0 0 0 0 0
6 0 0 0 0 0 0 0
78 310 828 452 0 0 0 0
