0 0 0 0 0 0 7 0
0 0 0 0 0 0 168 243
0 0 129 1472 0 0 441 897
0 0 0 0 0 0 584 830
0 0 0 0 0 0 0 0
0 0 0 0 0 0 0 0
0 0 0 0 0 0 0 0
0 0 0 0 0 0 0 0
