0 0 0 0 0 0 0 0
0 2499 1602 966 1155 0 0 2348
0 587 0 75 937 0 0 0
0 1016 0 0 0 606 0 0
0 0 0 0 508 2810 1286 0
0 0 0 722 2379 1360 0 0
265 0 329 1842 433 0 0 0
0 0 0 0 0 0 0 0
