0 0 0 0 0 0 0 0
45 0 0 0 0 0 0 0
266 0 0 0 0 0 376 467
441 0 0 0 0 0 0 0
1894 1685 0 0 0 0 0 0
159 1159 0 0 0 0 0 0
0 0 0 0 0 0 0 0
0 0 263 506 0 0 0 0
