520 0 0 0 0 0 0 0
0 0 0 0 0 0 0 0
0 0 0 0 0 0 0 0
0 0 0 0 0 0 0 0
0 0 0 0 0 0 127 0
0 0 0 0 0 1904 282 0
0 102 0 0 843 0 0 0
354 728 0 567 0 0 0 0
