0 0 0 0 0 0 0 0
104 3 864 0 0 0 0 0
0 0 0 0 0 0 0 0
0 0 0 153 0 0 0 0
423 0 0 0 0 0 0 0
944 0 0 0 0 0 0 0
754 0 0 0 0 0 0 0
0 0 0 0 0 0 0 0
