0 0 0 0 0 0 0 0
0 0 0 0 0 0 0 0
0 0 0 0 0 0 0 0
0 0 0 0 0 0 0 0
0 0 0 0 799 0 0 0
0 0 0 1123 512 0 0 0
0 42 841 1930 409 0 0 0
0 0 400 1104 0 0 0 0
