0 0 0 0 0 0 0 0
0 0 0 0 0 0 0 0
0 0 0 0 0 0 0 0
0 0 0 0 0 0 0 0
0 0 0 733 0 0 0 0
0 0 0 0 0 0 0 65
0 85 0 0 0 0 0 311
1 644 146 304 399 0 0 0
