0 0 0 0 0 0 0 0
0 0 0 0 0 0 0 0
0 0 0 0 0 0 0 0
0 0 0 0 0 0 0 0
0 0 466 1355 2234 0 0 0
16 0 490 1149 709 0 0 0
0 0 0 0 0 0 0 0
181 0 0 0 0 0 0 0
