0 0 0 0 0 0 0 0
708 864 683 1805 1344 1713 1967 196
0 360 1028 2031 1937 410 1312 247
0 143 158 1057 1852 0 280 301
1431 1689 0 0 0 0 0 403
172 0 0 0 0 0 0 0
0 0 0 0 0 0 0 0
0 15 0 0 0 0 0 0
