0 0 0 0 0 0 0 0
0 0 0 0 0 0 0 0
1025 0 0 0 0 0 0 0
1225 53 0 0 0 0 0 0
79 752 0 0 252 0 0 0
0 508 80 0 529 478 0 0
0 0 0 0 1380 1394 0 0
0 0 0 594 0 87 11 0
