339 0 0 0 0 0 0 0
1286 0 0 0 0 0 1141 853
92 0 0 147 0 0 0 15
0 0 0 82 0 0 0 0
0 0 0 0 0 0 0 0
0 0 0 0 0 0 0 0
0 0 0 0 0 0 0 0
0 166 21 158 0 0 0 373
