0 0 1184 463 545 34 0 0
0 0 16 0 0 0 0 0
0 0 0 0 0 0 0 0
0 0 78 0 0 60 0 0
0 0 0 268 0 0 0 0
0 0 0 0 0 0 0 0
0 0 0 0 0 0 0 0
0 623 686 30 0 0 0 0
