3 7 0 0 0 0 0 0
0 0 0 0 0 0 0 0
0 0 0 0 0 0 0 0
0 0 0 0 774 0 0 0
150 0 0 669 1466 2316 0 0
0 0 0 0 69 0 0 0
0 0 0 0 0 0 0 0
0 0 0 0 0 0 0 0
