0 0 0 0 0 0 0 0
0 0 1047 0 0 0 0 0
208 963 3137 1473 581 814 0 349
0 0 1407 0 0 0 0 0
0 0 0 0 0 0 0 0
0 0 0 0 0 0 0 0
0 0 0 0 0 0 0 0
0 0 0 474 0 0 0 0
