0 0 0 0 0 0 0 0
0 0 0 0 0 0 0 0
0 0 1586 2141 685 297 0 0
0 1514 1973 1813 0 0 68 0
0 0 0 0 0 0 0 663
0 0 0 0 0 0 0 0
0 0 0 0 0 0 0 0
0 77 0 0 0 0 0 0
