637 1271 571 234 736 1301 996 745
0 0 0 0 0 0 0 0
0 0 0 0 754 0 0 0
0 0 411 0 0 0 0 0
0 0 0 0 0 0 279 0
0 0 0 0 0 166 0 0
0 0 0 0 219 0 0 0
0 0 0 0 0 0 0 0
