0 0 0 0 0 0 0 0
0 0 0 0 0 0 0 0
0 0 0 0 0 0 0 0
0 0 0 0 0 0 0 0
346 0 0 0 0 0 0 0
1623 1265 0 0 0 0 0 0
588 1021 0 0 0 0 0 0
46 0 15 608 65 0 0 0
