200 0 0 0 0 0 0 0
19 0 15 0 0 0 0 0
0 0 0 0 0 0 0 0
0 0 0 0 0 0 167 752
0 0 0 0 0 0 131 1588
0 0 0 0 0 0 0 555
0 0 0 0 0 0 0 338
281 0 0 0 0 0 0 235
