0 0 301 251 0 0 0 0
184 0 0 637 345 0 0 165
0 0 0 0 0 0 0 253
0 0 0 0 0 0 0 39
1031 0 0 0 0 0 0 0
971 0 0 0 0 0 0 0
0 0 0 0 0 0 0 0
0 0 0 0 0 0 0 0
