0 0 0 550 95 0 0 0
0 0 411 738 374 0 0 0
190 145 0 0 0 0 0 0
220 0 0 0 0 0 0 0
63 0 0 237 695 4 0 0
0 154 211 264 74 0 0 0
85 102 0 0 0 0 0 0
19 0 0 92 0 125 0 0
