532 0 0 0 0 0 0 0
0 0 0 0 0 0 0 0
0 0 0 0 0 0 0 0
0 0 166 46 0 0 0 0
155 0 0 0 0 535 1384 491
0 0 0 0 62 1361 348 27
0 0 61 517 1384 366 0 0
437 188 546 1068 865 311 287 428
