507 358 273 328 445 457 508 667
488 808 236 326 0 0 0 617
168 1516 336 0 0 0 0 463
0 577 0 0 0 0 0 129
0 0 0 0 0 0 0 0
0 0 0 0 0 45 0 218
0 121 0 0 415 486 273 40
0 0 0 0 98 173 0 0
