0 0 88 166 149 0 0 0
846 0 0 0 502 536 289 0
1040 0 0 0 52 156 467 0
519 181 0 0 0 0 0 0
0 0 0 0 0 0 0 0
0 0 0 0 0 0 0 0
0 0 0 0 0 0 0 0
0 0 0 0 0 0 0 0
