0 159 10 221 0 12 209 0
0 0 0 0 0 0 0 0
0 0 0 240 0 0 0 0
0 0 0 0 0 0 0 682
0 0 0 0 0 0 0 719
0 0 0 0 0 0 85 120
0 0 0 0 0 0 0 0
0 289 136 0 238 0 0 0
