0 0 0 0 0 0 0 0
24 0 481 0 0 0 0 0
364 0 0 0 0 178 0 0
0 0 0 0 0 134 0 0
0 0 0 0 0 1 106 0
0 0 0 0 0 0 0 296
0 0 0 0 0 0 0 127
347 0 0 0 0 0 0 0
