793 961 885 846 746 581 571 126
748 932 242 0 207 93 169 0
784 173 0 0 0 0 0 0
0 0 0 0 0 0 0 0
0 0 0 0 0 0 0 0
275 0 0 0 0 0 0 0
76 0 0 0 0 0 0 0
0 0 0 0 0 0 0 0
