0 0 0 0 0 0 0 0
0 0 265 0 0 0 0 0
0 0 67 0 0 160 0 0
0 0 462 187 0 161 0 0
0 0 728 357 0 0 290 0
0 0 367 0 0 232 796 279
0 0 0 0 0 55 771 102
0 0 0 0 245 0 351 6
