1052 1218 1225 787 967 1070 1144 1417
0 0 0 0 0 0 0 0
0 0 0 0 0 0 0 0
0 0 0 0 0 0 0 0
0 0 0 0 0 0 0 0
0 0 0 0 0 0 0 0
0 0 0 0 0 209 0 0
0 0 145 70 537 0 0 140
