0 0 0 0 0 0 0 0
0 0 0 0 0 0 0 0
0 0 0 0 0 0 0 69
0 0 0 0 0 0 0 90
0 0 0 0 62 2 129 0
0 0 0 0 255 691 653 540
0 0 0 0 891 961 366 384
51 0 0 629 1135 573 152 0
