0 0 0 0 0 0 0 0
0 0 0 0 0 69 0 0
0 0 0 0 0 84 0 0
0 0 339 0 0 467 0 107
0 44 541 456 0 347 0 210
0 0 0 0 0 85 388 327
0 0 0 0 0 0 307 99
0 0 0 0 0 89 356 257
