0 0 0 0 0 0 0 0
0 0 0 0 0 0 0 0
0 0 0 114 0 0 0 0
0 0 0 0 0 0 0 0
0 0 0 90 217 230 0 0
0 0 0 849 951 0 0 0
0 0 511 978 0 0 0 0
11 0 140 0 0 0 0 0
