675 100 0 90 173 99 358 424
0 0 0 0 0 0 0 0
0 0 0 0 0 0 0 0
0 0 0 0 0 0 0 0
113 0 0 0 0 0 0 0
0 0 0 0 0 0 0 0
0 180 561 122 0 0 0 0
109 82 358 241 0 0 0 0
