0 0 0 0 0 0 0 0
0 0 0 0 0 0 0 0
0 0 0 0 0 0 0 0
0 0 0 0 0 0 0 0
0 0 0 0 0 497 64 0
0 0 0 279 1000 561 0 0
0 0 0 672 782 0 0 0
0 0 0 327 0 0 0 207
