0 0 0 0 0 0 0 0
0 0 0 0 0 0 0 0
0 0 0 0 0 0 0 0
0 0 0 895 17 0 0 0
0 0 0 544 597 894 8 0
0 0 0 411 1096 822 405 138
0 0 0 177 624 0 0 116
0 0 0 458 0 0 0 0
