0 0 0 264 167 0 0 0
305 914 1045 1368 1216 1007 827 915
416 1018 583 935 1135 1325 993 974
499 574 0 0 148 369 218 473
37 167 0 0 0 0 0 0
0 20 0 0 0 0 0 0
0 0 0 0 0 0 0 0
0 0 0 0 0 0 0 0
