0 0 0 0 0 0 0 0
0 0 0 0 0 0 0 0
0 0 436 65 0 167 0 0
0 0 213 417 0 27 402 0
0 0 0 147 0 0 148 0
0 0 0 23 15 0 0 0
0 0 0 163 0 0 0 54
0 0 0 0 0 0 0 0
