0 0 0 0 0 0 0 0
0 0 0 0 0 0 0 0
0 0 0 0 0 0 0 0
0 1 0 0 0 0 0 0
0 0 0 0 282 0 0 0
0 0 0 0 0 349 752 229
0 0 0 0 0 912 1107 0
0 0 150 0 187 1286 555 0
