691 0 0 40 21 193 554 0
563 60 526 711 154 302 293 0
185 0 450 772 189 260 252 194
0 0 0 0 0 0 302 644
275 0 0 0 0 0 731 1043
377 0 0 0 0 0 691 590
0 0 0 0 0 248 64 149
267 452 0 0 173 3 0 0
