0 0 0 0 0 0 0 0
0 0 940 769 861 602 0 0
476 0 131 85 233 1208 848 0
0 0 0 0 0 438 560 0
0 0 0 0 0 0 0 0
0 0 0 0 0 0 0 0
0 0 0 0 0 0 0 0
0 0 0 0 0 0 0 0
