509 302 410 320 318 178 232 904
0 0 0 0 0 0 0 0
0 80 0 0 0 0 0 0
0 22 0 0 0 0 0 0
0 0 348 0 0 0 298 0
0 300 767 0 0 802 834 0
89 408 531 591 1754 1266 345 0
0 0 113 1110 1167 209 427 166
