0 0 0 0 0 0 0 0
0 0 0 0 0 0 0 0
0 0 0 0 0 0 0 0
0 137 0 0 564 724 56 0
0 161 0 0 361 359 0 0
0 70 0 0 459 0 59 0
0 0 0 23 183 0 0 0
0 0 0 38 0 0 0 0
