0 0 0 0 0 0 0 0
0 0 0 0 0 0 0 0
0 0 0 0 0 0 0 0
436 0 0 0 0 0 0 0
0 0 0 0 0 0 0 0
0 0 0 0 0 255 8 0
96 54 0 0 147 0 0 0
0 0 0 0 0 0 0 122
