638 0 0 54 266 250 0 0
0 0 0 0 0 353 4 0
0 0 0 0 157 333 296 0
0 0 0 0 200 0 0 0
0 0 0 0 0 0 0 0
0 0 0 0 0 0 0 0
0 0 0 0 0 0 0 0
0 0 64 77 0 0 0 0
