45 0 0 308 364 311 0 0
471 559 0 0 0 273 473 713
0 0 0 0 0 0 0 173
0 0 0 0 0 0 0 34
0 0 0 0 0 0 0 0
0 0 0 0 0 0 0 603
0 0 0 0 0 0 0 101
0 0 0 0 0 0 0 0
