0 0 0 0 78 0 0 0
0 0 0 0 0 0 0 0
0 0 0 0 0 0 0 0
0 0 273 104 0 0 0 239
0 0 193 274 0 0 0 843
0 0 0 0 0 0 0 544
0 0 0 0 0 0 71 317
0 0 0 0 0 0 0 185
