0 0 0 0 0 0 0 0
0 0 0 0 0 0 0 0
0 0 59 911 638 0 0 0
0 0 0 1068 701 205 0 0
0 0 0 538 651 27 0 0
0 0 0 741 888 0 0 0
0 0 296 970 825 0 0 0
0 0 296 775 0 0 0 0
