0 0 372 613 529 373 337 0
0 0 0 0 0 0 0 0
0 0 0 0 37 0 116 0
0 0 0 0 0 0 0 0
0 0 0 0 38 0 0 0
0 0 0 48 754 149 0 0
0 0 0 481 794 0 0 0
0 0 12 499 463 0 0 0
