132 342 87 0 0 4 123 0
268 408 762 779 327 0 0 0
0 0 0 758 180 0 0 0
0 0 0 231 0 0 0 0
339 0 0 0 0 0 0 0
64 0 0 0 0 0 0 0
0 0 0 0 0 0 0 0
0 0 0 0 0 0 0 0
