150 0 208 98 0 75 202 0
388 0 541 176 0 0 0 0
523 0 589 774 0 24 155 174
18 0 0 536 0 0 1035 628
311 0 0 591 0 0 117 894
323 0 0 194 0 0 0 882
120 0 0 0 0 0 0 813
102 0 0 0 0 0 0 615
