0 0 0 0 0 0 0 0
0 0 0 0 0 0 0 0
0 0 0 0 0 0 0 0
0 0 0 0 0 0 0 0
367 0 0 0 0 0 0 0
499 0 0 0 0 0 0 0
105 0 372 0 0 0 0 0
139 376 526 0 0 0 0 0
