272 0 0 0 0 0 0 198
0 0 0 0 0 0 0 0
0 0 0 0 0 0 0 0
395 0 0 0 0 0 0 0
217 0 0 0 0 0 0 0
0 0 0 0 0 0 0 0
0 0 0 0 0 0 0 0
0 0 208 363 233 824 680 336
