0 0 0 0 0 0 0 0
0 0 0 0 0 0 0 0
0 0 0 187 0 0 0 0
0 0 154 1421 7 0 0 0
0 0 0 634 11 0 0 0
0 0 0 0 27 0 0 0
0 0 0 495 24 0 0 0
0 0 442 462 0 0 0 0
