539 0 0 0 0 0 42 501
0 0 0 0 0 0 0 0
0 0 0 0 0 0 0 0
0 0 0 0 0 0 0 0
304 0 0 0 0 165 95 0
0 0 0 0 0 396 0 0
0 0 0 46 652 89 0 0
0 0 0 455 4 0 0 0
