0 0 0 0 0 0 0 0
0 0 0 0 0 0 0 0
0 415 0 0 0 0 0 0
26 309 0 0 191 124 0 0
226 484 0 0 0 0 0 0
0 98 0 0 0 0 0 0
0 0 0 0 0 0 0 0
0 0 0 376 94 249 0 0
