0 0 0 0 0 0 0 20
0 0 0 0 0 0 0 0
0 0 0 0 150 0 0 0
0 0 0 0 1074 309 0 0
0 0 0 0 662 444 0 0
0 0 259 432 386 262 0 0
0 0 663 605 0 385 0 0
0 0 163 0 0 0 0 0
