0 0 0 0 0 0 0 0
0 0 0 0 0 0 0 0
0 0 0 0 0 0 0 0
0 0 0 0 0 0 29 0
0 0 0 0 0 0 1069 1012
0 0 0 0 0 0 486 249
0 0 0 0 0 0 0 84
0 0 0 0 0 0 0 504
