0 0 0 0 71 0 0 0
0 0 0 0 0 0 0 0
0 0 0 0 0 0 0 0
0 0 0 0 0 0 0 0
739 1071 0 0 0 0 0 0
0 805 6 0 0 0 0 0
0 0 16 0 0 0 0 0
0 28 429 214 0 0 0 0
