0 0 0 0 0 0 0 0
0 0 0 97 42 0 0 0
0 0 0 722 680 11 0 0
499 1495 1032 782 277 0 0 0
78 1413 699 148 0 0 0 0
0 103 284 0 0 0 0 221
0 0 0 0 0 0 70 69
10 48 0 0 125 580 343 0
