330 28 0 0 0 0 38 0
55 0 0 0 0 0 0 57
0 0 0 1145 500 0 0 0
0 0 0 1429 820 0 0 0
161 0 0 0 0 0 0 217
0 0 0 0 0 0 0 0
0 0 0 0 0 0 0 0
188 516 581 273 0 0 0 0
