0 0 0 0 0 0 0 0
0 0 133 0 0 0 0 0
0 0 157 0 159 126 0 0
3 631 783 0 175 0 0 0
0 639 898 0 0 0 612 282
46 266 108 0 0 713 959 66
0 0 0 0 0 1206 689 0
0 0 44 47 637 706 100 0
