0 0 0 0 0 0 0 0
0 0 0 0 0 0 0 0
0 0 0 351 0 0 209 220
0 0 0 98 0 0 0 238
0 0 341 226 0 0 0 0
0 75 0 150 647 0 0 0
0 0 0 712 687 0 0 9
0 0 130 178 81 0 0 79
