0 0 0 0 0 0 0 0
0 0 0 0 0 0 0 0
0 0 0 0 0 0 0 0
0 0 575 0 0 0 0 0
0 0 135 0 0 0 0 21
0 0 80 0 0 0 0 141
114 55 100 0 0 0 188 202
155 4 0 0 0 456 593 440
