0 0 0 0 0 0 0 0
0 0 0 0 0 0 0 0
0 573 0 0 0 0 0 0
134 381 0 0 0 0 0 0
0 0 0 0 519 412 0 0
0 330 648 441 883 161 0 0
6 161 134 98 109 0 0 0
0 0 0 0 0 0 0 0
