0 0 0 0 0 0 0 0
0 0 457 266 351 626 0 0
1252 116 279 224 102 1540 522 0
0 0 0 0 0 292 0 0
0 0 0 60 0 0 0 0
237 0 0 0 0 0 0 389
0 0 0 0 0 0 0 91
0 0 0 0 0 0 0 0
