0 0 0 0 0 0 0 0
0 0 0 0 0 0 0 0
0 0 0 0 0 0 0 0
0 0 75 251 0 1031 333 0
0 0 0 255 0 1274 1296 338
0 0 0 57 176 703 977 297
0 0 0 0 0 0 104 183
0 0 0 0 0 0 0 83
