65 0 0 0 0 428 642 0
605 386 476 0 0 651 594 0
240 0 0 0 0 136 531 0
0 0 0 0 0 0 177 0
0 0 0 11 0 0 0 139
0 0 0 0 0 0 217 365
0 0 0 0 0 0 0 90
0 0 0 28 488 0 0 106
