0 0 0 0 0 0 0 0
0 0 0 753 244 0 129 313
0 529 0 0 0 0 53 787
0 699 0 0 228 0 0 137
0 164 0 253 716 0 0 0
0 415 0 490 746 0 0 0
0 69 534 325 9 0 0 0
0 0 185 0 0 0 0 0
