0 3 0 0 0 0 0 0
0 363 0 0 0 0 0 0
0 0 0 0 220 0 0 0
0 0 0 0 95 99 0 0
0 0 0 0 92 248 0 0
0 0 0 0 322 119 0 0
78 0 0 466 0 0 30 0
201 68 0 0 0 0 0 0
