0 0 0 0 0 0 0 0
97 0 0 0 0 0 160 0
0 0 0 0 0 0 0 0
0 0 0 141 0 0 0 0
0 0 0 123 69 0 0 0
468 395 0 24 0 0 0 0
46 0 0 0 0 0 0 0
0 0 0 0 0 0 0 247
