274 777 496 425 236 125 452 656
634 941 555 734 434 20 550 675
0 0 0 0 0 0 247 787
0 0 0 0 0 0 0 487
0 0 0 0 0 0 0 0
0 0 0 0 0 0 0 0
0 0 0 0 0 0 0 0
0 0 0 0 0 0 0 0
