0 0 0 0 0 0 0 0
0 0 0 0 0 0 0 0
0 0 0 0 0 0 0 0
634 0 0 0 0 0 0 0
1350 0 0 0 403 0 0 0
814 559 0 0 287 0 0 0
307 385 0 0 0 0 0 0
0 0 0 0 0 0 0 0
