0 0 0 75 0 0 0 0
0 373 0 0 0 0 275 180
0 899 679 557 233 196 476 241
222 950 632 532 229 826 721 471
0 1223 883 307 0 0 0 200
0 797 302 0 0 0 0 97
0 0 0 0 0 0 0 0
0 0 0 0 0 0 0 0
