0 0 0 0 0 0 0 0
0 0 0 0 0 0 0 0
0 0 0 0 0 0 0 0
0 0 0 0 78 0 0 0
27 0 0 151 600 0 0 0
0 221 0 25 0 0 0 0
0 0 0 0 0 531 0 0
0 0 0 0 0 154 0 0
