0 0 0 446 323 0 271 0
0 0 0 332 0 0 0 0
0 0 0 463 301 0 0 0
0 0 0 0 38 0 0 0
264 0 0 0 98 0 0 0
319 0 0 0 438 20 0 0
0 152 425 888 553 0 0 0
0 75 171 0 0 0 0 0
