-71 -65 -34 -35 -36 -37 -37 -36 -35 -36 -36 -36 -35 -36 -36 -36 -35 -37 -35 -34 -30 -38 -42 -32 -31 -33 -32 -31 -29 -30 -16 3
-22 -23 -18 -19 -17 -18 -19 -16 -15 -14 -14 -13 -15 -16 -14 -13 -13 -14 -11 -10 -11 -16 -11 -9 -13 -12 -10 -10 -10 -10 28 40
-8 -43 -19 -18 -17 -20 -20 -17 -16 -15 -16 -15 -14 -16 -17 -17 -16 -13 -15 -18 -19 -8 -4 -17 -21 -18 -19 -20 -18 -17 -5 -7
-8 -44 -18 -17 -17 -19 -16 -15 -15 -16 -15 -14 -15 -15 -16 -18 -15 -16 -18 -17 -15 -15 -20 -24 -20 -18 -19 -17 -18 -19 -5 -6
-9 -43 -18 -16 -16 -18 -15 -13 -11 -16 -15 -14 -15 -16 -18 -18 -18 -17 -16 -14 -17 -20 -25 -22 -20 -22 -21 -19 -23 -22 -8 -6
-8 -42 -17 -16 -17 -15 -14 -9 -11 -17 -19 -22 -24 -28 -27 -26 -29 -32 -26 -20 -20 -22 -21 -22 -23 -24 -23 -24 -24 -22 -8 -7
-8 -44 -16 -16 -16 -14 -13 -3 -23 -17 0 -3 -4 2 2 2 1 10 21 -16 -32 -9 -14 -29 -22 -21 -22 -22 -20 -20 -7 -7
-9 -42 -17 -18 -15 -13 -12 -29 -45 31 70 52 46 47 42 36 35 55 47 -11 3 33 -18 -46 -29 -21 -21 -20 -20 -20 -7 -6
-7 -22 -15 -24 -16 -14 -17 -35 2 71 49 17 3 0 0 0 -6 -9 -30 -6 17 -23 -52 -27 -7 -22 -32 -26 -22 -21 -8 -9
16 -27 -36 -31 -18 -15 -21 -13 29 31 -6 -27 -39 -37 -37 -35 -39 -43 -24 -32 -57 -43 3 36 36 -17 -47 -36 -23 -22 -14 -13
65 -24 -15 -22 -31 -21 -21 -8 16 14 0 -5 6 4 -8 -15 -22 -11 -6 -47 -36 19 35 0 -25 10 -34 -37 -19 -19 -17 -2
26 4 87 4 -54 -26 -26 -4 14 11 -6 -8 9 -6 -14 -10 -16 -23 -46 -32 1 29 -27 -81 -29 9 -50 2 6 -2 16 19
-3 51 69 -6 -55 -64 -49 69 55 0 -8 -7 -8 -28 -22 -15 -19 -19 -29 -21 8 -10 -98 -37 27 -33 -17 28 20 1 25 14
-1 -7 -59 -17 30 6 56 68 38 -7 -38 -19 -8 -11 -14 -20 -22 -16 -2 0 -6 -61 -50 -4 3 -18 31 9 -8 -23 -25 -37
-18 -56 -71 -4 43 46 60 -63 -36 -15 -25 -5 -15 -17 -18 -16 -10 -29 -8 -16 -86 -70 15 -2 10 -5 13 -90 -107 -88 -44 -20
-14 -36 -29 -13 -40 -35 -71 -119 -60 -10 23 1 -29 -25 -22 -17 -8 -9 -10 -77 -60 -7 -25 40 16 -14 -5 -111 -83 -18 61 37
-13 -14 4 -16 -30 -34 -51 -16 1 21 4 -22 -28 -20 -19 -22 -16 -8 -38 -34 28 -59 -19 49 -10 43 -18 -42 3 73 68 0
-9 -11 -14 -22 -23 -23 -21 -3 17 16 -13 -6 -29 -53 -23 -2 -19 -39 -29 20 -77 -67 63 5 9 31 -47 -32 11 35 -14 -24
-11 -43 -32 -22 -18 -16 -15 -6 -1 3 -5 -10 -40 -49 -16 2 -22 -30 -14 -45 -44 84 27 -75 -14 -27 -63 -36 15 7 -25 -18
4 -15 -19 -26 -29 -42 -48 -45 -16 10 -14 -31 -12 0 -1 -7 -28 -32 -29 -19 63 61 -88 -45 17 -73 -83 -9 37 -3 -20 -15
-1 -41 -49 -57 -60 -46 -26 -5 8 -5 -14 -15 -1 17 0 -27 -42 -29 17 20 -6 -74 -83 30 -61 -124 -25 38 29 -53 -27 -10
-19 -46 -28 -19 -7 2 3 -3 -13 -12 -13 -29 -7 2 -25 -24 -12 0 -19 -57 -36 -50 23 -54 -161 -61 21 47 -1 -45 -11 -11
-2 -5 -2 -5 -10 -18 -38 -47 12 28 -36 -36 -7 -52 -53 -28 -20 -16 -64 -77 -19 27 11 -109 -62 8 26 26 -35 -29 -7 -9
4 -25 -30 -30 -36 -45 -46 0 31 -52 -55 20 5 -38 -23 -9 -25 -52 -46 0 39 -12 -123 -64 22 9 29 19 -45 -33 -16 -9
3 -39 -43 -33 -30 -39 -22 -13 -52 -32 36 21 -14 14 23 4 3 -17 8 75 0 -136 -83 20 2 -9 40 -25 -49 -32 -10 -8
-1 -30 -25 -30 -34 -18 9 12 27 59 25 -19 -11 14 1 -14 -3 7 42 -9 -161 -99 39 13 -43 3 20 -13 6 -36 -13 -7
-4 -31 -30 -24 9 37 38 34 17 -22 -30 -15 -15 -32 -25 -14 -26 10 -13 -139 -108 30 19 -45 -31 38 3 -30 -28 -28 -6 -7
-18 -41 4 37 45 25 -12 -39 -46 -42 -20 -14 -16 -13 -13 -18 12 16 -93 -93 28 28 -37 -48 7 55 -5 -66 -90 -29 8 -8
-9 11 46 23 -15 -42 -49 -31 -16 -11 -15 -17 -10 2 1 23 18 -90 -95 17 24 -29 -47 -32 33 20 -44 -55 -34 3 16 -6
31 24 -16 -47 -48 -27 -10 -9 -12 -8 -8 -16 -18 8 36 7 -97 -102 -1 26 -20 -40 -41 5 56 -50 -84 -32 -6 -6 0 -18
16 -45 -66 -48 -22 -14 -18 -24 -20 -16 -18 -24 -8 -11 -88 -161 -98 6 14 -24 -46 -45 -23 42 5 -99 -59 22 27 -3 -32 -42
-5 -32 -17 -6 -8 -16 -17 -9 -7 -11 -14 -6 -7 -42 -61 -21 35 33 5 -16 -16 -7 15 -3 -71 -30 11 -3 -15 -26 -21 -2
