86 66 18 19 21 20 17 17 16 16 14 14 14 14 13 13 12 12 13 9 7 10 13 7 6 6 6 7 4 4 8 -100
106 30 19 21 23 22 21 20 21 20 20 21 23 22 21 22 22 22 19 16 21 30 20 14 20 19 18 18 17 18 -21 -145
65 26 2 2 2 4 2 0 0 0 0 1 2 2 1 1 2 0 -1 0 6 6 -7 -3 3 0 0 -1 -3 -2 -35 -130
67 29 4 1 3 6 1 -2 -1 0 1 0 3 2 1 3 1 1 1 0 0 0 -1 3 3 0 2 -2 -4 -1 -35 -130
67 29 3 0 3 6 0 -3 -2 0 1 0 3 2 2 2 1 2 2 -1 -2 0 3 3 0 1 2 -2 -1 0 -34 -130
66 28 2 0 4 4 -1 -6 -2 3 0 -1 0 0 -3 -4 -3 -3 -5 -10 -5 0 0 0 0 2 1 0 0 -1 -35 -129
65 29 1 0 4 0 -4 -9 4 2 -13 -12 -9 -15 -18 -16 -15 -18 -26 -8 1 -10 -7 0 0 1 0 0 -1 -2 -35 -129
67 28 1 1 1 -1 -6 2 -1 -75 -104 -87 -85 -87 -82 -75 -72 -81 -50 13 -10 -30 15 22 2 -2 0 -1 -1 -1 -34 -129
69 17 3 9 0 -1 -1 7 -75 -205 -153 -99 -86 -78 -68 -56 -53 -46 17 31 -29 9 71 27 -11 -2 0 1 0 -1 -34 -128
68 3 32 10 -1 0 5 -9 -138 -221 -81 -25 -15 -13 -3 9 13 22 50 46 16 40 39 -26 -33 17 20 6 -1 -2 -34 -128
41 24 51 10 5 3 7 -20 -144 -191 -40 5 -1 -1 13 27 32 19 38 62 1 -40 -35 -39 6 34 37 16 -5 -6 -39 -142
24 25 -6 22 35 15 8 -26 -147 -191 -41 -2 -16 4 24 30 32 20 54 47 -55 -82 -6 44 29 27 72 -22 -35 -27 -75 -166
16 -18 -16 98 75 25 -7 -107 -168 -176 -42 -12 -15 21 26 31 36 29 56 32 -70 -50 77 31 -35 41 35 -101 -77 -60 -99 -157
4 -9 66 146 46 -23 -119 -189 -141 -137 -20 -12 -12 20 20 34 37 27 44 16 -55 32 82 -30 -52 28 -32 -120 -35 -10 -26 -77
20 40 69 55 -27 -80 -161 -88 -32 -67 1 -25 -13 18 19 29 24 21 30 24 23 66 21 -51 -62 18 -25 -19 58 46 8 -81
37 55 29 -7 -20 -26 -32 37 -5 -55 -34 -38 -1 20 20 21 21 17 33 87 56 0 7 -78 -62 49 27 99 74 16 -65 -126
55 51 18 10 19 18 36 26 -60 -104 -46 -13 7 18 22 18 17 16 64 93 -10 14 -10 -124 -14 21 80 120 0 -93 -131 -105
56 29 15 19 16 14 16 -10 -102 -122 -26 1 18 34 16 0 7 29 60 35 36 31 -128 -115 -26 -3 106 79 -69 -132 -79 -68
46 20 10 7 5 5 5 -19 -94 -106 -18 14 54 36 -15 -20 10 27 38 68 70 -99 -149 -50 -32 24 137 59 -90 -103 -36 -69
36 7 2 4 7 14 16 -1 -80 -108 -8 39 58 8 -48 -23 18 27 37 44 -51 -136 -7 -6 -58 78 153 3 -128 -70 -13 -69
24 18 19 26 28 26 13 -13 -93 -102 0 22 27 -20 -56 -6 32 15 -13 -23 -56 2 84 -64 -7 158 88 -71 -132 -12 2 -71
47 38 24 19 1 -11 -18 -26 -82 -96 -18 4 -3 -27 -23 13 20 -18 -26 13 -6 61 32 -23 128 113 -11 -123 -82 24 -10 -69
46 -1 -9 -16 -25 -18 1 1 -84 -117 -9 3 -27 9 7 6 9 -13 24 34 -18 21 25 122 119 17 -72 -123 -28 29 -19 -67
22 -13 -3 -1 3 17 24 -29 -111 -57 17 -39 -19 43 -3 -8 13 17 37 -16 -65 22 148 134 22 -36 -100 -103 8 28 -15 -72
21 8 18 15 20 26 0 -51 -56 -28 -53 -69 5 16 -42 -19 4 5 -8 -79 -44 155 163 27 -20 -49 -128 -50 35 16 -17 -76
28 21 21 19 25 6 -35 -61 -81 -106 -81 -37 0 -14 -31 -4 3 -7 -37 -33 127 186 32 -23 -3 -80 -124 -12 20 25 -17 -78
35 29 22 5 -27 -73 -99 -103 -100 -62 -14 -10 -6 3 -5 -3 13 1 -9 109 171 45 -19 14 -16 -130 -104 -5 32 44 -25 -74
50 16 -25 -75 -109 -109 -77 -36 -15 0 0 -5 10 10 -11 2 4 -9 89 158 49 -15 14 21 -68 -158 -61 34 68 29 -48 -76
44 -61 -107 -107 -74 -31 1 10 1 -7 -8 0 14 4 -9 -2 -1 75 147 58 -9 12 27 -8 -122 -127 20 75 47 -15 -55 -71
-11 -111 -71 -26 -2 7 6 2 1 -5 -7 2 13 -1 -19 8 92 136 59 -9 2 26 15 -55 -150 -43 82 61 -3 -48 -54 -58
-23 -46 8 11 -4 -6 3 8 2 -5 -3 6 -1 -12 32 107 128 43 -11 -11 12 9 -25 -121 -107 50 52 -8 -37 -47 -33 -39
-8 -24 -15 -33 -36 -26 -14 -19 -28 -28 -20 -21 -28 8 62 55 -25 -80 -88 -79 -72 -88 -129 -158 -49 2 -76 -89 -71 -65 -60 -76
