32 83 68 66 65 66 65 62 61 62 60 59 57 54 53 53 52 52 52 53 53 48 45 45 45 44 41 40 40 38 49 44
95 164 130 128 129 131 129 124 123 124 123 122 123 122 119 119 118 118 119 120 118 114 111 113 115 115 113 111 112 111 116 48
58 103 79 75 76 77 74 71 69 71 69 67 68 66 63 62 61 59 60 62 63 58 54 54 55 54 50 49 50 51 83 31
58 102 76 73 73 74 71 68 68 70 69 68 68 65 61 60 59 58 60 62 63 61 58 57 54 51 47 46 47 48 82 31
58 101 75 71 71 71 69 65 65 68 69 69 69 65 62 61 61 61 60 60 59 56 56 56 56 54 50 48 50 50 82 31
58 99 72 68 67 68 66 64 64 67 70 72 72 70 68 68 68 66 61 62 59 52 52 53 54 54 53 53 54 52 82 30
57 95 68 65 65 67 65 73 67 62 71 75 71 66 61 59 56 48 47 49 42 40 47 49 49 50 50 50 50 49 79 28
53 92 66 63 63 63 66 79 46 23 42 40 32 30 27 29 26 23 20 18 7 21 35 37 42 47 47 46 45 45 76 26
46 83 60 58 59 60 65 74 27 24 51 45 32 29 27 28 25 19 5 11 12 16 38 34 34 44 45 45 43 44 75 24
45 74 58 56 57 56 60 67 33 19 24 17 8 4 0 -1 0 -4 -13 -2 4 12 33 34 33 39 42 41 39 41 70 22
42 52 43 45 47 49 51 63 37 16 10 -6 -12 -7 -11 -13 -12 -8 -19 -11 -7 3 37 45 28 42 39 33 34 42 69 24
21 5 13 32 33 53 42 44 31 15 11 -4 -5 -1 -8 -11 -10 -8 -8 -7 -11 -1 32 31 28 33 33 30 39 45 74 28
11 -12 0 25 41 64 26 24 31 9 12 -5 -6 0 -5 -8 -10 -9 -13 -11 -8 -1 19 23 24 19 16 18 44 39 68 17
15 8 0 -4 29 35 8 25 52 8 4 -2 -1 3 -3 -9 -6 -5 -12 -4 5 0 13 4 12 10 10 18 35 36 56 7
13 23 24 10 12 21 23 13 31 0 -5 -3 3 7 0 -8 -8 -4 -4 2 10 16 1 -13 -1 -2 0 6 33 32 44 8
13 16 9 9 11 12 17 10 12 0 1 -1 1 6 0 -6 -8 -4 -8 -6 16 21 0 -11 -18 -28 -32 11 39 26 20 -2
20 14 -8 -8 -6 -5 7 11 2 1 9 0 0 1 -4 -10 -9 -5 -8 4 12 -4 -7 -10 -14 -10 -4 37 33 2 12 -10
34 29 15 17 19 19 17 16 5 -3 5 -1 0 0 -3 -9 -8 1 1 3 -1 -10 -14 -8 -11 6 14 21 16 4 8 -14
35 30 14 10 7 8 6 12 5 -5 3 -4 -5 1 0 -3 0 7 -3 -17 -13 -15 -2 -15 -9 9 3 18 6 5 16 -11
29 21 13 13 13 14 10 9 -1 -7 0 -5 0 0 -3 0 6 2 -14 -18 -18 -4 -10 -5 -1 2 19 20 5 6 12 -12
31 21 9 8 8 10 5 1 -5 -15 0 -2 -2 0 -4 -2 3 -4 -26 -42 -31 -18 10 20 6 25 32 3 2 6 10 -10
23 17 6 9 10 10 8 7 -3 -11 12 8 4 10 0 -2 0 -1 -19 -39 -29 -21 2 -1 27 53 19 1 -5 3 4 -11
29 22 11 12 8 2 -1 -7 -5 6 23 19 21 26 17 9 10 15 7 -5 -9 -6 -29 -11 45 26 0 1 5 4 3 -13
28 19 8 7 2 -4 -9 -3 15 16 24 17 14 24 13 11 18 20 18 2 -4 -16 -15 38 29 3 -6 1 7 1 4 -12
24 14 7 9 9 5 7 15 14 17 15 8 0 12 11 2 8 11 3 4 -33 -25 35 26 12 3 6 2 9 3 4 -13
24 14 5 5 10 9 8 11 18 16 9 4 -1 2 1 -2 0 0 -7 -26 -22 48 32 8 1 -3 -3 6 5 -1 1 -11
26 18 6 2 2 10 25 35 29 11 8 7 7 5 5 8 1 -4 -36 -33 50 37 5 2 3 -4 1 14 4 -1 0 -11
26 15 3 7 15 21 21 20 20 17 14 10 6 6 3 0 -4 -29 -43 23 35 1 -2 7 0 -3 -4 0 2 4 5 -10
18 10 15 21 18 18 16 17 18 18 16 14 12 5 -5 -11 -30 -31 24 28 0 -4 8 5 -6 -6 -3 -6 -2 -5 0 -10
23 22 19 18 17 15 16 15 13 13 13 14 10 2 -13 -35 -36 23 31 1 -6 5 9 -4 0 1 9 9 0 0 5 -10
28 36 43 36 33 29 28 28 27 26 27 28 24 17 5 5 38 39 13 10 18 23 8 -3 3 21 15 9 5 2 3 -10
8 9 14 9 6 4 5 6 5 3 4 5 -7 -22 -7 31 27 3 -4 0 7 5 4 0 -2 14 11 5 6 0 6 2
