-185 40 -15 -13 -19 -17 -13 -15 -19 -17 -14 -16 -17 -14 -17 -20 -18 -18 -20 -14 -17 -23 -14 -17 -21 -19 -19 -21 -19 -19 -115 64
-161 -30 -11 -6 -13 -14 -9 -9 -12 -13 -9 -8 -10 -8 -7 -14 -14 -12 -13 -8 -3 -21 -14 -4 -13 -12 -12 -13 -11 -13 -128 -34
-141 -17 -11 -4 -8 -14 -10 -7 -9 -11 -8 -7 -8 -7 -4 -10 -11 -15 -12 -6 3 -13 -20 -6 -9 -10 -12 -12 -8 -10 -117 -23
-142 -17 -10 -6 -7 -14 -10 -7 -9 -8 -8 -7 -8 -8 -7 -8 -8 -14 -15 -7 0 -5 -12 -12 -10 -10 -14 -14 -7 -11 -117 -27
-142 -20 -10 -7 -8 -11 -10 -6 -11 -9 -5 -7 -7 -8 -9 -12 -7 -10 -16 -11 -3 -6 -8 -11 -9 -9 -14 -15 -8 -9 -117 -28
-141 -21 -10 -7 -8 -12 -8 -6 -8 -11 -4 -4 -6 -8 -6 -12 -8 -7 -12 -9 -5 -9 -11 -10 -8 -8 -11 -13 -12 -9 -116 -26
-142 -20 -11 -7 -7 -12 -7 -10 0 -8 -14 -11 -11 -18 -18 -19 -18 -16 -35 -22 5 -17 -22 -8 -6 -9 -11 -11 -13 -11 -116 -26
-138 -27 -11 -6 -7 -10 -10 -20 23 21 -37 -50 -38 -45 -53 -54 -43 -30 -70 -84 -5 -29 -54 -13 -1 -10 -10 -11 -12 -13 -117 -28
-125 -37 -24 -1 -6 -9 -15 -36 25 94 7 -28 -13 -12 -21 -38 -24 6 -28 -100 -27 -26 -81 -42 -19 -17 -4 -8 -11 -11 -119 -30
-131 -35 -45 -1 -5 -6 -17 -51 -4 117 28 -8 2 3 5 -11 -17 27 -8 -76 11 -5 -99 -58 -58 -71 -10 2 -11 -13 -116 -35
-118 -75 -78 -29 3 -1 -14 -61 -28 114 29 -8 0 -6 -2 -7 -21 26 -5 -89 27 57 -71 -30 -11 -129 -74 0 -9 -24 -113 -45
-10 -92 -131 -136 -1 4 0 -71 -50 106 32 -1 13 -5 -5 -12 -28 15 8 -97 -1 74 -13 -5 48 -77 -121 -18 -31 -36 -129 -55
54 19 -34 -213 -88 -6 31 -51 -121 92 25 0 25 -3 2 -10 -23 0 -15 -91 5 36 -32 17 54 -18 -116 7 -60 -44 -142 -52
6 61 104 -128 -173 -78 -4 43 -158 30 19 5 30 -9 3 -4 -20 21 -27 -107 6 44 -92 26 90 -9 -100 45 -9 -22 -121 -21
-54 15 101 21 -91 -92 -77 62 -47 -15 -15 3 30 -1 -4 3 -37 20 2 -105 -18 59 -111 -20 92 0 -96 15 19 -4 -109 -2
-82 -15 15 40 8 -21 -60 -20 23 44 -34 -19 17 7 -4 11 -21 -10 7 -81 -47 32 -34 -48 53 3 -79 -78 10 20 -92 -20
-75 -24 -16 -8 -4 -11 -28 -57 -1 88 2 -25 -2 9 -4 8 7 0 1 -82 -74 4 -2 6 37 -7 -45 -138 -7 23 -65 -41
-58 -20 -10 -12 -6 -8 -22 -60 -25 72 22 -18 -31 11 11 -6 7 15 24 -99 -56 -28 -5 35 59 2 -61 -142 -23 21 -54 -39
-59 -12 -9 -16 -12 -11 -21 -61 -21 64 23 6 -58 -21 39 4 -2 7 31 -55 -68 -63 -28 39 89 12 -71 -105 -24 17 -72 -23
-55 -17 -8 -8 -10 -13 -18 -54 -17 74 11 33 -46 -70 33 24 -8 15 17 -24 -57 -55 -73 10 81 4 -76 -63 0 7 -87 -17
-57 -10 -13 -12 -4 -12 -22 -62 -32 91 9 23 -13 -81 0 21 -19 19 21 -34 -1 -10 -100 -6 54 -4 -88 -33 22 6 -80 -23
-62 -11 -9 -18 -8 -8 -15 -55 -50 75 18 14 15 -46 -10 8 -28 -8 24 -10 -3 7 -119 -13 33 -26 -58 -7 22 -20 -68 -20
-49 -16 -16 -19 -11 -9 -15 -32 -50 44 11 15 19 -24 9 10 -10 -10 -9 -4 35 -7 -86 -52 -20 -29 -10 16 24 -30 -77 -18
-45 -2 -10 -18 -12 -7 -19 -26 -29 33 15 11 12 -47 16 11 -14 23 -6 -42 48 -11 -31 -66 -61 -20 6 19 2 -15 -81 -13
-51 -4 -5 -5 -17 -12 -26 -19 0 14 11 29 40 -60 -11 20 -36 -7 11 -34 18 -23 -54 -57 -37 -14 20 15 -24 -11 -85 -7
-51 -13 -15 0 -7 -9 -27 -34 -21 2 -8 20 50 0 -6 25 0 -26 3 -8 12 -39 -80 -39 -24 -9 47 8 -43 -31 -72 -16
-47 -11 -15 -2 -7 -10 -17 -28 -24 7 -3 -2 5 8 21 8 21 -3 -10 -12 -18 -60 -30 -36 -24 -4 32 32 -13 -68 -67 -22
-49 -6 -15 -11 -10 -11 -1 -9 -13 7 7 3 -9 -26 18 7 6 19 -9 -35 -45 -32 -12 -31 -24 27 -14 -3 30 -38 -81 -21
-50 -14 -11 -15 3 -6 0 -1 -12 -4 11 18 8 -27 0 1 -9 20 -10 -65 -19 -9 -29 -24 -16 48 -2 -48 -14 7 -69 -26
-41 -21 0 -6 8 1 -10 -2 -2 -3 1 11 17 -6 -1 0 -24 -21 -21 -30 -5 -14 -29 -16 -5 25 33 -45 -46 10 -54 -28
-25 -20 -5 -7 0 7 -9 -9 -1 -1 -4 -2 8 2 -2 6 -38 -65 -23 3 -10 -22 -19 -10 11 -24 37 -18 -64 -6 -47 -32
-14 -25 -16 -15 -10 0 -6 -17 -13 -6 -7 -12 1 9 -19 -26 -35 -37 -27 -10 -19 -25 -30 -2 19 -37 -5 26 -38 -27 -36 -65
