61 105 95 96 98 98 98 97 97 98 98 98 98 98 99 98 98 97 98 100 100 96 93 96 97 97 97 95 96 95 97 46
1 -16 -11 -11 -10 -11 -13 -13 -12 -13 -14 -14 -14 -14 -14 -15 -15 -16 -16 -18 -15 -13 -14 -17 -20 -18 -20 -22 -21 -21 -29 -43
-19 -4 1 1 2 2 2 1 0 1 1 2 2 1 0 0 0 1 1 0 0 1 0 0 0 0 0 0 1 1 0 -20
-18 -3 1 1 2 1 1 1 2 1 1 0 0 -1 -1 -2 -2 -2 -1 0 -2 -5 -3 -1 0 0 -1 -1 -1 -1 -1 -21
-18 -3 2 2 1 1 1 1 2 2 2 2 2 2 2 3 3 3 2 0 1 2 3 2 1 0 0 0 1 1 0 -21
-18 -3 0 0 0 0 -1 -2 -2 -2 -1 0 0 0 1 2 1 1 2 2 1 0 0 0 1 2 2 2 3 2 0 -22
-18 -4 0 0 0 0 0 0 -2 14 37 46 51 54 54 53 53 50 39 15 7 11 6 1 1 0 1 1 0 0 -1 -23
-17 -1 1 0 0 0 0 6 2 18 28 24 18 12 9 6 0 -2 2 4 13 13 -4 -7 -3 0 0 -1 -1 0 -1 -23
-18 1 0 -2 -2 -2 0 -4 -56 -86 -123 -135 -136 -138 -135 -130 -125 -115 -99 -80 -52 -32 -5 20 20 7 2 0 -1 -1 -3 -24
-11 4 -1 1 1 0 1 -9 -34 -15 -15 -16 -11 -9 -11 -13 -12 -12 -29 -38 -19 16 32 34 30 19 5 1 -3 -2 -3 -20
16 23 25 8 0 -4 -7 -12 -27 -13 -9 -12 -2 1 -1 -6 -9 -10 -3 -7 -16 -34 -58 -64 -46 -6 0 12 13 19 14 0
-28 -28 20 2 -5 -3 -11 -7 -19 -15 -20 -29 -27 -26 -21 -14 -14 -16 -15 -25 -33 -32 -42 -38 -32 -27 -23 28 37 41 28 14
-60 -95 -99 -69 -20 18 11 35 11 10 4 -3 -2 -5 -2 0 3 11 15 0 -3 11 2 0 5 -14 -21 -10 -23 -22 -33 -30
-31 -44 -55 -37 24 54 10 -24 -40 -19 -11 -3 3 1 0 -3 -8 -5 1 -4 -12 -13 -23 -31 -27 -36 -45 -73 -82 -92 -88 -80
-3 0 -14 -52 -88 -121 -88 -92 -76 -42 -10 1 -3 -5 -4 -2 -4 -10 -10 -20 -16 8 5 -16 -10 -34 -44 -51 -50 -28 -8 -18
0 -7 -15 -36 -66 -82 -54 -20 -27 -18 -13 0 0 -1 -4 -6 0 3 6 -4 11 16 -9 -5 13 16 29 34 53 57 46 9
8 13 32 50 62 61 45 38 7 1 -10 -11 -3 -5 -10 -13 -15 -13 0 8 15 -5 -20 1 -8 18 16 24 21 -16 -39 -42
-6 -8 -13 -18 -17 -12 -4 -6 -14 -4 -3 -3 -8 -12 -5 -1 -1 -7 -12 -23 -20 -17 0 -33 -46 -42 -51 -35 -47 -26 -25 -25
-8 2 14 20 18 11 0 -13 -27 -14 -15 -7 0 4 7 4 6 7 0 14 12 18 -19 -39 -22 -20 -31 -22 -9 0 -7 -13
-3 0 -7 -22 -31 -32 -31 -26 -32 -12 -13 -5 6 9 10 4 -2 -2 -4 -19 -40 -31 -16 13 24 -10 -22 -21 -11 -15 -11 -14
-30 -34 -20 -4 14 32 41 25 0 -6 -5 -8 -9 -8 -2 -2 -3 -10 -23 -54 -54 -35 -30 -2 -6 -6 6 -10 -9 -20 -15 -15
6 28 40 38 29 9 -11 -21 -15 0 1 -6 -8 -13 -8 2 5 0 -2 -6 10 4 -2 -2 0 17 0 -11 2 2 1 -13
-6 0 -9 -19 -26 -27 -20 -14 -1 8 5 4 5 -13 -13 -13 -13 6 23 8 11 -12 -4 -7 22 18 -17 -9 -14 -7 -6 -12
-24 -23 -19 -10 -8 -3 -3 -19 -22 -23 0 21 25 21 33 28 16 15 28 26 13 -22 -39 -3 16 -8 -9 3 -4 -3 -8 -14
-9 0 -1 -1 -1 0 -6 0 13 29 12 -9 -18 -4 2 4 15 18 1 -6 -13 -9 7 19 -7 -26 -12 -14 -3 6 0 -9
-8 -2 0 0 11 28 48 52 31 0 -21 -21 -33 -46 -49 -51 -50 -52 -41 -28 -27 -1 15 -7 -15 -13 1 4 15 -1 -3 -9
-9 -6 1 12 12 -4 -31 -60 -59 -42 -16 1 9 6 8 11 5 3 9 5 22 24 -3 -5 -10 -9 -26 -33 -23 -16 -4 -10
-1 13 13 -1 -24 -39 -35 -14 7 10 7 8 14 12 11 10 6 6 -6 0 18 -3 -7 -2 -21 -8 -9 -12 -20 -13 -6 -9
4 2 -20 -34 -26 -5 4 2 -1 -2 0 1 0 0 0 -4 -15 -23 -5 11 -6 -12 3 -12 -17 -23 -15 8 19 13 1 -8
-18 -21 -25 -6 5 5 0 -3 -2 1 1 -2 -6 -7 -10 -14 -17 2 19 5 -4 5 6 -12 0 -15 -12 -2 -6 -10 -9 -17
-5 5 20 18 9 5 6 7 7 7 9 10 9 1 -8 3 35 53 25 14 21 24 5 -7 -2 6 30 35 25 16 2 -1
15 18 14 12 12 13 14 15 14 15 15 18 29 52 83 89 70 37 30 41 42 33 14 19 19 32 17 -9 -12 6 19 28
