89 -59 -18 -18 -17 -18 -21 -23 -22 -23 -25 -26 -26 -27 -26 -27 -29 -29 -30 -30 -26 -28 -37 -35 -30 -31 -32 -32 -32 -31 -34 -146
98 -117 -30 -34 -32 -32 -37 -41 -40 -39 -42 -44 -46 -50 -52 -51 -51 -52 -54 -55 -51 -50 -61 -63 -60 -61 -62 -64 -63 -61 -37 -173
92 -93 -11 -15 -13 -10 -16 -21 -20 -18 -18 -20 -20 -24 -27 -27 -26 -24 -27 -30 -27 -22 -25 -28 -28 -29 -31 -34 -34 -32 -18 -140
93 -96 -13 -18 -15 -13 -19 -21 -21 -19 -19 -21 -21 -24 -27 -29 -28 -27 -28 -31 -31 -30 -29 -28 -28 -28 -30 -34 -35 -34 -19 -139
92 -99 -15 -19 -17 -16 -21 -24 -22 -20 -21 -22 -21 -24 -27 -28 -29 -27 -27 -29 -30 -30 -31 -30 -31 -30 -30 -32 -34 -35 -20 -140
92 -103 -17 -22 -20 -19 -24 -25 -21 -19 -19 -20 -19 -22 -25 -24 -25 -27 -28 -33 -33 -30 -32 -34 -34 -33 -33 -35 -36 -36 -23 -142
92 -106 -21 -24 -23 -23 -27 -25 -28 -27 -16 -18 -20 -18 -18 -18 -15 -7 0 -21 -33 -17 -21 -34 -36 -34 -34 -35 -35 -36 -24 -144
93 -103 -19 -27 -28 -26 -28 -34 -70 -64 3 39 45 50 54 52 48 59 78 44 13 25 16 -21 -35 -35 -35 -35 -36 -36 -22 -145
89 -86 -7 -28 -31 -30 -27 -34 -129 -178 -103 -63 -63 -62 -54 -47 -49 -35 7 10 2 39 36 5 -10 -23 -34 -37 -38 -38 -24 -147
107 -42 0 -23 -33 -33 -27 -38 -166 -233 -152 -101 -98 -92 -85 -73 -71 -56 -17 -39 -56 8 54 53 58 44 -14 -36 -36 -34 -26 -143
138 41 50 -3 -37 -37 -32 -45 -155 -207 -112 -47 -34 -19 -14 -11 -18 -19 6 -25 -81 -51 -2 10 40 86 27 -21 -23 -21 -25 -123
83 69 126 78 -20 -35 -37 -38 -125 -179 -102 -50 -39 -19 -11 -3 -5 -13 0 -34 -106 -100 -57 -57 -22 59 22 -1 2 3 -12 -84
-2 -44 68 112 18 -40 -67 -40 -65 -119 -82 -46 -35 -16 -12 -4 -4 -2 13 -29 -82 -57 -42 -84 -54 24 -5 -22 3 15 -15 -73
-27 -136 -42 61 65 29 -39 -60 -37 -52 -60 -46 -32 -11 -10 -6 -11 -14 13 -2 -58 -34 -24 -117 -96 -30 -67 -109 -102 -86 -93 -144
23 -113 -78 -51 -32 -34 -70 -119 -104 -73 -40 -32 -30 -14 -10 -3 0 -10 10 11 -60 -51 -27 -89 -89 -44 -52 -117 -127 -102 -84 -144
48 -106 -75 -106 -124 -127 -102 -114 -131 -118 -45 -19 -23 -18 -17 -14 0 8 31 12 -45 -53 -58 -64 -40 9 58 -13 -84 -84 -50 -116
56 -89 -25 -25 -25 -23 -18 -44 -95 -109 -53 -20 -21 -26 -24 -25 -14 3 30 25 -14 -59 -73 -61 -26 33 60 -2 -75 -75 -53 -99
50 -91 -27 -30 -33 -31 -29 -44 -89 -98 -44 -4 -9 -42 -41 -23 -14 -6 16 31 -25 -63 -81 -76 -27 36 54 -10 -87 -85 -69 -97
47 -86 -25 -20 -18 -19 -21 -44 -96 -95 -37 1 9 -36 -54 -26 -9 -2 5 22 2 -18 -65 -95 -62 20 17 -60 -100 -76 -56 -97
47 -80 -24 -32 -36 -38 -45 -65 -109 -102 -36 -4 14 -16 -40 -22 -9 -12 1 10 0 1 -29 -51 -22 18 -24 -100 -101 -60 -40 -94
36 -101 -39 -36 -35 -28 -21 -28 -78 -93 -34 -2 11 5 -15 -12 -11 -21 -9 -15 -33 -11 -18 -41 -46 -13 -60 -103 -94 -58 -49 -98
50 -78 -18 -20 -22 -21 -22 -28 -61 -78 -37 -19 -10 -3 -7 4 10 -2 -7 -23 -11 19 26 -26 -58 -64 -90 -100 -61 -30 -39 -99
41 -75 -12 -15 -26 -32 -38 -49 -54 -56 -33 -27 -19 -25 -36 -20 -14 -5 9 -18 -14 29 41 -19 -60 -74 -100 -91 -54 -30 -40 -96
25 -93 -38 -34 -35 -38 -44 -57 -64 -69 -51 -23 4 6 -15 -9 -6 -16 -4 1 11 25 -14 -54 -58 -72 -91 -62 -33 -28 -46 -99
30 -86 -39 -34 -26 -26 -38 -68 -71 -55 -34 -26 0 25 20 21 33 25 21 26 18 -2 -45 -63 -58 -88 -87 -49 -24 -28 -43 -98
38 -73 -24 -27 -28 -27 -21 -14 -9 -13 -19 -26 -31 -29 -26 -18 -7 -5 0 0 -40 -49 -64 -45 -67 -96 -83 -24 19 -16 -43 -91
40 -71 -24 -30 -23 -22 -16 -17 -27 -32 -17 -11 -16 -32 -38 -28 -23 -7 9 -28 -57 -68 -48 -42 -72 -90 -78 -50 -18 -19 -40 -86
40 -64 -19 -20 -25 -34 -42 -40 -28 -22 -13 -3 5 -1 -17 -12 -6 -4 -28 -62 -77 -48 -39 -50 -87 -82 -37 -25 -49 -53 -52 -82
44 -37 -21 -32 -41 -36 -25 -14 -6 -10 -15 -14 -4 2 0 6 -10 -62 -69 -73 -56 -38 -36 -67 -89 -70 -18 -4 -36 -52 -46 -73
28 -33 -33 -35 -28 -8 0 -2 -4 -6 -9 -14 -13 -2 -3 -5 -36 -76 -85 -62 -43 -35 -47 -74 -69 -49 -28 -10 -37 -59 -41 -75
2 -34 -25 -19 -20 -12 -3 -4 -10 -10 -10 -11 -6 11 4 -27 -48 -69 -79 -74 -67 -67 -88 -100 -70 -56 -56 -37 -27 -43 -53 -81
19 18 31 31 29 29 34 34 33 31 33 33 31 37 36 28 37 66 80 83 86 84 63 46 54 69 51 43 51 57 66 32
