-110 -9 -28 -26 -28 -29 -28 -29 -28 -29 -29 -28 -29 -31 -28 -31 -31 -30 -30 -31 -26 -32 -37 -28 -31 -33 -30 -32 -30 -31 5 -145
-145 1 -5 -2 -1 -4 -4 -3 -2 -3 -3 -1 0 -4 0 -2 -1 -2 -2 -4 7 -3 -12 2 -3 -4 -1 -6 -2 -3 51 -186
-129 -8 -14 -11 -7 -12 -15 -12 -11 -11 -12 -9 -7 -13 -8 -11 -10 -12 -10 -13 0 -13 -18 -5 -13 -13 -13 -19 -11 -14 40 -192
-130 -8 -13 -12 -6 -12 -15 -12 -11 -9 -12 -9 -8 -14 -9 -11 -11 -11 -12 -13 -6 -12 -14 -11 -14 -12 -14 -20 -12 -15 41 -193
-131 -9 -14 -11 -5 -11 -14 -11 -8 -9 -10 -7 -6 -13 -9 -11 -10 -7 -12 -12 -8 -12 -12 -14 -14 -11 -15 -18 -11 -15 43 -194
-132 -11 -14 -11 -7 -12 -14 -10 -8 -13 -13 -14 -15 -22 -18 -19 -18 -18 -17 -19 -15 -13 -14 -16 -13 -11 -15 -14 -12 -13 42 -194
-134 -11 -15 -11 -9 -11 -14 -4 -20 -7 4 6 9 7 10 9 6 5 18 -15 -22 -3 -15 -21 -12 -11 -13 -13 -13 -14 41 -194
-136 -10 -15 -12 -10 -10 -12 8 -52 22 34 24 26 22 20 21 9 5 43 -18 -18 25 -12 -31 -12 -16 -15 -13 -14 -16 41 -195
-144 6 -18 -12 -11 -10 -8 16 -126 1 -15 -57 -57 -59 -57 -51 -70 -62 16 -66 -48 34 -23 -37 1 -15 -21 -15 -14 -15 41 -196
-137 24 -29 -17 -12 -10 -1 6 -196 2 -14 -75 -73 -72 -70 -58 -83 -70 7 -88 -68 42 -15 -24 25 1 -25 -18 -18 -16 33 -194
-80 30 -7 -17 -17 -11 -1 -1 -198 44 43 -28 -12 -9 -13 1 -35 -38 48 -52 -69 37 -32 -59 2 16 -47 -11 -18 -6 26 -172
-22 -39 43 -21 -29 -7 -25 10 -191 47 51 -37 0 -6 -13 6 -31 -39 49 -63 -110 31 -46 -73 -29 30 -90 16 -4 29 21 -124
-18 -130 47 -39 -44 0 -66 65 -166 56 51 -42 15 -12 -18 7 -32 -28 45 -63 -114 78 -23 -75 -19 70 -137 36 -31 25 -13 -110
-43 -130 44 -25 -43 39 -93 108 -154 43 31 -38 25 -10 -16 12 -30 -22 43 -47 -89 105 -45 -89 13 58 -157 5 -62 -4 -38 -125
-53 -66 23 -8 -50 -32 -137 53 -138 12 7 -24 21 -6 -19 7 -25 -34 42 -39 -82 74 -51 -105 41 10 -117 -34 -73 -37 -42 -136
-74 -37 -29 -36 -80 -99 -106 -8 -123 8 -15 -14 11 1 -17 -3 -7 -46 56 -32 -83 43 -38 -92 60 -10 -14 -49 -50 -15 26 -102
-87 -18 -20 -17 -16 -22 -13 -13 -108 52 0 -11 -1 -1 -14 -16 1 -51 61 -38 -47 14 -46 -33 42 -7 67 -72 -27 -3 54 -100
-94 -18 -9 -15 -11 -13 2 -3 -120 58 7 0 -6 -21 -14 -19 0 -44 46 -43 -26 -46 -44 -6 -14 10 53 -84 -67 -10 42 -110
-101 -17 -9 -11 -4 -6 6 -3 -128 58 -2 15 -3 -52 -10 -3 0 -30 29 -3 -36 -47 -19 -62 -32 38 4 -97 -81 20 22 -95
-92 -5 -4 -14 -14 -19 -17 -16 -143 61 -6 19 8 -63 -2 21 -3 -24 21 15 -91 -5 -35 -71 23 62 -26 -107 -44 33 6 -84
-97 -26 -20 -30 -22 -18 -9 3 -134 65 4 4 22 -55 -13 23 -9 -36 6 -34 -109 37 -77 -60 45 33 -58 -95 0 15 0 -88
-96 -15 -6 -13 -4 0 -2 4 -122 53 20 -20 21 -45 -24 22 -6 -49 10 -54 -59 59 -79 -25 14 -24 -60 -72 36 -3 10 -88
-99 -1 0 -9 -15 -11 -19 -11 -98 43 24 -34 26 -39 -37 8 -20 -42 27 -64 -8 44 -24 -13 -25 -19 -70 -27 35 -18 14 -83
-107 -9 -23 -20 -28 -15 -23 -26 -72 24 10 -30 56 -28 -19 21 -14 -17 24 -80 33 25 -6 -59 -16 -32 -60 19 8 -7 2 -81
-102 -5 -25 -12 -24 -12 -32 -39 -33 25 9 -10 57 -24 -6 29 5 -2 19 -73 36 24 -50 -40 -4 -68 -31 31 -15 -5 -3 -76
-92 0 -22 -6 -16 -4 -2 10 0 19 0 -13 25 -33 -24 -1 -5 -39 -15 -46 31 -41 -53 -9 -20 -86 12 19 4 -15 5 -75
-86 -7 -21 -3 1 0 -2 -19 -37 -4 -10 -20 7 -30 -23 -17 -13 -35 -8 -19 -22 -54 -16 -2 -58 -61 24 -11 22 -39 20 -75
-85 -6 -3 -6 -13 -32 -32 -32 -30 -11 -7 -10 17 -25 -6 5 -9 -2 14 -44 -36 -21 -7 -8 -90 -18 19 -20 0 -57 15 -74
-78 -6 -11 -34 -29 -27 -15 -10 -13 -9 1 0 16 -21 -6 17 -17 -2 -16 -59 -10 -17 -10 -37 -85 12 22 -19 -22 -22 27 -71
-83 -33 -24 -30 -15 -3 -5 -2 -4 -7 0 -2 5 -8 -7 11 -16 -39 -40 -31 -8 -15 -8 -68 -30 12 9 -15 -48 -15 34 -79
-71 -30 -8 -11 -8 5 0 -1 -3 -4 1 -6 -12 -21 -37 -30 -54 -44 -21 -8 -9 -7 -19 -71 29 -5 -8 15 -31 -8 27 -67
-23 0 2 1 2 13 12 4 4 6 12 2 1 12 1 -3 -7 -1 -10 7 0 0 -37 -43 48 -12 -15 21 -31 -10 12 -43
