25 81 59 60 61 62 63 65 65 66 67 68 68 69 70 71 71 72 73 72 73 73 78 76 72 74 74 75 75 74 74 135
3 -43 -45 -43 -44 -46 -45 -46 -47 -47 -47 -45 -45 -46 -46 -46 -47 -47 -48 -50 -46 -41 -42 -48 -50 -50 -50 -51 -53 -54 -37 3
1 12 9 10 10 10 11 10 8 8 8 9 9 8 8 7 5 4 6 6 7 2 -3 2 7 7 7 6 5 2 16 55
2 13 8 10 10 10 10 9 8 7 7 8 7 7 7 6 5 3 5 6 6 0 -2 1 4 3 3 2 1 0 14 54
2 13 9 9 9 9 8 7 6 7 7 8 7 7 5 5 3 5 6 8 9 8 7 4 0 0 -1 -3 -1 -1 14 54
3 14 9 10 10 9 7 6 6 11 14 14 14 13 13 11 12 15 13 9 9 8 5 3 2 1 0 -2 0 0 16 55
4 15 12 11 12 10 7 7 5 7 -4 -7 -8 -12 -16 -17 -14 -6 -3 -3 8 6 -3 1 4 3 2 3 3 2 18 58
6 19 10 10 11 9 8 10 2 -15 -64 -81 -86 -93 -97 -97 -94 -88 -80 -53 -25 -34 -23 5 8 3 2 3 3 3 18 57
5 13 0 12 10 11 11 21 3 -43 -107 -133 -131 -131 -129 -127 -121 -112 -96 -84 -84 -67 -33 -5 -1 -5 0 3 3 3 17 58
-7 -9 -2 13 10 11 12 24 -16 -31 -53 -46 -32 -33 -32 -29 -28 -25 -18 -47 -54 -41 -52 -71 -60 -33 -4 6 5 4 19 59
-38 -42 3 0 10 11 14 24 -25 -27 -31 -20 -9 -17 -10 -1 -4 -9 -12 -22 -20 -37 -96 -113 -89 -63 -35 0 -10 -13 5 44
-57 -67 -53 -44 8 14 16 24 -33 -27 -25 -23 -20 -30 -18 -6 -5 -8 -4 -11 -30 -31 -62 -42 -30 -65 -65 -46 -66 -62 -42 -4
-35 -77 -99 -69 -5 12 1 -11 -89 -58 -30 -20 -8 -11 -7 -6 -10 -4 4 -8 -24 -10 -2 24 -19 -50 -62 -97 -115 -104 -93 -51
-23 -50 -36 -34 -57 -47 -70 -83 -151 -105 -50 -27 -15 -17 -18 -14 -24 -31 -21 -31 -29 5 36 4 -6 -16 -71 -76 -96 -72 -50 -11
18 24 19 -21 -96 -105 -143 -90 -97 -85 -45 -31 -27 -28 -29 -20 -27 -29 -15 -28 0 44 21 -1 19 17 -17 1 43 62 61 75
29 63 56 10 -14 -26 -41 2 3 -13 -48 -50 -26 -18 -24 -24 -29 -23 -7 5 27 13 -19 -23 -13 31 33 84 107 67 27 30
16 40 30 27 34 35 34 42 -8 -11 -47 -41 -25 -17 -14 -18 -25 -35 -21 4 -33 -25 -3 -61 -52 -30 -35 13 -5 -29 -55 -15
-5 -14 -28 -26 -29 -32 -29 -20 -51 -40 -36 -17 -19 -6 0 -13 -20 -29 -7 -37 -50 5 -52 -79 -52 -81 -58 -25 -48 -62 -50 5
-14 -20 -25 -26 -26 -30 -29 -24 -52 -37 -38 -17 -5 9 -2 -25 -28 -23 -21 -43 -9 -48 -97 -58 -28 -59 -27 -2 -38 -56 -35 9
-18 -30 -30 -35 -33 -25 -13 -4 -31 -27 -35 -17 -10 -26 -30 -32 -30 -25 -23 -30 -71 -117 -83 -20 -24 -41 37 1 -49 -59 -29 11
-20 -14 -3 4 9 7 1 1 -34 -26 -35 -31 -30 -57 -52 -34 -22 -18 -25 -50 -70 -60 -31 -40 -57 43 67 -29 -41 -42 -12 15
1 18 -2 -15 -24 -36 -49 -45 -58 -40 -44 -41 -38 -66 -63 -39 -28 -32 -44 -45 -23 2 -5 -36 54 101 5 -51 -39 -20 0 21
-17 -39 -54 -53 -53 -47 -41 -27 -57 -63 -47 -21 -30 -44 -30 -33 -38 -45 -35 -27 -22 -29 -60 27 111 26 -25 -43 -44 -23 -13 23
-29 -44 -45 -36 -28 -20 -21 -25 -70 -58 -21 -25 -30 -18 -15 -20 -26 -34 -26 -29 -39 -83 -16 90 11 -20 -32 -47 -33 -11 -7 21
-22 -15 -16 -15 -18 -16 -21 -37 -41 -16 -26 -53 -36 -37 -55 -48 -46 -41 -24 -74 -105 -18 118 24 -36 -25 -52 -50 -22 -13 -2 20
-19 -12 -12 -12 -22 -32 -46 -48 -51 -64 -72 -38 -24 -49 -58 -50 -49 -51 -59 -100 -30 124 38 -45 -10 -31 -59 -47 -31 -28 -8 13
-17 -12 -24 -29 -43 -67 -88 -100 -106 -82 -43 -21 -11 -10 -1 -12 -7 -8 -49 1 144 64 -42 -22 -9 -48 -60 -62 -47 -26 -9 8
-20 -20 -40 -62 -84 -91 -82 -65 -46 -28 -19 -20 -5 3 7 6 2 -29 4 124 76 -31 -20 -5 -35 -61 -51 -18 14 -5 -21 4
-30 -56 -81 -92 -79 -57 -35 -23 -22 -21 -18 -19 -15 -14 -4 -3 -34 3 120 81 -17 -18 -8 -10 -48 -64 -40 -1 15 -12 -28 -1
-49 -91 -82 -58 -37 -22 -21 -22 -16 -11 -11 -10 -3 -15 -32 -36 32 141 95 -9 -15 -7 -13 -24 -61 -57 -12 -6 -33 -42 -31 -2
-44 -54 -34 -17 -17 -20 -18 -10 -7 -10 -6 1 11 4 15 74 137 78 0 -7 -1 -8 -10 -43 -51 -26 5 -19 -44 -33 -21 17
-18 -21 -20 -25 -26 -23 -18 -17 -19 -21 -18 -15 -18 0 49 73 15 -45 -37 -23 -25 -31 -48 -80 -55 -27 -47 -58 -70 -61 -40 -33
