3 -125 -42 -43 -42 -43 -45 -46 -45 -45 -45 -47 -47 -47 -47 -48 -48 -48 -49 -50 -48 -49 -56 -54 -50 -52 -53 -53 -54 -53 -42 -106
-29 -143 -62 -64 -63 -65 -67 -68 -67 -67 -68 -70 -71 -70 -70 -71 -71 -72 -72 -71 -70 -76 -81 -74 -71 -74 -75 -75 -74 -72 -52 -119
-25 -103 -19 -21 -20 -21 -23 -23 -22 -22 -23 -25 -26 -26 -26 -25 -27 -25 -25 -25 -27 -31 -29 -24 -26 -27 -28 -29 -27 -24 -13 -79
-26 -106 -21 -22 -21 -22 -25 -24 -22 -23 -23 -26 -28 -29 -28 -27 -27 -25 -26 -29 -28 -26 -24 -23 -25 -26 -28 -28 -24 -22 -11 -78
-27 -109 -23 -23 -22 -24 -25 -24 -22 -22 -24 -26 -28 -28 -28 -27 -25 -26 -29 -31 -29 -27 -25 -24 -24 -23 -24 -23 -20 -19 -10 -78
-30 -112 -24 -24 -24 -26 -26 -24 -23 -25 -24 -23 -23 -23 -23 -22 -21 -24 -25 -25 -29 -27 -23 -24 -23 -22 -21 -21 -20 -21 -11 -79
-32 -116 -26 -27 -27 -27 -27 -22 -30 -39 -25 -26 -30 -29 -26 -25 -26 -32 -20 -22 -35 -20 -11 -22 -26 -24 -23 -24 -25 -24 -13 -80
-35 -118 -24 -27 -28 -28 -26 -24 -50 -46 -1 3 2 7 9 9 7 8 11 -18 -26 5 1 -27 -28 -21 -25 -26 -26 -25 -13 -81
-40 -114 -19 -31 -29 -30 -26 -39 -63 -22 37 35 28 30 28 25 23 22 11 -13 -1 26 -3 -36 -21 -12 -20 -25 -25 -25 -13 -81
-37 -79 -19 -31 -29 -29 -29 -44 -49 -1 46 27 14 20 17 11 5 0 -1 -2 -3 9 -4 -11 2 2 -17 -27 -26 -22 -14 -81
-14 -59 -30 -28 -32 -31 -33 -48 -57 -28 18 -6 -15 -1 -5 -12 -18 -14 1 -18 -25 12 30 30 10 6 -23 -35 -19 -10 -15 -70
9 -51 -17 -12 -38 -34 -47 -60 -54 -28 9 -5 -6 2 -9 -14 -19 -9 2 -22 -31 35 44 3 0 14 -40 -32 1 4 -7 -43
16 0 6 -33 -68 -44 -56 -44 -17 4 20 4 4 5 -8 -7 -13 -9 -2 -29 -28 42 10 -42 6 4 -30 3 42 35 21 -20
19 14 9 -53 -70 -59 -17 25 21 25 30 8 9 6 -5 -5 -8 -4 -2 -24 -13 8 -33 -62 0 1 5 30 35 3 -7 -56
-15 -49 -9 -14 -11 -20 41 47 -5 -9 11 12 21 11 0 -3 -1 2 6 -9 -26 -21 -41 -65 3 -15 -2 11 -28 -52 -63 -86
-43 -113 -39 -11 -3 -14 3 -2 -46 -33 11 24 23 9 0 -1 1 5 16 -28 -61 -19 -44 -45 18 -15 -16 -50 -106 -102 -66 -55
-51 -125 -43 -30 -28 -30 -36 -40 -66 -22 31 25 14 -2 -10 -5 3 14 6 -37 -27 -25 -56 0 16 15 -4 -58 -103 -61 -4 -21
-42 -95 -19 -15 -15 -14 -14 -22 -39 4 37 17 8 -12 -24 -2 14 19 1 -4 -19 -54 -13 25 33 44 6 -52 -72 6 30 -18
-31 -74 1 0 -1 1 -2 -11 -31 5 40 17 -3 -30 -26 12 20 17 8 -3 -56 -18 45 39 49 61 -2 -78 -56 22 25 -20
-31 -67 2 2 2 1 -5 -18 -39 0 40 15 -9 -31 -12 28 22 2 -5 -12 -10 53 41 2 64 51 -47 -97 -29 32 13 -26
-22 -69 -4 -6 -9 -12 -17 -23 -29 5 36 19 -1 -8 14 33 13 -12 0 12 36 58 0 8 67 -16 -93 -87 7 31 0 -30
-38 -89 -15 -15 -12 -5 0 -6 -14 20 52 31 20 22 18 21 5 1 40 33 40 26 -4 22 -11 -76 -92 -44 30 14 -12 -31
-41 -74 4 9 13 14 11 -16 -6 45 56 23 38 29 8 22 16 19 37 17 34 34 22 -44 -92 -78 -70 -3 34 5 -15 -31
-22 -47 19 13 6 3 -6 -14 21 45 20 13 31 1 -4 18 18 15 4 3 51 79 -12 -93 -76 -59 -37 28 28 -6 -14 -29
-22 -51 4 -4 -5 -7 -5 3 10 10 10 29 23 -3 3 20 12 4 9 48 100 20 -101 -84 -39 -41 -4 38 17 -9 -14 -27
-25 -62 -7 -13 -12 -13 -7 -3 8 35 48 41 32 26 22 30 26 20 46 96 32 -89 -92 -41 -27 -33 18 29 11 -12 -16 -22
-26 -66 -12 -18 -11 4 27 43 55 54 41 27 27 22 17 30 26 25 67 23 -100 -96 -49 -11 -37 -21 40 44 9 -24 -19 -16
-29 -70 -11 5 34 58 65 55 40 30 21 18 8 -3 0 14 16 36 5 -96 -107 -53 -13 -18 -41 10 54 29 -15 -32 -14 -10
-35 -41 33 59 66 57 38 23 15 11 15 17 6 0 3 16 29 -9 -94 -103 -61 -19 -4 -34 -23 41 40 -8 -41 -35 0 -5
-4 21 69 58 36 25 17 12 9 8 11 7 1 13 32 28 -26 -111 -111 -62 -23 -7 -16 -40 18 63 16 -20 -25 -9 22 -2
24 31 38 17 6 8 10 1 0 2 2 -7 -4 26 31 -29 -105 -114 -80 -40 -22 -26 -45 -25 36 24 -21 -27 -16 1 4 -12
21 29 21 16 20 24 20 16 16 20 16 12 26 39 8 -37 -24 1 25 40 41 36 37 71 72 35 29 46 49 48 28 28
