-3 -38 -3 -4 -4 -2 -1 -2 -1 0 1 1 2 2 1 3 3 4 4 4 3 5 5 6 6 7 6 7 8 9 40 60
-28 -95 -14 -17 -19 -16 -14 -13 -13 -12 -10 -12 -12 -10 -11 -11 -9 -9 -7 -6 -11 -13 -8 -3 -4 -6 -6 -5 -5 -3 56 112
-18 -105 -8 -11 -12 -10 -7 -6 -5 -5 -5 -6 -6 -5 -4 -4 -5 -2 0 0 -7 -7 -2 0 0 0 0 0 1 2 64 103
-18 -106 -7 -9 -10 -9 -6 -4 -4 -4 -5 -6 -7 -5 -4 -4 -4 -3 -1 0 -3 -3 -4 -3 -2 -2 -1 1 4 3 64 102
-19 -109 -6 -8 -9 -7 -5 -3 -4 -3 -4 -6 -7 -6 -4 -2 -1 -2 -3 0 0 -2 -4 -3 -2 -2 -1 1 4 3 64 102
-18 -110 -6 -7 -8 -7 -4 -3 -5 -10 -10 -12 -14 -12 -11 -9 -9 -7 -3 0 0 -3 -1 0 -1 -2 -1 0 2 4 65 103
-19 -112 -5 -6 -7 -5 -1 1 -11 -27 -21 -21 -23 -22 -18 -16 -18 -23 -14 -7 -10 -6 1 4 0 -1 0 0 1 3 66 103
-23 -117 -4 -4 -5 -3 0 5 -2 -12 -10 -28 -37 -40 -43 -43 -45 -51 -57 -58 -36 -18 -17 -8 -1 2 1 1 1 2 66 104
-30 -126 -6 -6 -3 -2 0 11 43 46 15 -32 -50 -57 -68 -74 -70 -85 -115 -113 -78 -71 -74 -44 -13 2 5 2 1 1 65 104
-57 -134 -23 -11 0 -2 -1 26 101 82 39 -13 -36 -35 -44 -54 -56 -79 -98 -83 -84 -96 -94 -67 -51 -34 -9 0 0 0 63 106
-98 -175 -71 -26 0 0 -2 34 122 87 54 8 -13 -11 -23 -32 -33 -45 -56 -52 -42 -40 -61 -79 -114 -108 -60 -24 -6 -3 61 111
-110 -224 -147 -81 -23 0 -11 22 127 93 60 22 -1 -8 -29 -38 -36 -42 -56 -29 7 13 -20 -85 -126 -127 -111 -53 -16 -13 55 108
-62 -167 -185 -203 -114 -22 -5 28 119 102 64 35 5 -7 -29 -39 -39 -52 -53 -9 31 16 -5 -39 -59 -95 -99 -44 -30 -34 43 72
1 -73 -147 -230 -176 -49 30 50 68 62 47 33 6 -7 -27 -41 -40 -52 -57 -16 33 -8 -15 11 -8 -49 -37 0 -12 -50 6 21
17 -45 -54 -109 -114 -55 34 20 26 -1 13 25 11 -5 -25 -40 -39 -48 -55 -32 -8 -25 0 33 20 -23 -23 -4 -17 -51 6 39
10 -52 -13 -9 -26 -32 -14 -10 25 6 18 20 7 -7 -20 -33 -38 -53 -63 -60 -40 -2 15 39 12 -34 -51 -19 -3 1 60 94
-8 -69 -1 5 3 -3 -7 20 59 50 35 6 1 -4 -17 -27 -33 -51 -86 -90 -22 6 19 47 -19 -60 -99 -72 -8 47 89 95
-18 -85 -17 -16 -15 -15 -10 24 79 63 28 -6 -7 -1 -11 -15 -19 -44 -89 -84 -46 -13 62 46 -18 -75 -131 -85 3 62 76 75
-18 -83 -11 -10 -10 -8 -4 29 74 53 22 -17 -29 -8 6 4 -12 -35 -63 -91 -88 24 81 50 -8 -66 -114 -82 4 43 63 70
-13 -78 -8 -8 -13 -16 -11 21 69 50 20 -31 -47 -11 21 14 -8 -31 -64 -86 -45 23 17 14 7 -52 -90 -57 34 33 53 62
-8 -77 -17 -17 -18 -18 -9 28 82 52 22 -23 -40 -13 14 2 -15 -23 -27 -34 -23 -41 -46 14 5 -66 -76 -4 51 22 41 56
-15 -86 -17 -13 -10 -6 0 21 69 51 34 -1 -18 -7 -8 -19 -22 -8 3 -17 -39 -69 -42 0 -33 -59 -30 44 37 11 41 60
-20 -82 -12 -6 1 0 -5 8 59 56 29 0 -5 -7 -20 -20 -17 -16 -27 -21 -35 -45 -42 -62 -55 -19 23 57 19 5 38 61
-8 -68 -8 -12 -9 -10 -6 19 66 38 19 9 -11 -23 -13 -12 -16 -24 -32 -22 -15 -29 -84 -105 -41 17 53 49 9 -2 38 60
-4 -65 -9 -16 -17 -18 2 38 52 28 37 25 -20 -31 -14 -15 -25 -33 -28 -2 -16 -67 -111 -69 -6 31 58 17 -5 -5 43 63
-7 -67 -9 -16 -17 -10 12 29 41 50 44 13 -7 -10 -18 -27 -33 -41 -25 -16 -68 -116 -86 -21 10 51 51 -2 -25 -14 42 65
-11 -74 -14 -12 -2 8 14 20 32 18 4 -4 -2 1 -9 -14 -26 -34 -23 -48 -99 -77 -33 -10 17 63 43 11 -32 -38 30 64
-19 -72 -2 13 26 25 12 -2 -7 -10 -3 -3 -7 -2 0 -4 -14 -7 -37 -87 -71 -32 -18 -2 37 65 23 -6 -33 -30 31 63
-26 -46 25 26 13 -3 -14 -16 -11 -2 1 -3 -12 -10 -13 -10 -2 -23 -79 -72 -34 -18 -13 10 64 48 -2 -33 -23 4 52 62
-12 -18 15 -1 -13 -17 -15 -7 -4 -1 0 -4 -14 -14 -9 -8 -34 -67 -57 -28 -16 -10 -3 27 71 25 -32 -53 -10 25 59 55
-10 -38 -22 -20 -14 -11 -15 -15 -9 -6 -6 -10 -16 -21 -34 -65 -94 -72 -32 -20 -24 -16 5 46 26 -11 -30 -31 -7 10 45 61
-6 -33 -14 -3 0 -1 -7 -6 -2 0 -3 -3 2 -4 -29 -55 -38 -15 -5 -5 -4 2 30 41 -3 -12 -4 1 0 -7 17 43
