-28 -128 -89 -89 -90 -92 -92 -91 -92 -93 -93 -93 -93 -93 -93 -94 -94 -94 -96 -98 -95 -88 -90 -97 -98 -99 -98 -100 -101 -100 -106 -101
-73 -29 -24 -25 -25 -23 -22 -24 -25 -25 -24 -23 -22 -22 -22 -23 -22 -23 -22 -20 -17 -21 -31 -24 -20 -19 -18 -18 -17 -18 0 31
-2 -25 -7 -7 -6 -6 -7 -7 -7 -8 -8 -9 -9 -9 -8 -8 -8 -10 -9 -7 -12 -19 -13 -6 -8 -6 -5 -7 -8 -8 -5 -11
-3 -28 -8 -8 -8 -8 -8 -8 -8 -8 -7 -7 -6 -7 -7 -7 -6 -4 -4 -7 -6 -3 1 -2 -10 -10 -10 -12 -8 -8 -3 -9
-3 -28 -9 -9 -8 -9 -10 -10 -10 -9 -8 -9 -9 -9 -8 -9 -9 -8 -7 -4 -3 -5 -8 -10 -8 -7 -9 -9 -8 -9 -3 -10
-3 -27 -6 -6 -5 -8 -8 -5 2 8 11 14 17 16 16 16 18 16 7 0 0 -3 -7 -7 -6 -6 -6 -5 -5 -6 -2 -8
-1 -25 -6 -5 -7 -7 -8 4 14 -6 -33 -46 -58 -67 -69 -68 -71 -80 -57 -19 -13 -23 -19 -10 -8 -7 -7 -6 -6 -5 -1 -9
-1 -28 -8 -7 -8 -8 -5 6 -36 -113 -136 -129 -127 -119 -111 -105 -100 -86 -43 -49 -78 -47 -4 0 -4 -8 -8 -6 -6 -7 -3 -10
-8 -38 -12 -6 -4 -3 0 -6 -38 -13 44 76 81 82 81 82 80 81 66 12 16 43 7 -38 -35 -19 -9 -6 -7 -7 0 -9
-14 -20 2 -8 -7 -6 -6 -6 -5 33 39 46 43 38 36 36 29 17 10 14 17 -47 -104 -99 -61 -27 -13 -4 -2 0 4 -10
-22 -42 -46 -26 -10 -4 -2 0 0 11 -7 -11 -21 -18 -11 -7 -10 -13 3 -20 -52 -40 -6 36 31 -3 -21 -22 -26 -22 -18 -31
16 -62 -89 -33 -22 2 10 1 -12 7 -7 -8 4 13 9 5 2 12 19 -8 -2 29 64 53 0 12 -25 -78 -82 -75 -59 -44
10 -25 67 54 0 6 -51 -97 -63 -21 -20 -15 7 5 -5 -2 -7 -13 -18 -30 -22 30 18 -25 -19 -4 -79 -60 -42 -38 -18 -3
35 39 62 -33 -103 -131 -143 -49 -1 18 5 -8 -5 -14 -12 -6 -19 -22 -23 -35 4 49 -5 -14 11 -12 -32 35 51 77 77 54
15 2 -6 -51 -28 15 46 92 59 55 -15 -22 1 2 -1 -8 -10 -9 2 23 38 7 -27 -16 0 27 49 104 104 96 46 -2
0 -9 13 42 79 94 109 71 5 -4 -24 -4 5 0 -1 -5 -7 -15 13 15 -38 -25 -13 -29 3 -14 1 3 -37 -81 -104 -53
-14 -52 -43 -36 -38 -34 -42 -46 -52 -32 -1 14 0 0 3 -1 -3 0 9 -69 -43 19 -50 -42 -32 -87 -44 -81 -98 -74 -8 14
-18 -35 -7 0 2 -2 -12 -16 -16 9 -6 -4 13 15 3 -10 0 -2 -4 3 53 -35 -70 -7 -27 14 32 -22 0 17 27 -5
4 -15 -16 -33 -42 -40 -27 -8 0 12 -4 19 15 -18 -23 -9 -4 -6 2 -7 -101 -111 24 36 20 38 14 -24 -23 2 0 -10
-19 -44 -14 10 32 47 51 38 1 10 0 -7 -29 -43 -30 -9 0 0 -17 -69 -70 43 37 -46 -17 44 -1 -42 -12 15 0 -3
31 41 52 35 14 -16 -43 -49 -36 2 -21 -27 -30 -28 -6 9 0 -23 -25 1 37 67 -20 -4 86 25 -56 -49 11 30 6 0
5 -46 -52 -63 -68 -51 -18 9 0 -8 -16 -3 -13 -4 10 -8 -27 -21 20 11 -12 -19 -24 54 35 -44 -56 -18 13 -9 -15 -1
-28 -50 -26 -11 13 28 26 -6 -47 -9 15 0 17 35 26 17 13 16 20 -30 -22 -13 14 15 -60 -59 -32 -5 15 -3 -1 -5
8 10 22 19 13 5 -18 -35 16 72 4 -34 0 -19 -37 -23 -14 -4 -24 -70 -29 42 43 -38 -52 -27 -37 -4 1 -3 2 1
11 -1 4 7 10 3 -1 23 18 -53 -69 -7 0 -47 -38 -29 -37 -58 -64 -24 68 49 -62 -83 -5 -18 -7 28 2 -5 -10 -4
7 -6 0 0 -19 -55 -82 -100 -111 -45 24 21 6 20 47 34 27 26 36 84 78 -51 -86 0 1 -33 -11 -31 -36 -7 -8 -3
8 -8 -16 -52 -89 -81 -38 19 70 74 29 7 17 16 13 11 9 9 45 38 -63 -100 -12 10 -33 -30 2 13 36 3 -12 -3
-3 -51 -81 -79 -27 34 66 58 24 -5 -11 -4 -7 -21 -16 -12 -22 5 25 -65 -93 -20 4 -12 -39 -9 26 31 26 1 0 -3
-47 -85 -33 33 62 49 18 -5 -5 2 0 -4 -10 -16 -18 -22 14 41 -33 -81 -19 7 0 -18 -25 19 30 0 -47 -53 -18 -7
-20 17 63 48 14 -8 -8 0 0 -3 -1 0 -5 -19 -6 37 41 -39 -83 -34 -1 -9 -13 -45 -14 41 18 -15 -13 -1 2 4
36 53 21 -6 -9 -1 3 0 -4 -3 0 -2 -4 33 79 47 -65 -106 -52 -20 -20 -26 -48 -47 25 6 -60 -77 -64 -29 1 -16
5 -8 -12 -10 -4 -1 -7 -12 -11 -9 -11 -18 -8 -16 -84 -156 -134 -54 -33 -38 -42 -43 -33 16 16 -50 -41 12 36 24 -23 -39
