-7 -51 -10 -8 -8 -12 -11 -9 -10 -12 -11 -11 -11 -11 -11 -14 -13 -12 -12 -14 -14 -20 -13 -8 -14 -15 -14 -14 -16 -16 -48 -153
1 18 1 1 2 1 0 2 3 0 0 0 0 0 3 2 0 -1 1 1 5 1 -8 -1 4 2 1 2 5 4 5 -7
-8 14 0 -1 1 0 -1 -1 0 1 0 0 -1 -3 -3 0 1 0 -4 -1 -1 4 0 -8 -3 -2 -3 -3 -2 -2 -21 -22
-9 11 0 -1 -1 0 -1 -1 -3 -1 0 -1 0 0 -2 -3 -1 1 0 -3 -6 -1 7 3 -1 -1 -3 -4 -2 -1 -19 -19
-8 12 -1 0 -2 -1 0 -1 -1 -3 0 0 -1 0 0 -2 0 0 -1 -3 -4 -4 -4 0 0 0 0 0 -4 -1 -20 -18
-9 13 -1 0 0 0 -1 -1 -2 -6 -9 -6 -7 -8 -6 -6 -11 -5 1 2 -1 -3 -2 -2 -2 -2 -1 0 -1 -2 -20 -18
-10 12 0 -1 -1 0 0 -4 -13 -9 -17 -20 -13 -16 -22 -15 -14 -17 -32 -35 0 -1 -13 -3 0 -4 -3 -2 -1 -3 -21 -20
-10 5 -4 1 -1 -1 -4 -6 -1 31 18 5 7 15 14 7 11 21 22 -19 -15 -4 -26 -18 -1 0 0 -1 0 -1 -21 -19
-5 13 -19 -2 -1 0 -1 -13 -35 5 39 45 45 50 55 50 40 49 65 54 15 19 14 -10 -21 -15 0 1 -2 -1 -21 -19
-22 1 -1 0 0 0 0 -10 -37 -33 -17 -21 -20 -19 -12 -1 -8 -9 -11 -2 38 46 21 17 1 -45 -24 1 -2 -6 -21 -18
35 -40 -13 -37 5 0 0 -7 -24 -16 0 -1 1 -9 -14 -11 -3 -1 11 -10 -32 21 40 30 78 43 -43 -18 -9 -10 -28 -8
64 78 30 -58 -25 0 -12 -14 -33 -6 -5 2 14 12 12 3 -6 -15 -2 16 -12 -20 2 13 8 62 21 15 -17 9 -27 -8
-7 63 107 39 -59 -26 5 46 -53 -17 -10 -11 -4 -3 3 5 10 3 -23 -9 0 -15 -34 12 -3 12 21 32 30 20 12 5
-40 1 40 119 38 -31 -61 37 53 -40 -8 8 3 0 -8 0 -4 19 22 -8 -8 18 -20 -30 21 11 17 4 42 31 3 23
-36 -14 -42 40 91 68 11 -38 77 47 -23 -14 -3 14 4 3 -1 -19 17 16 0 10 18 -51 -30 -30 -4 -41 -4 10 2 -4
-31 -14 -57 -56 -6 25 48 -16 -26 53 28 -6 -9 -1 4 4 24 -2 -17 6 2 -40 12 28 -33 -18 10 -55 -34 -24 -28 -43
-5 6 -7 -27 -37 -39 -20 -21 -54 -30 14 14 -1 2 0 -6 11 26 21 -2 -2 -34 -12 26 35 0 12 1 -43 -28 -3 1
-7 11 -2 0 6 12 13 5 -11 -11 2 5 -20 -4 21 -1 -12 0 11 3 5 6 -4 1 16 37 19 29 2 10 -9 2
-19 12 15 9 -2 -4 -1 -3 -10 -2 -1 18 3 -36 -9 14 -2 -3 -9 37 -4 -22 -44 -9 14 14 17 27 0 -5 -17 -6
7 1 -15 -3 6 3 5 13 0 8 -2 4 21 -18 -26 0 0 11 -1 -1 37 41 10 -21 -45 -13 -3 14 20 11 -8 -17
-23 21 14 1 3 5 -7 -17 -36 -10 13 -13 23 19 -15 -7 -2 -7 7 -11 0 45 6 11 0 0 -5 -15 -4 -4 12 -8
-17 -9 -13 -8 -15 -13 -1 11 -7 -18 1 3 11 29 21 6 -1 -25 -13 19 5 -13 2 -33 -15 -13 3 9 10 -17 -23 -9
0 10 -1 1 9 11 2 16 14 -16 -20 -15 -11 -9 18 11 22 26 -24 -34 39 16 35 -7 -38 -35 -17 2 4 19 -11 -12
-9 18 17 11 -3 0 2 -9 -7 0 20 4 -3 -26 -20 -11 -33 -2 32 -13 -32 -15 13 39 -1 -21 -2 2 -16 0 -10 -4
-9 -4 -8 6 0 -14 -20 -10 18 5 -34 -4 30 32 -10 11 18 -28 -13 10 -7 -8 -15 -11 -6 -8 4 0 7 -1 -8 -19
-4 10 -8 -14 0 10 19 1 -32 -18 -7 -22 -32 18 22 -4 27 19 -12 -5 -2 8 2 -12 -8 -4 19 20 -10 -34 1 -15
-11 2 -1 2 2 -1 4 15 26 20 6 -12 -35 -37 -7 -17 -26 -7 -26 -17 -24 -22 0 0 -14 1 -24 21 62 12 -20 -7
-19 5 8 -6 1 1 8 12 -4 -19 -7 1 -5 -27 -37 -15 -27 -26 -17 -19 -14 -8 -11 -3 -4 18 -3 -52 -19 44 0 -9
-3 -8 0 1 5 4 -9 -9 -1 -6 -15 -7 1 4 -19 -32 -32 -25 -2 -9 -12 -1 -5 -9 5 8 37 15 -37 -22 -1 -13
8 -5 4 6 -6 -3 -6 -7 -3 -8 -16 -20 -14 2 -7 -16 -25 -35 -27 3 -7 -8 -2 -5 3 -23 9 5 -5 5 3 -3
-15 4 -6 -8 -6 -2 0 -11 -10 -5 -7 -15 -27 -42 -62 -48 -33 -52 -53 -30 -19 -16 -11 2 5 -16 -15 28 -21 -42 -23 6
13 1 2 -1 -6 -7 0 3 -4 -5 -1 -2 0 15 10 -36 -20 13 2 -6 -3 -2 -14 -10 12 15 -41 -6 55 33 9 -16
