15 -52 -7 -8 -6 -6 -7 -6 -6 -7 -7 -6 -5 -4 -3 -3 -4 -6 -6 -7 -1 -3 -6 -4 -2 -3 -5 -4 -4 -4 18 -50
-4 -40 -11 -14 -12 -9 -11 -12 -11 -10 -12 -12 -11 -9 -7 -5 -5 -7 -10 -9 -9 -1 -3 -8 -2 -1 -3 -3 -3 -3 -1 56
3 -9 -1 -4 -4 0 -1 -2 -6 -3 -3 -6 -3 0 -1 0 0 3 -2 -2 -9 0 11 1 2 5 5 4 1 2 -21 43
4 -10 -2 -2 -6 -1 -1 -3 -5 -6 -3 -5 -3 1 0 0 0 2 0 0 -4 -2 7 5 4 5 4 6 1 2 -21 45
5 -8 -2 -2 -6 -4 -2 -4 -4 -6 -4 -2 -1 3 3 2 1 2 5 3 0 3 2 3 3 2 4 6 1 1 -22 45
5 -5 0 -1 -6 -4 -2 -3 -4 0 -1 0 4 7 5 8 6 3 6 6 5 5 4 3 3 1 3 5 4 1 -22 44
7 -5 1 0 -5 -3 0 5 0 7 15 15 18 26 22 21 21 19 21 11 2 9 6 1 3 3 4 4 6 4 -22 45
10 -3 -1 0 0 0 5 5 -8 -17 0 -2 -10 -5 -3 -7 -5 -2 8 20 -6 4 15 0 -2 5 6 6 6 7 -19 47
10 4 1 -1 1 2 9 1 6 -44 -8 13 6 10 13 21 17 10 -2 50 22 0 31 16 3 4 4 7 6 9 -16 48
37 -9 15 -5 3 3 8 2 44 -28 2 26 22 23 20 24 35 18 -3 34 12 -12 23 12 14 15 -5 3 8 11 -17 51
71 2 18 -6 -2 2 4 5 51 -26 -10 12 7 11 7 0 19 3 -15 36 -8 -54 12 4 -11 47 13 -1 8 19 -22 59
5 26 19 23 -23 2 2 14 50 -21 -16 9 0 9 9 3 22 10 -31 37 23 -38 7 30 -21 10 47 -3 11 11 -15 61
-41 12 -19 90 12 -3 -9 13 82 -27 -20 17 -4 7 3 -2 15 19 -21 26 37 -11 0 5 -3 -46 51 -36 14 -19 -11 52
-32 10 -67 62 59 6 12 -83 115 -11 -28 14 -6 12 4 -6 8 -1 -10 37 42 -25 35 -7 -13 -51 51 -44 20 5 15 49
-14 22 -72 -40 21 16 78 -87 54 41 2 9 -9 8 14 -6 25 -2 -24 47 47 -52 56 41 -25 -36 65 -3 9 0 10 36
1 14 -3 -30 7 21 85 14 -7 -2 33 21 -3 -2 14 -5 15 30 -22 25 52 -34 6 79 -10 -17 46 21 -12 -15 2 43
10 6 22 17 14 12 24 26 18 -41 7 26 4 0 15 3 -4 28 -19 25 52 -9 -6 30 -13 -3 -7 55 -9 -6 -10 59
6 8 15 17 10 14 15 24 48 -24 -5 21 17 -9 4 21 0 17 -32 50 22 14 13 0 -17 -3 -11 52 14 8 -16 57
9 6 14 18 14 12 10 24 42 -19 1 2 31 7 -17 17 9 23 -31 37 27 37 16 -7 -3 -16 1 36 32 3 -2 42
12 14 10 13 19 20 16 25 47 -22 16 -16 18 44 -6 -3 12 13 -9 -1 27 26 27 22 -14 -25 -6 12 26 0 11 36
3 13 22 21 13 15 14 23 53 -41 15 -6 -6 54 18 -8 15 5 0 20 25 -3 49 27 -8 -24 5 18 18 -9 9 43
12 6 6 15 10 7 9 22 55 -30 -4 4 -18 33 32 0 15 23 -9 18 49 -29 66 15 -30 -24 -1 30 9 8 -7 42
9 9 10 14 14 14 13 0 49 -8 -4 5 -10 16 21 2 6 33 7 1 18 -23 41 29 -5 -12 3 21 -10 20 2 41
10 8 15 21 19 12 10 4 36 -7 -5 19 -2 28 7 5 11 0 2 47 -10 -14 -5 18 15 1 16 12 0 4 8 39
17 9 10 10 22 11 17 16 15 10 -4 3 -27 31 9 -13 20 5 -22 33 -9 -8 -9 8 14 17 15 0 16 -5 17 36
14 11 21 5 9 4 15 17 13 -2 5 7 -34 4 28 -4 2 33 -4 23 -21 -13 12 18 14 24 -7 1 27 -1 6 42
13 10 19 4 3 0 1 9 23 1 11 22 1 -2 7 14 -8 17 5 0 -24 -5 10 28 13 29 -9 -13 9 41 -3 46
19 -2 10 6 6 9 9 16 22 5 4 11 5 17 -6 -1 -6 -15 -8 -6 -8 11 17 15 25 11 25 8 -40 25 12 43
27 0 6 14 7 19 11 7 15 11 0 0 -6 23 8 -8 -1 -22 -17 9 2 18 24 4 33 -4 10 34 -4 -4 10 45
32 20 8 19 10 12 14 3 8 10 6 1 -11 7 5 -3 4 -13 -20 14 16 16 15 15 33 3 -15 20 24 3 1 46
27 29 19 18 16 7 16 13 9 13 13 12 9 18 11 -20 7 23 22 30 39 38 29 47 27 34 -19 24 62 28 -8 50
13 9 -1 -1 -1 -11 -8 -1 -3 -5 -8 -5 -11 -14 -8 -18 -21 -9 -4 -18 -15 -12 -5 -5 -37 8 -15 -47 11 7 -22 48
