-149 -131 -105 -107 -109 -109 -107 -107 -108 -108 -108 -108 -108 -109 -112 -112 -110 -110 -111 -111 -115 -111 -107 -113 -117 -117 -116 -117 -118 -119 -117 -15
-28 -102 -51 -51 -52 -53 -52 -51 -53 -54 -55 -54 -53 -51 -52 -55 -56 -55 -53 -53 -57 -62 -60 -55 -55 -56 -55 -53 -55 -57 -105 -62
-12 -41 -10 -9 -10 -11 -10 -9 -9 -11 -12 -13 -12 -11 -10 -9 -11 -13 -13 -10 -11 -14 -20 -19 -14 -14 -13 -12 -13 -13 -57 -20
-13 -42 -11 -10 -10 -10 -10 -10 -10 -10 -11 -11 -11 -11 -11 -10 -9 -9 -11 -9 -6 -4 -7 -14 -15 -17 -17 -16 -15 -13 -57 -21
-11 -42 -10 -10 -11 -10 -10 -11 -11 -10 -10 -11 -11 -10 -11 -11 -9 -11 -12 -11 -11 -10 -8 -10 -11 -14 -15 -15 -15 -12 -55 -20
-11 -40 -8 -9 -9 -9 -9 -10 -10 -11 -8 -5 -5 -3 -4 -5 -3 0 0 0 -7 -10 -10 -8 -9 -9 -9 -10 -12 -11 -54 -19
-13 -40 -9 -9 -9 -9 -9 -13 -22 -38 -49 -51 -54 -61 -61 -60 -63 -65 -57 -22 -14 -25 -14 -6 -10 -11 -10 -10 -11 -12 -55 -19
-17 -46 -7 -7 -9 -9 -8 -12 -20 -56 -72 -69 -63 -62 -64 -59 -51 -55 -79 -65 -50 -56 -37 -15 -11 -10 -11 -13 -13 -14 -56 -20
-19 -62 -13 -7 -7 -8 -10 -9 23 33 50 62 61 61 56 49 51 35 8 3 -11 -36 -47 -53 -45 -19 -6 -10 -12 -13 -57 -19
-40 -56 -10 -4 -5 -7 -11 -18 17 7 10 27 24 24 24 20 17 7 -6 27 15 -40 -56 -69 -90 -60 -17 -10 -15 -16 -60 -22
-70 -97 -54 -17 1 -4 -9 -19 11 -15 -15 -7 -18 -22 -18 -14 -3 -7 -28 -7 17 16 20 21 -19 -78 -51 -41 -37 -43 -81 -35
2 -74 -117 -66 -7 -14 -24 -52 -8 -21 -9 14 2 -4 -9 -18 -12 -4 -5 11 16 6 40 36 19 -30 -42 -74 -62 -67 -96 -44
62 51 -45 -83 -52 -36 -26 -96 -58 -46 -27 -2 -11 -8 -10 -19 -21 -34 -43 -15 -11 -38 14 30 1 -17 -7 -27 -14 -13 -26 -15
58 63 9 -48 -109 -114 -37 -23 -20 -47 -13 0 -18 -18 -18 -21 -9 -11 -43 -29 -8 -38 -7 28 15 23 52 45 65 39 30 30
0 24 52 75 43 16 24 30 59 -35 -37 -6 -2 -1 -12 -21 -18 -4 -18 -19 1 -29 -31 -20 -11 12 25 39 60 46 -1 15
-42 -39 10 46 65 56 34 -2 52 10 -20 -14 -5 2 2 -7 -20 -31 -52 -29 -25 -27 -14 -46 -67 -64 -89 -84 -50 -51 -88 -34
-46 -88 -66 -69 -65 -60 -49 -55 -14 -5 3 -4 -1 1 0 1 0 -10 -53 -37 -38 -32 -24 -16 -67 -79 -91 -81 -69 -43 -46 -14
-12 -49 -24 -18 -17 -19 -27 -35 -5 -17 -10 -16 -7 16 2 -10 -8 2 -15 -25 -19 -36 0 4 0 -27 -26 -7 -17 -11 -36 -2
-2 -29 -16 -24 -26 -19 -17 -16 10 -16 -5 -21 -35 -9 1 -6 -15 -9 -26 -37 -68 -51 -10 32 6 -26 0 -4 -19 -18 -32 3
0 -30 -1 9 9 10 10 2 23 -14 -9 -15 -38 -37 -17 -5 -3 -6 -21 -1 1 -31 -30 -24 -22 -24 11 7 -4 -17 -32 -2
22 0 4 -1 -10 -25 -38 -49 -5 -14 -11 -8 -15 -23 -22 -11 -4 0 -4 3 27 -6 6 9 -18 -14 -18 -11 -11 -1 -17 0
-30 -62 -39 -40 -34 -20 -12 -28 -9 -16 7 14 8 9 -10 -24 -21 -14 -8 0 -22 -34 -24 -18 -11 1 -12 -11 -32 -26 -28 1
-8 -46 -18 -4 2 0 -2 -16 -8 -17 4 20 13 34 29 17 16 -4 -28 13 5 -34 -50 -67 -49 -26 -10 -8 -12 -11 -36 -3
24 -3 10 -2 -6 -6 -3 -2 14 9 6 0 -29 -20 -9 -15 -1 13 -20 -12 -15 -20 0 -21 -44 -32 -18 -25 -20 -7 -23 3
4 -20 4 -1 -11 -18 -12 -6 -8 -28 0 25 8 -11 -15 -15 -29 -18 9 18 -35 -44 -31 -28 -20 -9 -12 -21 -15 -10 -31 1
0 -33 -19 -19 -22 -39 -60 -70 -39 -7 12 34 54 70 50 47 50 48 38 14 -16 -18 -36 -25 -19 -5 -16 -44 -45 -22 -33 -5
-3 -36 -25 -31 -29 -12 11 32 39 25 9 0 4 35 41 31 39 28 -16 -30 -40 -34 -22 -24 -17 -11 2 27 -1 -22 -37 -4
-16 -43 -28 -14 9 30 37 26 13 11 10 -4 -26 -20 0 17 17 -9 -49 -46 -47 -29 -20 -13 -7 -17 -39 -7 29 19 -31 2
-19 -34 8 29 32 21 14 14 12 10 16 17 2 -9 -9 -1 -7 -18 -28 -40 -29 -14 -14 -15 -1 -13 -32 -43 -39 -15 -38 -5
20 11 31 25 16 9 6 10 8 4 6 17 29 33 16 -32 -53 -46 -32 -25 -25 -15 -19 -19 -19 -12 -2 -16 -12 -4 -22 6
27 10 6 6 7 4 -3 -5 -1 -4 -13 -11 -8 -18 -38 -62 -91 -99 -69 -44 -40 -42 -35 -20 -39 -40 -24 -49 -62 -43 -57 -3
12 10 8 5 6 8 5 0 0 1 -3 -8 -17 -56 -106 -105 -71 -53 -42 -33 -29 -27 -18 2 -20 -23 -1 28 17 -9 -41 -44
