-116 85 -7 -4 -6 -5 -4 -4 -5 -5 -6 -7 -7 -6 -5 -6 -4 -5 -6 -6 -7 -6 -1 -3 -8 -5 -4 -6 -6 -7 -12 44
-119 149 21 27 24 24 27 27 26 26 27 27 26 27 29 27 29 32 31 30 29 23 33 34 27 30 33 32 32 29 20 14
-142 117 2 10 6 5 9 10 9 7 9 10 6 7 11 8 9 10 13 9 10 0 5 14 5 8 9 8 10 6 13 13
-145 118 3 9 7 3 9 11 10 9 9 11 7 7 10 8 9 10 12 11 11 5 5 8 4 4 5 5 9 5 12 12
-146 120 5 10 7 5 9 12 9 9 9 10 8 8 11 10 10 11 12 12 10 5 6 5 4 3 4 4 8 5 13 11
-148 121 7 12 9 7 11 14 11 13 15 13 10 11 13 10 12 11 10 7 9 6 5 4 4 4 4 5 7 7 13 12
-150 122 7 13 11 8 12 12 7 -3 -37 -53 -57 -61 -57 -57 -55 -52 -42 -25 -1 -4 -8 6 7 3 4 6 6 7 14 12
-151 124 5 12 12 10 12 0 -9 -14 -90 -99 -83 -85 -81 -76 -69 -60 -62 -54 -6 -15 -19 15 15 0 3 5 5 5 15 13
-149 119 -1 17 13 10 7 1 -7 23 -72 -73 -42 -44 -45 -44 -35 -28 -33 -58 6 -8 -50 -13 -5 -15 2 4 4 3 14 14
-149 104 -17 22 11 8 4 1 -13 63 -36 -47 -11 -17 -16 -20 -20 -9 -15 -55 -3 -32 -96 -46 -39 -35 0 12 2 2 10 13
-160 51 -51 -1 11 8 4 6 -5 86 -19 -36 6 -2 -1 -1 -13 1 -7 -51 11 -8 -90 -30 -17 -55 -22 12 -22 -23 -10 1
-115 -14 -76 -52 21 21 0 4 -23 69 -24 -32 15 -2 -1 0 -11 3 8 -39 16 24 -71 -18 8 -70 -65 -12 -76 -65 -47 -6
-67 -10 -22 -86 12 1 -31 -44 -90 56 -34 -32 20 -6 0 -1 -16 -4 4 -31 23 38 -39 4 14 -55 -90 6 -101 -49 -44 12
-48 4 17 -105 -62 -37 -56 -12 -121 69 -18 -25 20 -11 4 0 -16 -1 -8 -32 27 45 -43 26 25 -48 -78 47 -68 -14 -16 38
-56 33 36 -45 -54 -23 -45 60 -75 53 -10 -13 17 -11 1 6 -19 5 0 -39 15 53 -57 24 47 -43 -56 53 -6 17 1 27
-77 63 14 -9 -39 -19 -30 39 -23 32 -36 -9 10 -4 -3 7 -15 -10 11 -45 -3 43 -35 -6 30 -30 -36 24 23 10 -18 -4
-100 78 1 7 7 8 1 15 -9 39 -39 -14 3 0 -3 2 -1 -19 -4 -49 -4 36 -17 -21 -11 -64 -39 -36 44 8 -15 -10
-101 81 4 1 0 -6 -6 2 -13 42 -28 -15 0 10 -1 -10 -1 -17 7 -53 -5 -2 -31 -15 -11 -44 -26 -37 46 1 -12 -10
-109 71 -12 -17 -11 -11 -4 2 -10 46 -24 -4 -13 5 13 -19 -11 -17 5 -76 -42 -31 -22 -18 -4 -35 -41 -34 30 1 -26 4
-110 72 -3 -4 -3 -5 0 2 -17 43 -35 0 -22 -17 22 -13 -17 -13 -14 -52 -51 -5 -26 0 21 -30 -29 -14 30 -6 -28 21
-99 72 -6 -6 -4 -15 -16 -6 -27 46 -45 -8 -13 -36 11 -7 -29 -16 -22 -55 -30 5 -32 17 16 -22 -25 3 23 -16 -20 20
-113 65 -19 -24 -15 -17 -14 -6 -30 35 -41 -24 -4 -37 6 3 -24 -20 -15 -53 -19 17 -48 24 12 -15 -11 6 10 -26 1 18
-103 71 -15 -14 -8 -9 -13 -6 -31 21 -22 -15 0 -29 4 0 -18 -21 -13 -34 -4 1 -53 6 10 7 -7 4 -4 -33 9 17
-97 74 -16 -13 -9 -6 -11 0 -12 23 -17 -18 -5 -40 -3 -17 -29 -18 -32 -54 22 -28 -22 -7 13 5 -7 -2 -19 -13 6 19
-98 73 -6 -1 -10 0 -11 -12 -20 -12 -22 -10 6 -41 5 -3 -32 -14 -3 -28 20 -29 -10 1 8 -5 -3 -13 -38 -2 -1 22
-91 75 -3 4 -21 -27 -45 -42 -28 -12 -12 0 18 -18 6 12 -7 -10 12 -19 3 -25 -8 6 1 -15 4 -32 -35 5 6 15
-89 67 -17 -23 -42 -45 -38 -28 -15 8 0 1 8 -2 6 -2 4 -7 0 -23 -3 -11 0 -5 -9 -18 0 -34 -20 -18 25 10
-98 42 -43 -43 -42 -35 -19 -11 -2 14 8 5 6 -2 21 7 9 1 -14 -18 3 -7 -1 -9 -20 0 -23 -21 17 -28 13 5
-107 25 -42 -35 -17 -13 1 6 5 11 14 8 10 -3 24 20 -2 0 -15 -13 9 -12 -9 -10 -26 8 -28 -30 14 0 -2 1
-90 27 -16 -10 4 4 5 9 8 10 14 8 12 6 19 9 -15 -7 2 -9 0 -13 -13 -20 -18 -3 -11 -20 -4 10 -8 0
-81 2 -28 -25 -20 -18 -26 -19 -17 -16 -17 -22 -16 -21 -22 -40 -76 -79 -77 -95 -102 -105 -95 -93 -68 -90 -60 -86 -87 -48 -57 -27
-49 9 -3 0 2 5 -1 -2 2 5 4 0 5 0 -21 -11 -2 0 0 4 -4 -1 4 10 27 -24 16 17 -18 10 12 24
