0 53 0 -2 -1 0 0 0 0 0 0 -1 -1 0 -2 0 0 -1 0 1 -5 -5 6 0 -2 0 -2 1 0 -1 2 57
18 8 -12 -15 -15 -13 -13 -13 -14 -14 -15 -16 -16 -13 -19 -14 -16 -14 -15 -15 -27 -13 -5 -24 -17 -17 -19 -13 -17 -17 -6 0
18 21 4 1 -1 2 3 2 1 1 0 0 0 3 -1 1 0 1 0 1 -4 7 2 -10 3 0 -2 5 -2 0 17 9
17 22 4 1 -2 2 4 0 0 0 0 0 0 3 -1 1 1 -2 0 3 -2 1 -2 -2 4 -1 0 5 -5 0 15 10
16 25 4 1 -3 3 5 0 -1 0 0 -1 0 3 -2 1 0 -3 2 2 -2 0 -1 1 1 -2 2 1 -4 1 16 11
17 25 4 0 -2 4 3 0 -5 2 1 -2 0 2 -1 0 0 1 1 0 -1 0 -1 0 0 -1 1 0 0 1 16 11
17 25 5 -2 1 2 3 -9 -4 8 -4 -5 0 0 -3 -4 0 10 -15 -6 14 -3 -10 1 0 0 0 0 0 1 15 11
18 26 1 -1 1 1 1 -20 52 12 -17 -5 -3 -6 -8 -8 0 1 -62 19 32 -39 -16 19 0 -2 0 0 0 1 15 10
29 11 -1 4 0 0 -3 -6 120 -38 -39 0 -8 -6 -10 -11 5 -11 -65 53 7 -73 21 40 -10 -7 0 0 0 0 14 11
35 -27 16 7 0 0 -6 9 124 -95 -43 9 0 -3 -9 -13 11 -1 -52 37 9 -47 40 19 -43 -8 9 5 1 -2 14 12
-3 -34 40 -5 3 -1 -6 14 114 -107 -34 25 1 -10 -5 -13 14 7 -72 43 60 -45 8 -11 -34 -11 24 14 0 -12 23 4
-44 29 -22 -17 19 0 2 17 103 -106 -35 38 -17 -17 0 -14 14 1 -71 67 70 -89 -27 23 16 -79 82 2 -3 -23 38 -18
-26 72 -139 8 54 -8 66 -32 84 -102 -29 42 -37 -3 4 -19 16 -2 -51 67 53 -142 13 73 -17 -108 146 -47 9 -33 44 -30
-11 45 -144 37 61 2 103 -138 97 -97 -13 44 -41 5 0 -22 22 -2 -39 47 15 -139 87 68 -61 -58 139 -98 14 -35 55 1
-8 22 -58 32 28 7 47 -147 123 -78 16 23 -37 1 0 -15 13 8 -45 11 19 -61 62 65 -88 -23 71 -108 34 -14 68 5
-10 24 0 -7 -4 0 -12 -44 116 -53 10 -9 -21 0 2 -6 -3 23 -76 11 71 -53 44 50 -125 33 -44 -26 53 19 24 -34
-4 35 4 -13 -12 -3 -14 13 88 -63 -12 -10 -8 -2 4 3 -12 17 -88 66 17 -43 97 -31 -63 32 -116 70 59 13 -48 -16
10 23 -8 -1 -3 0 -11 12 71 -84 -4 -12 -16 13 12 1 -21 10 -56 35 -30 79 29 -52 10 -57 -82 104 58 -34 -42 18
15 12 -2 3 1 -1 -7 8 77 -85 1 -30 -11 49 8 -19 -19 6 -42 -9 68 49 -73 14 6 -120 -12 122 43 -75 2 12
23 9 -5 -2 -6 -5 -1 8 92 -93 0 -24 -1 57 -6 -35 -8 8 -21 12 84 -92 -30 95 -79 -127 68 124 -10 -82 32 1
11 3 -6 3 0 6 6 5 78 -94 4 -10 -7 42 -20 -36 8 35 -21 3 37 -132 88 31 -160 -16 109 83 -79 -48 46 -4
8 20 -2 10 3 -1 -7 -11 72 -75 -11 10 -10 15 -15 -20 16 33 -60 21 18 -80 90 -91 -60 62 77 20 -102 7 31 -5
29 8 -6 2 -4 -11 -6 18 70 -88 -22 47 -40 5 12 -19 13 7 -58 78 -8 -48 -28 -47 58 34 50 -35 -75 29 13 -1
34 -11 -1 0 1 -8 16 32 10 -80 26 34 -80 36 18 -30 9 -8 -16 97 -62 -102 -23 79 29 21 36 -77 -24 16 20 -3
26 -12 7 -4 3 -3 20 1 -2 -8 23 -12 -60 52 0 -30 3 9 15 42 -163 -65 98 56 -27 55 -9 -83 22 -3 30 -12
17 -7 10 -8 10 12 12 2 14 -21 -17 -9 -19 24 -10 -9 -4 28 -2 -73 -132 91 78 -29 1 74 -61 -32 1 2 28 -14
12 0 14 11 18 7 -8 -13 -9 -29 1 0 -20 17 0 -7 1 25 -81 -91 37 86 -19 -33 65 31 -82 -10 -36 43 16 -9
16 21 21 9 -9 -17 -25 -10 1 -2 2 -9 -25 25 -3 -14 14 -55 -103 41 66 -5 -29 6 88 -38 -79 -1 -10 57 -4 -9
45 21 -11 -17 -23 -12 -5 5 3 1 -6 -10 -14 22 0 -15 -40 -86 13 79 -9 -19 -11 45 56 -94 -52 17 36 24 -18 -8
53 -24 -31 -7 0 0 0 0 2 2 -8 -7 3 18 -17 -69 -57 21 58 8 -31 -3 4 75 -31 -92 2 28 34 -3 -25 2
22 -44 -4 10 5 -10 -7 0 2 -3 -12 0 8 -22 -67 -54 24 39 5 -24 -13 4 31 43 -106 -11 42 2 15 -18 -12 14
2 -23 3 -2 -7 -16 -8 -1 -5 -11 -14 -2 -22 -56 -46 9 23 -3 -5 -13 5 6 26 -21 -70 48 21 -32 4 -19 12 -4
