0 0 0 0 0 0 0 0 
0 0 0 0 0 0 0 0 
0 0 0 0 0 0 0 0 
0 0 0 0 0 0 0 0 
0 0 501 1402 2240 0 0 0 
0 0 519 1196 782 0 0 0 
0 0 0 0 0 0 0 0 
167 0 0 0 0 0 0 13 
