0 0 0 0 0 0 0 0 
0 0 0 0 0 0 0 0 
0 0 1809 0 0 0 0 0 
7 409 920 0 0 378 0 0 
0 0 551 0 0 0 0 0 
0 0 100 0 0 0 0 0 
0 0 0 0 0 0 0 0 
0 0 0 0 0 0 0 0 
