0 0 0 0 0 0 0 0 
0 0 0 137 277 0 0 0 
0 0 1709 1805 3416 24 930 74 
0 1364 3319 0 1133 0 825 1428 
0 0 2208 0 0 0 0 0 
0 0 0 0 0 0 0 0 
0 94 0 0 0 0 0 0 
0 0 0 0 0 0 0 0 
