0 0 0 0 0 0 0 0 
0 0 0 0 0 0 0 0 
0 0 1617 2135 692 324 0 0 
0 1485 1950 1850 0 0 54 0 
0 0 0 0 0 0 0 675 
0 0 0 0 0 0 0 0 
0 0 0 0 0 0 0 0 
0 46 0 0 0 0 0 0 
