0 0 0 0 0 0 0 0 
0 0 0 0 0 0 0 0 
0 0 0 0 0 0 0 0 
0 0 0 0 0 0 0 0 
0 0 0 0 0 0 0 0 
0 0 6 652 554 0 0 0 
0 0 492 874 0 0 0 0 
0 0 861 23 0 0 0 0 
