0 0 0 0 0 0 0 0 
0 0 0 0 0 0 0 0 
0 0 0 0 0 0 0 0 
0 0 0 0 0 0 0 0 
346 0 0 0 0 0 0 0 
1651 1328 0 0 0 0 0 0 
576 976 0 0 0 0 0 0 
49 0 0 608 33 0 0 0 
