643 1266 584 223 723 1312 1013 753 
0 0 0 0 0 0 0 0 
0 0 0 0 815 0 0 0 
0 0 436 0 0 0 0 0 
0 0 0 0 0 0 268 0 
0 0 0 0 0 140 0 0 
0 0 0 0 191 0 0 0 
0 0 0 0 0 0 0 0 
