0 0 271 189 0 0 0 0 
145 0 0 541 329 0 0 150 
0 0 0 0 0 0 0 227 
0 0 0 0 0 0 0 20 
1035 0 0 0 0 0 0 0 
1012 0 0 0 0 0 0 0 
0 0 0 0 0 0 0 0 
0 0 0 0 0 0 0 0 
