334 0 0 0 0 0 0 0 
1265 0 0 0 0 0 1138 867 
83 0 0 168 0 0 0 11 
0 0 0 111 0 0 0 0 
0 0 0 0 0 0 0 0 
0 0 0 0 0 0 0 0 
0 0 0 0 0 0 0 0 
0 157 41 188 0 0 0 366 
