0 0 0 0 0 0 0 417 
0 0 0 0 285 0 0 0 
0 0 0 0 407 0 0 0 
0 0 0 0 0 0 0 0 
0 0 0 0 0 0 0 0 
0 0 0 0 0 180 0 0 
0 0 0 0 1016 343 0 0 
290 20 0 7 499 0 0 0 
