0 0 0 0 0 0 0 0 
0 2440 1602 995 1239 0 0 2360 
0 573 0 116 979 0 0 0 
0 1016 0 0 0 561 0 0 
0 0 0 0 499 2842 1327 0 
0 0 0 754 2423 1339 0 0 
217 0 335 1840 407 0 0 0 
0 0 0 0 0 0 0 0 
