0 0 0 0 0 0 0 0 
79 0 0 0 0 0 0 0 
273 0 0 0 0 0 396 459 
411 0 0 0 0 0 0 0 
1899 1683 0 0 0 0 0 0 
153 1140 0 0 0 0 0 0 
0 0 0 0 0 0 0 0 
0 0 329 611 0 0 0 0 
