0 0 0 0 0 0 0 0 
0 0 1045 0 0 0 0 0 
291 985 3207 1488 613 885 0 345 
0 0 1410 0 0 0 0 0 
0 0 0 0 0 0 0 0 
0 0 0 0 0 0 0 0 
0 0 0 0 0 0 0 0 
0 0 0 378 0 0 0 0 
