0 0 1210 481 559 33 0 0 
0 0 0 0 0 0 0 0 
0 0 0 0 0 0 0 0 
0 0 65 0 0 71 0 0 
0 0 0 215 0 0 0 0 
0 0 0 0 0 0 0 0 
0 0 0 0 0 0 0 0 
0 612 660 9 0 0 0 0 
