0 0 0 0 0 0 0 0 
707 893 689 1787 1342 1727 1970 172 
0 411 1091 2084 1973 446 1331 246 
0 136 156 1100 1929 0 288 341 
1442 1751 0 0 0 0 0 446 
180 0 0 0 0 0 0 0 
0 0 0 0 0 0 0 0 
0 22 0 0 0 0 0 0 
