0 0 0 0 0 0 0 0 
0 0 0 0 0 0 0 0 
0 0 0 0 0 0 0 0 
0 0 0 0 0 0 0 0 
0 0 0 728 0 0 0 0 
0 0 0 0 0 0 0 64 
0 144 0 0 0 0 0 303 
19 655 174 290 377 0 0 0 
