0 0 0 0 0 0 0 0 
1107 0 0 0 0 0 629 0 
0 0 989 0 0 0 0 0 
0 24 1431 1192 141 0 0 0 
0 0 0 0 0 0 0 0 
0 0 0 0 0 0 0 0 
294 0 0 0 0 0 0 0 
293 0 209 47 0 0 90 260 
