0 0 0 0 0 0 0 0 
0 0 0 0 0 0 0 0 
0 0 47 0 242 658 0 0 
0 0 480 0 0 574 1201 0 
0 0 580 0 0 0 0 0 
0 0 0 0 0 0 0 0 
0 0 0 0 0 0 0 0 
0 0 0 0 0 0 0 0 
