781 0 312 219 167 14 175 0 
1490 0 257 751 274 341 0 0 
716 0 0 0 0 0 158 0 
0 0 0 0 0 0 0 0 
0 0 0 0 0 0 0 0 
0 0 0 0 0 0 0 0 
181 0 0 0 0 0 0 93 
0 0 0 0 0 0 186 1420 
