0 0 0 0 0 0 0 0 
0 0 0 0 0 0 0 0 
0 0 0 0 0 0 0 0 
0 0 0 0 0 0 0 0 
0 0 0 0 832 0 0 0 
0 0 0 1188 564 0 0 0 
0 86 919 1965 393 0 0 0 
0 0 406 1100 0 0 0 0 
