553 0 0 0 0 0 0 0 
0 0 0 0 0 0 0 0 
0 0 0 0 0 0 0 0 
0 0 0 0 0 0 0 0 
0 0 0 0 0 0 119 0 
0 0 0 0 0 1915 308 0 
0 205 0 0 743 0 0 0 
317 678 0 494 0 0 0 0 
