0 0 0 0 0 0 0 0 
0 0 0 0 0 0 0 0 
0 0 569 304 0 0 0 0 
0 0 728 770 0 0 0 0 
0 88 549 292 0 0 0 0 
0 0 0 0 0 0 502 888 
0 0 0 0 0 0 0 487 
0 0 0 0 0 0 0 0 
