0 0 0 0 0 0 0 0 
0 0 0 0 0 0 0 0 
0 0 0 0 0 0 0 0 
0 0 0 0 0 0 0 0 
0 0 0 0 0 0 262 0 
573 0 0 0 0 197 1119 0 
0 0 0 0 0 757 6 0 
0 878 179 0 0 444 0 0 
