0 0 0 0 0 0 0 0 
0 0 0 0 0 0 0 0 
1031 0 0 0 0 0 0 0 
1261 56 0 0 0 0 0 0 
82 772 0 0 300 0 0 0 
0 501 14 0 576 510 0 0 
0 0 0 0 1379 1384 0 0 
0 0 0 609 0 51 11 0 
