0 0 0 0 206 525 0 0 
1087 0 0 0 0 1217 1453 0 
0 0 0 0 0 0 700 0 
0 0 0 0 0 0 294 0 
163 0 0 0 0 0 0 0 
0 0 0 0 0 0 0 0 
24 0 0 0 0 0 0 0 
66 264 795 448 0 0 0 0 
