11 20 0 0 0 0 0 0 
0 0 0 0 0 0 0 0 
0 0 0 0 0 0 0 0 
0 0 0 0 806 0 0 0 
148 0 0 729 1507 2356 0 0 
0 0 0 8 122 0 0 0 
0 0 0 0 0 0 0 0 
0 0 0 0 0 0 0 0 
