221 0 0 0 0 0 0 0 
18 0 0 0 0 0 0 0 
0 0 0 0 0 0 0 0 
0 0 0 0 0 0 197 751 
0 0 0 0 0 0 109 1560 
0 0 0 0 0 0 0 498 
0 0 0 0 0 0 0 299 
276 0 0 0 0 0 0 200 
