0 0 0 0 0 0 16 0 
0 0 0 0 0 0 128 229 
0 0 175 1556 0 0 413 913 
0 0 0 0 0 0 572 831 
0 0 0 0 0 0 0 0 
0 0 0 0 0 0 0 0 
0 0 0 0 0 0 0 0 
0 0 0 0 0 0 0 0 
