0 0 0 0 0 0 0 0 
0 0 0 0 0 0 0 0 
0 0 0 0 252 0 0 339 
0 0 0 0 309 0 0 0 
0 0 0 0 0 0 0 0 
626 950 0 0 0 0 0 0 
0 747 0 0 0 0 0 0 
0 169 0 0 0 0 0 0 
