0 0 0 0 0 0 0 0 
75 0 891 0 0 0 0 0 
0 0 44 0 0 0 0 0 
0 0 0 94 0 0 0 0 
426 0 0 0 0 0 0 0 
962 0 0 0 0 0 0 0 
733 0 0 0 0 0 0 0 
0 0 0 0 0 0 0 0 
