0 14 14 15 15 15 15 15 15 15 15 15 16 16 17 16 16 16 16 16 17 17 16 17 17 17 18 17 17 18 18 0
0 0 0 0 0 0 0 0 0 0 0 0 0 0 0 0 0 0 0 0 0 0 0 1 1 1 1 1 2 3 3 0
0 0 0 0 0 0 0 0 0 0 0 0 0 0 0 0 0 0 0 0 0 1 2 3 2 2 2 2 3 3 4 0
0 0 0 0 0 0 0 0 0 0 0 0 0 0 0 0 0 0 0 0 0 1 3 4 3 4 4 4 5 4 4 0
0 0 0 0 0 0 0 0 0 0 0 0 0 0 1 1 1 1 0 0 1 2 3 3 4 5 5 6 6 5 4 0
0 0 0 0 0 0 0 0 0 0 0 0 0 0 0 0 0 0 0 0 2 3 3 3 4 4 5 5 5 4 4 0
0 0 0 0 0 0 0 0 0 0 0 0 0 0 0 1 1 1 4 1 1 5 5 3 4 4 4 4 4 4 4 0
0 0 0 0 0 0 0 0 0 0 0 0 1 3 4 4 3 6 16 4 3 14 7 3 5 5 5 5 5 5 5 0
0 0 0 0 0 0 0 0 0 0 0 0 0 0 1 1 0 5 12 2 9 18 7 5 9 7 6 6 6 6 6 0
0 5 0 0 0 0 1 0 0 10 7 0 3 4 4 5 3 7 14 3 6 16 4 8 19 10 6 6 7 7 7 0
0 8 0 0 1 1 2 0 0 15 11 3 7 9 9 10 7 10 22 7 0 11 5 5 14 16 5 8 9 11 7 0
0 0 18 5 2 4 4 3 0 18 16 6 11 11 11 14 13 15 22 6 2 16 6 0 0 16 0 13 12 15 5 0
0 0 25 8 0 6 0 17 0 23 20 9 15 12 13 17 14 19 22 8 8 30 0 0 2 10 0 14 9 13 1 0
0 0 12 0 1 9 0 24 1 24 18 11 16 12 13 17 12 17 23 12 15 30 0 0 7 5 0 12 2 6 0 0
0 4 0 0 0 6 6 18 0 22 14 12 15 12 13 17 16 15 23 17 14 20 7 0 17 7 3 11 0 0 0 0
0 11 5 1 3 5 16 13 0 17 16 15 13 10 11 14 18 16 27 15 8 20 8 10 29 13 30 11 3 0 3 0
0 14 15 16 16 16 17 12 0 18 16 14 12 11 11 13 16 16 29 6 17 17 5 21 25 23 33 4 4 5 16 0
0 15 16 15 15 15 16 11 2 22 15 15 13 9 13 15 18 16 22 13 19 6 14 23 18 30 23 0 5 19 21 0
0 14 15 15 15 15 15 12 3 22 14 18 16 6 12 18 18 16 18 19 8 17 27 15 21 32 12 0 8 24 16 0
0 14 14 14 15 15 14 12 0 24 14 15 14 6 14 19 15 13 17 11 8 36 24 11 31 28 0 0 14 24 14 0
0 13 14 14 14 14 15 15 4 24 16 13 13 9 16 18 13 10 22 19 16 36 6 16 33 13 0 2 23 18 12 0
0 14 15 14 13 13 14 16 8 24 18 11 13 12 16 17 13 15 31 26 25 27 8 24 16 0 0 12 29 15 12 0
0 15 15 14 15 15 16 13 8 24 14 5 13 6 8 12 9 17 29 15 26 23 24 17 4 3 5 20 23 14 14 0
0 14 14 15 15 17 14 11 13 16 4 2 15 2 6 13 8 11 18 10 28 29 14 2 9 8 10 27 18 15 13 0
0 15 11 12 14 17 15 14 12 9 3 4 8 1 7 11 10 8 10 13 37 22 0 5 14 6 17 26 14 16 13 0
0 15 11 11 12 14 15 14 9 10 7 5 2 0 4 4 6 4 9 22 23 0 1 15 13 5 23 22 19 13 14 0
0 14 12 12 11 10 10 8 7 9 6 5 6 0 2 5 4 6 20 17 0 0 14 18 8 13 22 13 20 11 15 0
0 12 12 12 13 9 8 5 4 4 4 5 7 2 3 4 2 15 20 0 0 13 19 15 4 23 27 15 10 8 15 0
0 11 13 10 9 7 4 2 2 2 2 2 4 3 5 7 10 12 4 0 13 18 18 11 10 28 25 17 10 12 17 0
0 12 12 7 4 4 3 2 2 2 2 1 1 3 8 16 12 1 0 12 20 17 16 7 24 27 18 13 11 15 19 0
0 8 5 2 1 3 3 2 1 2 3 2 3 8 10 9 3 4 12 19 19 17 12 12 33 18 10 16 15 18 19 0
0 0 0 1 2 2 2 2 2 2 2 2 5 12 14 11 15 25 29 30 28 29 26 32 35 22 19 22 21 25 26 14
