0 0 0 0 0 0 0 0 0 0 0 0 0 0 0 0 0 0 0 0 0 0 0 0 0 0 0 0 0 0 0 0
0 0 0 0 0 0 0 0 0 0 0 0 0 0 0 0 0 0 0 0 0 0 0 0 0 0 0 0 0 0 0 0
0 0 0 0 0 0 0 0 0 0 0 0 0 0 0 0 0 0 0 0 0 0 0 0 0 0 0 0 0 0 0 0
0 0 0 0 0 0 0 0 0 0 0 0 0 0 0 0 0 0 0 0 0 0 0 0 0 0 0 0 0 0 0 0
0 0 0 0 0 0 0 0 0 0 0 0 0 0 0 0 0 0 0 0 0 0 0 0 0 0 0 0 0 0 0 0
0 0 0 0 0 0 0 0 0 0 0 0 0 0 0 0 0 0 0 0 0 0 0 0 0 0 0 0 0 0 0 0
0 0 0 0 0 0 0 0 0 0 0 0 0 0 0 0 0 0 0 0 0 0 0 0 0 0 0 0 0 0 0 0
0 0 0 0 0 0 0 0 0 0 0 0 0 0 0 0 0 0 0 0 0 0 0 0 0 0 0 0 0 0 0 0
0 0 0 0 0 0 0 0 0 4 2 0 2 2 1 0 0 0 0 0 0 0 0 0 0 0 0 0 0 0 0 0
0 0 0 0 0 0 0 0 0 5 1 0 0 0 0 0 0 0 0 0 0 0 0 0 0 0 0 0 0 0 0 0
0 0 0 0 0 0 0 0 0 2 0 0 0 0 0 0 0 0 0 0 0 1 0 0 0 0 0 0 0 0 0 0
0 0 0 0 0 0 0 0 0 2 3 3 4 1 0 0 0 0 0 0 0 5 0 0 0 0 0 0 0 0 0 0
0 1 0 0 0 0 0 0 0 0 2 4 6 0 0 0 0 0 0 0 0 0 0 0 0 0 0 0 0 0 0 0
0 3 0 0 0 0 0 0 0 0 2 5 6 0 0 0 0 0 0 0 0 0 0 0 0 0 0 2 0 0 0 4
0 0 0 0 0 0 0 6 0 0 1 7 8 3 0 0 0 1 0 0 0 0 0 0 0 0 0 0 0 0 0 3
0 0 0 0 0 0 0 0 0 6 4 7 6 3 1 2 1 0 0 0 0 0 0 0 0 0 0 0 0 0 0 4
0 0 0 0 0 0 0 0 0 11 8 6 5 3 1 4 5 3 0 0 0 0 0 4 1 0 0 0 0 0 0 8
0 0 0 0 0 0 0 0 0 12 8 3 1 3 4 5 6 4 0 0 0 0 5 11 10 1 0 0 0 0 0 11
0 0 0 0 0 0 0 0 2 13 9 4 0 0 7 7 6 2 1 0 0 1 7 13 13 0 0 0 0 0 0 13
0 0 0 0 0 0 0 0 3 14 9 7 0 0 8 8 6 4 2 6 9 8 2 7 8 0 0 0 0 0 0 13
0 0 0 0 0 0 0 0 2 18 11 10 7 4 8 9 6 6 9 14 17 9 0 5 0 0 0 0 0 0 0 13
0 0 0 0 0 0 0 0 3 17 14 12 12 9 9 9 7 7 12 16 14 8 0 0 0 0 0 0 0 0 0 13
0 0 0 0 0 0 0 0 6 15 12 11 11 8 9 11 10 5 6 14 19 6 0 0 0 0 0 0 0 0 0 14
0 0 0 0 0 0 0 4 9 15 10 10 9 3 8 9 8 8 7 11 16 0 0 0 0 0 0 0 0 0 0 15
0 0 0 0 0 0 0 6 9 10 13 15 15 7 11 14 9 10 15 14 5 0 0 0 0 0 0 0 0 0 0 16
0 0 0 0 0 1 5 7 10 15 14 14 17 16 16 17 16 14 16 5 0 0 0 0 0 0 5 0 0 0 0 15
0 0 0 3 8 12 15 15 15 15 12 12 12 12 14 13 14 10 1 0 0 0 0 0 0 2 8 4 0 0 0 15
0 5 8 14 16 17 16 12 10 12 13 12 10 9 13 12 9 1 0 0 0 0 0 0 0 7 1 0 0 0 0 16
0 13 17 17 16 13 11 10 11 11 12 11 11 11 12 8 0 0 0 0 0 0 0 0 3 10 0 0 0 0 0 16
3 18 17 13 12 11 11 11 11 11 10 10 11 12 10 0 0 0 0 0 0 0 0 0 4 5 0 0 0 2 2 17
9 13 11 10 12 12 11 10 11 11 10 9 10 6 0 0 0 0 0 0 0 0 0 3 6 0 1 0 0 1 1 16
10 13 11 12 13 14 13 12 13 13 12 12 12 10 0 0 3 7 7 8 7 8 10 15 16 8 13 17 13 12 11 12
