69 0 0 0 0 0 0 0 0 0 0 0 0 0 0 0 0 0 0 0 0 0 0 0 0 0 0 0 0 0 0 0
104 13 14 14 15 15 14 13 14 13 13 13 14 14 15 15 15 14 13 13 16 18 14 14 15 15 15 15 15 15 15 0
106 13 14 13 15 15 13 13 13 14 13 13 14 14 14 15 16 15 13 13 14 17 17 15 16 16 16 15 14 15 15 0
107 13 14 13 14 15 13 13 13 13 13 14 15 15 15 15 15 16 14 13 14 16 18 17 16 17 16 15 15 15 16 0
109 13 14 13 14 14 13 12 13 13 14 14 16 16 16 15 15 16 15 14 15 16 16 16 16 17 17 16 15 15 15 0
110 14 14 13 14 14 13 12 14 14 14 15 16 16 16 16 15 15 15 15 15 16 16 16 16 16 16 16 15 15 15 0
111 14 14 13 13 14 13 13 12 12 14 16 18 19 18 18 18 19 21 19 17 18 18 16 16 16 16 16 16 15 15 0
113 15 15 14 13 14 13 13 0 0 17 24 26 29 31 31 29 32 46 37 21 28 29 19 15 16 16 16 16 16 15 0
112 19 18 15 14 15 16 13 0 0 15 28 28 31 35 37 33 36 54 50 32 40 41 24 18 18 17 16 16 16 16 0
109 26 25 16 15 15 17 12 0 0 0 17 14 15 17 23 22 21 35 39 24 32 40 32 37 33 21 17 17 17 17 0
113 42 36 21 16 15 17 13 0 0 0 11 11 14 15 19 19 17 36 33 0 14 41 38 48 57 34 19 18 19 15 0
98 56 66 47 22 16 16 14 0 0 0 7 10 16 18 21 21 17 29 28 0 1 34 29 24 63 43 21 22 25 16 0
51 35 81 91 37 17 0 17 0 0 0 4 8 14 15 20 22 21 27 23 0 10 20 4 12 47 31 18 29 32 24 0
34 13 45 89 55 25 0 13 25 0 1 6 8 16 15 19 19 19 32 28 5 19 19 0 2 32 23 8 31 33 26 0
40 6 3 38 51 37 21 3 25 6 6 5 8 18 17 19 22 16 31 40 16 9 25 0 0 22 30 7 14 15 11 0
58 8 0 6 21 24 31 3 0 0 10 10 9 15 17 16 24 21 35 46 14 4 16 0 4 21 48 18 0 0 0 0
74 13 13 12 11 12 13 6 0 0 9 14 11 14 16 14 19 24 43 40 26 14 0 4 12 34 60 40 0 0 8 0
78 19 19 19 19 20 20 13 0 0 6 17 16 10 11 13 16 21 34 47 37 4 0 0 8 46 64 50 4 3 9 0
78 19 19 20 19 19 20 15 0 0 7 22 26 7 1 12 17 20 26 53 23 7 6 0 8 44 63 38 1 5 10 0
76 18 18 19 21 21 20 16 0 0 9 19 29 14 0 12 17 19 24 29 24 32 24 0 8 47 47 16 0 10 15 0
74 20 21 19 17 17 17 13 0 0 9 14 24 22 8 14 19 12 19 26 21 36 23 7 25 43 29 1 1 12 15 0
74 15 16 16 14 15 18 19 0 0 7 11 17 24 15 16 20 12 19 24 18 26 33 24 23 21 13 0 8 13 11 0
73 17 18 19 18 19 20 15 0 0 7 6 14 19 12 15 19 21 23 11 14 28 58 39 14 9 0 0 10 19 12 0
69 18 20 20 18 18 15 6 1 0 4 4 18 18 7 13 15 16 22 11 12 45 58 34 18 7 0 6 12 18 11 0
66 15 15 17 18 16 11 6 2 0 0 3 15 23 12 16 24 15 15 20 39 61 36 21 16 1 0 12 19 17 10 0
66 17 16 14 15 13 12 7 0 0 6 5 5 17 16 13 21 20 18 38 52 40 28 22 13 0 1 15 27 17 12 0
65 17 16 11 8 8 10 13 14 12 12 9 9 7 7 9 11 18 31 46 30 22 24 23 6 0 0 15 35 25 10 0
64 13 10 7 9 12 16 17 13 7 9 11 14 9 4 9 10 26 46 32 20 25 21 18 0 0 13 16 15 20 9 0
57 7 10 12 15 16 12 11 11 9 7 9 13 15 9 13 23 35 33 22 19 22 21 9 0 2 24 29 8 6 9 0
48 14 16 15 11 12 12 12 11 9 8 8 10 13 16 30 41 23 14 20 18 19 17 1 3 8 21 23 14 6 11 0
40 17 14 11 8 11 14 12 10 10 11 10 9 17 27 36 29 18 14 17 19 18 9 0 15 17 9 20 17 9 13 0
27 14 14 14 12 12 15 15 14 13 14 13 15 26 34 27 30 36 33 31 32 31 23 20 23 29 16 22 32 28 26 2
