53 42 43 42 42 42 42 41 40 40 40 38 38 38 37 37 37 36 37 37 36 35 34 33 34 34 33 33 33 33 33 80
76 42 43 42 41 41 41 39 38 38 37 35 34 34 32 32 31 31 31 31 29 29 28 26 27 27 25 25 24 24 24 49
75 41 41 40 40 40 39 37 36 36 35 34 33 32 31 30 30 30 29 29 28 29 27 26 27 26 25 25 24 24 24 50
75 40 40 39 38 38 38 36 35 34 34 33 32 31 29 29 28 28 28 28 27 27 26 26 26 26 25 24 23 24 24 50
75 39 39 37 36 37 36 34 33 33 33 32 31 31 29 29 28 28 28 27 27 26 26 26 26 25 25 24 23 24 23 50
75 37 37 35 34 35 34 32 30 31 31 31 30 29 28 27 27 27 26 26 25 25 25 25 25 24 24 23 23 23 23 49
75 35 35 33 33 33 32 30 31 32 32 32 32 32 31 31 30 30 26 25 24 23 24 24 23 23 23 23 23 23 22 49
74 33 33 32 31 31 30 29 40 37 37 40 39 37 35 34 34 30 22 27 25 19 23 23 21 22 22 22 22 22 22 48
74 29 31 30 29 29 28 29 45 17 10 14 11 10 9 8 10 6 4 15 13 8 21 25 21 22 21 21 21 21 21 47
72 23 29 27 27 26 27 30 38 0 0 5 4 4 4 3 5 4 2 10 8 11 30 30 22 24 22 20 20 20 20 47
62 27 30 27 24 24 24 27 32 0 0 3 2 3 2 1 3 0 0 8 12 7 18 20 17 21 26 20 20 20 23 45
41 31 24 29 23 21 23 24 28 0 0 0 0 0 0 0 0 0 0 5 3 0 2 13 18 11 32 21 26 23 30 39
29 25 1 20 24 19 34 20 30 0 0 0 0 0 0 0 0 0 0 6 0 0 9 19 11 10 40 17 26 23 28 27
19 6 0 24 34 30 43 6 19 0 0 0 0 1 0 0 0 0 0 6 0 0 13 13 0 5 26 0 9 6 11 15
20 0 5 22 21 18 12 0 6 0 0 0 0 1 0 0 0 0 0 0 0 0 9 7 0 0 0 0 0 0 8 24
26 0 1 3 0 0 0 0 6 0 0 0 0 1 0 0 0 0 0 3 9 0 7 0 0 0 0 6 14 21 18 25
34 4 5 6 7 8 6 9 13 0 0 0 0 0 0 0 0 0 0 16 6 0 8 0 0 0 0 25 22 15 0 11
40 6 5 5 5 5 5 9 8 0 0 0 0 0 0 0 0 0 0 6 0 7 1 0 0 0 2 23 14 0 0 9
42 7 7 8 8 8 7 7 6 0 0 0 0 5 0 0 0 0 0 0 13 7 0 0 0 0 7 23 11 0 0 8
43 8 7 5 2 1 1 1 6 0 0 0 3 9 0 0 0 1 0 3 7 0 0 3 0 0 17 23 3 0 0 8
36 0 0 2 3 6 7 7 8 0 0 3 6 9 0 0 1 4 0 0 0 0 7 0 0 2 24 17 0 0 0 8
38 5 7 10 10 8 6 2 4 0 0 6 6 7 2 1 4 4 0 0 0 0 9 0 0 16 22 6 0 0 0 9
42 7 7 7 4 0 0 2 7 0 2 9 3 7 4 1 4 0 0 3 0 0 0 1 14 18 14 0 0 0 0 9
38 2 2 2 2 0 1 5 1 0 7 12 3 15 10 5 8 4 4 12 0 0 0 14 13 12 8 0 0 0 0 7
35 1 3 1 2 1 3 2 2 7 13 9 7 17 13 9 11 13 13 9 0 0 20 18 8 11 0 0 0 0 0 7
33 2 4 2 5 9 13 16 19 12 7 5 7 9 5 6 6 8 3 0 0 17 21 7 7 10 0 0 2 2 0 7
33 3 6 9 13 16 15 12 7 2 5 6 5 8 6 6 7 7 0 0 14 24 8 4 11 4 0 0 0 2 0 7
35 9 13 16 13 9 6 7 9 10 10 9 8 11 8 6 8 0 0 13 18 8 2 6 12 0 0 0 0 0 0 5
40 16 13 10 6 6 9 12 12 11 10 10 10 11 8 5 0 0 7 17 5 2 3 9 6 0 0 0 5 3 0 6
36 11 7 8 10 11 12 12 12 12 10 10 11 11 6 0 0 7 15 8 1 3 5 11 0 0 0 3 4 0 0 6
23 7 12 14 12 11 11 12 12 11 10 11 11 5 0 0 11 16 9 2 2 4 8 5 0 0 5 5 6 0 0 9
23 19 21 20 18 17 18 19 19 19 18 19 18 17 26 42 45 37 33 33 35 34 33 20 13 27 26 19 19 16 18 17
