0 0 0 0 0 0 0 0 0 0 0 0 0 0 0 0 0 0 0 0 0 0 0 0 0 0 0 0 0 0 0 0
0 18 16 17 17 16 17 17 17 16 17 17 16 16 18 17 17 17 18 17 19 13 14 21 19 19 19 19 20 19 19 0
0 18 15 16 17 15 15 16 17 17 16 17 16 15 17 17 17 17 18 17 18 16 17 20 18 18 18 17 19 19 19 0
0 18 15 16 17 15 15 16 17 17 17 17 17 16 18 18 18 19 18 17 19 20 20 19 18 19 18 17 20 19 20 0
0 17 15 16 17 15 15 16 17 17 17 17 16 16 18 18 18 19 17 17 18 17 18 18 19 20 19 19 20 20 20 0
0 17 15 16 16 15 16 17 18 16 16 17 16 16 18 17 18 18 16 16 17 17 18 19 19 19 19 19 19 19 20 0
0 16 14 16 16 16 16 18 15 12 12 11 10 10 11 11 10 10 14 13 14 17 18 17 18 18 18 18 18 18 19 0
0 15 14 15 16 16 16 18 1 17 21 15 18 20 21 21 21 25 27 2 11 27 17 14 19 18 18 18 18 18 19 0
0 18 13 15 16 17 17 14 0 78 78 57 61 61 60 56 51 56 50 10 28 42 9 8 20 18 18 18 18 18 19 0
0 29 7 14 16 16 16 11 0 67 43 17 18 19 21 19 12 18 27 9 17 27 6 14 28 14 14 17 18 18 18 0
0 21 1 12 15 16 16 11 0 53 29 3 7 9 8 9 4 11 23 0 9 54 35 42 43 15 3 15 18 18 15 0
0 6 20 1 10 14 16 11 0 52 34 8 20 16 11 11 5 13 26 0 11 62 41 20 34 42 0 20 20 24 14 0
9 30 74 0 0 16 0 25 0 44 27 5 21 10 9 11 1 5 13 0 6 47 0 0 28 37 0 52 30 42 23 0
0 23 65 0 0 5 0 88 0 42 24 6 20 8 10 14 5 15 19 0 12 41 0 5 46 31 0 75 45 50 29 0
0 0 23 26 27 36 26 79 10 29 10 11 22 13 10 15 9 17 33 7 1 17 0 0 45 33 7 44 16 16 0 0
0 0 3 30 43 42 26 13 0 32 14 15 16 12 9 14 13 7 29 0 0 22 4 0 38 0 0 0 0 0 0 0
0 0 0 0 0 0 0 0 0 42 26 14 12 11 9 12 18 13 25 0 5 18 0 31 27 9 20 0 0 18 40 0
0 12 16 16 17 15 15 7 0 42 21 14 10 8 8 10 17 13 28 4 17 0 22 39 35 51 26 0 15 39 30 0
0 15 14 12 12 14 16 13 1 40 20 19 1 0 13 16 13 10 23 4 0 14 42 28 39 51 7 0 12 38 15 0
0 13 19 21 23 23 20 13 0 43 16 15 4 0 16 22 12 10 13 10 11 49 14 0 42 31 0 0 28 37 8 0
0 19 15 10 9 5 3 2 0 44 15 15 18 3 19 23 9 7 23 23 26 49 0 19 45 0 0 1 43 29 7 0
0 2 5 3 9 15 18 17 0 36 27 17 25 16 17 17 8 9 31 12 11 31 0 21 1 0 0 16 37 7 8 0
0 17 19 21 23 22 18 12 0 38 24 10 30 15 15 22 15 11 16 1 29 28 8 0 0 0 7 30 34 8 9 0
0 25 21 18 14 15 10 13 25 37 10 6 25 0 5 16 9 14 11 0 41 40 2 0 0 8 13 37 18 12 7 0
0 17 13 15 10 13 14 23 15 9 15 21 25 0 11 19 6 5 17 16 50 1 0 0 17 8 30 40 8 12 4 0
0 13 8 13 9 9 10 8 11 29 24 18 25 22 22 24 27 18 30 35 18 0 0 16 12 8 38 21 11 8 8 0
0 13 10 11 14 24 36 42 38 30 14 10 12 5 10 10 13 10 19 0 0 0 16 14 4 19 48 32 24 0 12 0
0 10 12 23 37 42 38 23 11 10 11 9 8 0 8 9 4 16 3 0 0 9 15 12 4 37 31 11 18 2 13 0
0 20 35 38 35 22 13 10 9 9 11 10 10 4 8 12 13 8 0 0 13 14 13 9 14 48 23 0 0 10 17 0
0 38 36 21 13 11 9 10 8 8 9 9 10 8 14 20 0 0 0 5 15 12 11 5 30 34 14 5 8 21 24 0
0 23 12 9 10 13 10 7 8 9 10 6 8 16 17 0 0 0 4 16 15 13 11 16 47 5 4 12 5 19 21 0
0 4 0 2 4 6 3 1 2 3 3 0 2 0 0 0 0 1 3 7 4 7 8 23 24 0 9 32 16 13 7 0
