65 0 0 0 0 0 0 0 0 0 0 0 0 0 0 0 0 0 0 0 0 2 0 0 0 1 1 1 1 1 0 0
45 0 0 0 0 0 0 0 0 0 1 2 2 0 0 1 0 0 1 1 2 3 0 0 0 0 1 1 0 0 0 0
46 0 0 0 0 0 0 0 0 0 1 2 2 1 0 0 0 0 1 1 1 1 0 0 0 0 1 0 0 0 0 0
47 0 0 0 0 0 0 0 1 1 1 2 2 0 0 0 0 0 1 1 0 0 0 0 0 0 0 0 0 0 0 0
48 0 0 0 1 1 0 1 1 2 1 2 1 0 0 0 0 0 1 1 0 0 0 0 0 0 0 0 0 0 0 0
49 0 0 1 2 1 1 2 3 3 2 2 1 0 0 0 0 0 0 0 0 0 0 0 0 0 0 0 0 0 0 0
51 1 1 1 2 1 0 2 2 1 2 3 2 1 1 2 2 3 6 5 0 0 1 0 0 0 0 0 0 0 0 0
52 2 1 1 1 1 0 1 0 0 0 5 4 5 7 7 6 8 21 20 3 6 11 4 0 0 0 0 0 0 0 0
51 4 5 1 0 0 0 0 0 0 0 5 4 4 7 10 8 10 25 20 6 15 16 5 2 2 0 0 0 0 0 0
47 9 10 1 0 0 0 0 0 0 0 9 6 5 8 10 10 10 20 14 2 10 11 5 13 15 5 0 0 0 0 0
41 29 17 7 2 1 0 0 0 0 1 8 6 8 10 12 9 8 20 15 0 0 9 10 18 27 17 1 0 0 0 0
30 31 31 33 10 1 0 0 0 0 0 4 3 8 11 13 10 9 19 9 0 0 13 11 9 29 21 0 0 0 0 0
21 9 39 58 23 0 0 0 0 0 1 2 4 8 9 13 12 13 19 6 0 9 17 0 3 33 5 0 3 5 1 0
25 4 31 44 24 5 0 0 0 0 5 0 3 7 9 14 12 10 17 9 0 17 12 0 0 26 0 0 8 14 9 0
35 7 13 6 7 6 0 6 0 5 7 0 3 5 7 12 12 8 14 17 7 8 4 0 0 19 9 15 9 10 5 0
42 9 4 0 0 2 6 9 0 0 1 2 5 5 6 9 11 10 21 25 2 0 0 0 9 22 26 27 0 0 0 0
44 7 4 5 4 4 4 0 0 0 0 6 7 6 6 5 7 9 26 19 0 5 0 0 11 17 37 20 0 0 0 0
37 1 2 1 1 1 2 0 0 0 1 8 11 5 1 3 5 7 18 15 13 0 0 0 0 20 43 13 0 0 3 0
33 0 0 1 1 1 1 0 0 0 1 11 16 3 0 0 6 6 14 20 6 0 0 0 0 28 40 5 0 0 4 0
32 0 0 1 2 3 2 0 0 0 2 9 13 2 0 1 6 5 11 9 0 2 16 0 0 38 27 0 0 3 6 0
33 3 4 3 1 1 1 0 0 0 0 3 6 1 0 5 6 0 2 6 0 15 11 0 19 37 5 0 0 8 4 0
39 3 2 0 0 0 0 0 0 0 0 0 0 1 3 6 5 0 1 4 0 16 11 14 26 11 0 0 0 10 3 0
31 0 1 0 0 3 4 0 0 0 0 0 0 4 0 2 3 1 7 0 0 16 29 34 9 0 0 0 4 8 4 0
27 0 2 3 4 4 1 0 0 0 0 0 8 9 0 3 4 2 5 0 0 29 39 15 0 0 0 0 9 6 3 0
29 2 3 4 5 2 0 0 0 0 0 0 7 5 1 4 7 4 0 0 24 48 23 0 0 0 0 4 9 6 2 0
29 4 4 4 1 0 0 0 0 0 0 1 2 0 3 3 4 3 2 16 45 28 0 0 0 0 0 7 12 10 1 0
29 2 0 0 0 0 0 0 0 2 3 3 5 3 0 2 4 4 19 38 29 0 0 1 0 0 0 4 14 13 1 0
27 0 0 0 0 0 0 4 3 1 0 2 7 4 0 3 5 15 38 28 1 0 2 0 0 0 8 13 9 2 0 0
16 0 0 0 0 3 4 2 1 0 0 2 5 3 3 8 17 31 28 3 0 3 0 0 0 0 15 17 4 0 0 0
4 0 0 2 2 2 2 2 1 1 2 3 2 0 5 22 36 25 1 0 1 1 0 0 0 4 10 7 0 0 1 0
5 2 2 1 0 1 3 3 1 1 3 4 2 7 20 30 22 4 0 0 0 0 0 0 0 11 0 0 2 0 4 0
6 6 4 4 4 5 5 5 4 4 6 6 6 14 20 12 0 2 3 3 2 1 0 0 8 5 0 1 4 7 7 0
