66 58 59 60 61 62 63 64 64 65 66 67 68 69 69 71 71 71 72 72 72 75 77 75 74 75 75 76 75 76 76 133
55 19 21 20 20 21 22 21 21 21 22 22 22 23 22 22 22 23 23 23 21 24 25 22 23 23 23 23 22 22 22 103
57 20 22 22 21 22 23 22 22 22 22 22 22 23 23 23 22 22 22 23 21 21 21 21 23 23 23 24 22 22 22 103
57 20 22 22 21 22 23 22 22 22 22 22 23 24 23 23 23 22 23 24 23 23 22 22 22 22 22 23 22 22 21 103
58 21 23 22 21 22 22 21 21 21 22 22 22 23 23 23 22 22 23 24 24 24 23 23 22 22 22 22 21 22 21 103
60 22 23 23 22 23 23 22 21 23 24 24 25 26 25 25 26 26 26 24 24 24 23 23 23 22 22 22 22 23 22 104
61 22 24 23 23 23 23 21 20 16 11 8 6 4 3 2 2 2 7 17 20 18 20 22 23 22 23 23 23 23 23 105
60 22 24 23 23 23 24 23 18 0 0 0 0 0 0 0 0 0 0 0 0 0 10 23 24 23 23 23 23 23 23 105
57 14 20 24 24 24 24 26 38 0 0 0 0 0 0 0 0 0 0 0 0 0 6 14 14 20 23 23 23 23 23 106
50 4 21 24 24 23 23 26 52 3 0 5 5 5 4 4 8 4 0 13 1 0 0 0 0 2 19 23 24 24 23 106
6 0 6 18 24 24 24 29 56 7 0 7 2 1 4 6 11 8 0 13 7 0 0 0 0 0 8 16 16 15 16 94
0 0 0 0 20 25 24 26 56 13 7 14 5 4 7 7 13 15 6 23 20 0 0 5 0 0 5 0 0 0 0 63
0 0 0 0 21 26 19 0 20 0 1 13 4 8 9 6 9 7 2 21 21 0 24 22 0 0 2 0 0 0 0 34
25 21 0 0 0 0 0 0 0 0 2 12 0 4 5 2 8 0 0 12 22 6 42 39 1 0 12 0 0 0 16 61
45 40 16 0 0 0 0 0 16 0 2 7 0 3 4 0 5 5 0 20 36 18 32 35 9 13 44 42 66 56 57 86
51 41 43 40 35 31 36 33 47 7 0 0 1 4 5 1 0 1 0 21 33 15 20 19 0 13 23 49 57 37 21 62
43 22 22 20 20 21 21 26 36 2 0 3 5 7 9 7 1 2 0 9 13 10 17 0 0 0 0 21 17 8 0 53
38 11 10 13 13 12 9 13 24 0 0 3 12 19 14 8 3 5 0 12 13 19 4 0 0 0 0 21 14 2 0 54
39 10 6 4 2 2 2 10 23 0 2 1 10 23 13 3 1 4 0 0 0 0 0 8 1 0 8 30 13 0 6 51
31 3 6 10 12 16 19 24 34 0 4 0 0 12 3 0 2 4 0 0 0 0 0 14 0 4 36 36 6 0 9 50
44 20 21 22 19 15 11 11 29 0 1 0 0 0 0 0 5 7 0 0 2 0 16 20 10 30 43 27 2 5 17 51
40 13 9 7 3 1 2 4 22 0 0 0 0 0 0 0 0 5 0 4 1 0 22 31 41 47 35 14 0 9 16 52
30 0 0 0 2 4 7 5 10 0 0 6 0 7 7 1 2 2 0 14 0 0 9 30 43 34 23 7 0 13 13 50
34 3 3 5 9 9 9 6 10 2 6 1 0 4 3 0 3 3 0 4 0 1 30 42 27 17 12 0 4 14 17 50
34 8 12 11 12 11 14 14 11 0 0 0 0 0 0 0 0 0 0 0 0 20 45 33 15 16 5 0 12 12 17 49
33 8 12 10 7 0 0 0 0 0 0 0 0 1 0 0 0 0 0 13 25 47 36 16 14 16 0 0 0 8 14 46
32 8 8 0 0 0 0 0 0 0 0 4 6 13 9 6 4 8 14 33 44 41 18 12 15 9 0 1 0 10 9 43
30 1 0 0 0 0 0 0 0 2 3 2 1 9 8 7 9 13 26 45 37 21 12 13 15 0 0 20 23 23 10 42
15 0 0 0 0 0 0 2 4 5 4 3 0 4 2 5 22 36 45 43 22 15 14 15 14 0 0 15 17 11 3 37
4 0 0 0 0 0 2 3 4 5 5 7 6 5 4 16 41 54 45 27 14 14 12 12 1 0 10 14 15 7 3 38
10 0 0 4 4 2 3 5 6 5 5 7 9 15 31 42 45 37 24 15 14 14 11 10 0 11 11 0 0 0 4 43
0 0 0 0 0 0 0 0 0 0 0 0 0 0 0 0 0 0 0 0 0 0 0 0 0 0 0 0 0 0 0 0
