0 8 8 8 7 8 9 9 9 10 10 10 10 11 11 11 12 12 12 13 13 12 13 14 14 15 15 15 16 16 17 101
0 7 6 6 4 5 6 7 6 7 8 7 7 7 8 8 9 9 9 10 8 7 11 12 10 10 11 11 11 11 12 125
0 7 5 6 5 5 6 7 7 7 7 7 7 8 9 8 8 10 10 10 8 7 12 13 10 10 11 11 12 12 12 126
0 6 5 7 5 5 7 8 8 7 7 8 7 8 9 9 9 9 9 10 10 8 9 10 10 11 11 12 13 12 12 126
0 6 6 7 6 5 7 9 8 8 8 8 8 9 9 9 9 9 10 11 11 10 10 10 10 10 10 12 13 12 12 126
0 6 6 8 6 6 8 10 8 8 8 7 7 8 9 9 9 8 8 10 11 11 10 11 11 10 10 11 12 12 12 126
0 6 7 8 7 7 9 10 9 10 13 14 14 17 19 18 19 19 20 17 13 13 13 12 12 11 11 12 12 13 12 127
0 8 7 8 8 9 11 10 12 26 37 38 38 38 38 37 35 33 26 20 24 22 13 11 12 11 11 12 12 13 12 128
0 9 9 9 9 9 10 10 38 61 33 18 17 14 11 9 11 7 0 0 17 8 0 8 17 13 12 12 12 12 12 128
0 10 2 8 10 10 9 12 60 88 33 10 12 10 7 2 4 3 0 0 2 0 0 17 23 16 13 12 12 13 12 129
0 13 1 12 11 10 8 13 65 94 34 10 14 13 10 5 3 5 0 0 19 13 0 11 0 0 10 15 15 16 15 134
0 0 1 13 12 10 10 16 67 97 34 10 13 8 5 2 2 6 0 0 31 31 0 0 0 0 0 20 25 22 26 140
0 0 0 0 0 11 12 29 78 101 40 17 17 6 4 1 0 5 0 0 38 32 0 0 9 0 0 34 28 26 29 127
0 0 0 0 0 30 60 53 51 87 35 17 17 7 8 3 2 4 0 3 37 11 0 21 17 0 2 40 8 4 6 84
0 0 0 0 0 20 60 51 9 44 26 23 19 5 7 4 4 9 0 0 15 0 0 42 39 0 0 18 0 0 0 81
0 2 0 0 0 0 6 14 11 26 19 24 17 6 6 6 2 8 0 0 3 18 2 40 44 0 0 0 0 6 20 113
0 6 8 12 10 10 11 14 42 52 20 15 13 7 6 7 3 3 0 0 15 21 19 45 28 1 0 0 25 43 39 103
0 7 10 9 8 8 8 16 51 61 22 11 9 4 4 10 8 2 0 0 0 12 44 50 26 0 0 0 32 48 33 89
0 7 9 11 13 13 13 20 49 57 22 5 0 7 15 13 8 4 0 0 1 41 59 38 19 0 0 0 37 46 25 85
0 14 14 11 9 6 5 10 42 52 19 1 0 12 30 18 7 4 0 0 13 40 27 31 30 0 0 0 45 38 18 84
0 4 3 3 4 5 10 19 52 56 15 7 0 11 32 17 4 8 8 6 17 8 0 28 10 0 0 22 51 22 8 80
0 9 9 11 16 17 16 19 45 56 19 8 4 8 20 12 6 17 14 0 14 0 0 16 0 0 0 41 43 15 13 79
0 15 15 15 16 14 12 13 40 56 22 12 10 2 7 6 1 8 8 4 12 0 0 0 0 0 23 47 29 6 15 80
0 13 9 10 12 10 9 20 43 39 10 17 13 3 14 12 7 6 0 14 28 0 0 0 0 19 40 46 20 6 14 79
0 13 8 7 8 9 13 23 29 32 28 27 7 1 23 15 8 15 11 22 15 0 0 0 13 28 49 34 7 7 15 81
0 10 9 10 7 12 21 33 47 46 33 24 10 0 9 8 0 5 10 2 0 0 0 9 17 38 49 25 10 11 16 82
0 8 8 13 20 29 35 35 33 25 16 15 11 6 6 6 2 0 0 0 0 0 0 10 21 51 51 12 0 2 20 80
0 10 18 30 35 33 25 16 16 15 11 10 6 8 13 7 4 0 0 0 0 0 9 10 32 56 39 11 0 0 18 76
0 27 34 33 26 17 12 9 9 11 11 8 3 6 13 8 1 0 0 0 0 6 8 16 45 51 11 0 6 16 23 75
0 32 25 16 13 10 9 8 8 10 11 8 4 4 9 0 0 0 0 0 10 7 11 28 53 38 0 0 10 24 22 67
0 15 10 9 10 9 6 6 7 9 9 7 7 6 0 0 0 0 4 12 10 10 17 42 43 13 0 3 21 32 21 62
0 19 17 21 22 20 15 16 20 21 18 19 19 8 0 4 21 40 54 56 54 56 68 78 53 31 51 43 34 42 39 88
