16 5 4 4 4 3 2 2 2 2 1 0 0 0 0 0 0 0 0 0 0 0 0 0 0 0 0 0 0 0 0 0
23 15 15 14 15 15 14 13 14 15 14 14 14 13 12 12 12 12 13 14 12 11 11 11 12 11 11 12 12 11 11 22
23 14 14 13 14 14 13 13 14 15 14 14 13 12 11 11 11 12 12 13 12 11 11 11 10 10 9 10 10 10 11 21
22 14 14 13 13 13 13 13 14 15 14 14 14 12 11 11 11 12 12 13 12 11 11 10 9 9 8 9 9 10 10 22
22 14 14 13 13 14 13 13 14 14 14 14 13 12 11 11 11 11 12 12 11 10 9 9 9 9 9 10 9 10 10 22
20 13 13 13 14 14 13 13 14 14 13 12 11 9 9 10 10 9 9 10 9 8 8 9 9 9 9 10 10 9 10 22
19 12 12 12 13 14 13 13 12 12 11 8 7 5 5 5 5 5 5 4 5 7 7 8 9 9 9 9 9 10 10 22
17 11 11 11 11 12 12 11 4 7 7 4 3 2 2 2 3 3 4 1 2 7 7 7 8 8 8 8 8 9 9 21
14 11 10 10 10 10 11 8 2 5 8 9 8 7 7 8 7 6 2 4 6 7 8 8 8 7 7 7 7 8 8 20
14 10 10 9 8 9 9 7 6 1 0 1 0 0 0 0 0 0 0 0 1 3 5 8 11 7 6 6 7 7 6 19
18 6 10 6 7 7 7 7 6 0 0 0 0 0 0 0 0 0 0 0 0 0 11 12 11 14 6 5 5 6 4 21
11 8 14 7 6 8 6 6 6 0 0 0 1 0 0 0 0 0 0 0 4 4 10 10 3 10 6 8 4 6 4 24
0 4 12 14 7 6 0 7 6 0 0 0 1 0 0 0 0 0 0 0 5 5 0 0 2 0 7 8 9 8 9 26
0 3 0 7 8 0 0 0 13 0 0 1 0 0 0 0 0 0 0 3 5 0 0 0 0 0 12 9 13 12 12 20
0 0 0 0 8 5 12 0 9 2 0 1 0 0 0 0 1 0 1 6 2 0 0 0 0 0 17 4 7 4 4 7
0 0 0 0 2 5 11 0 0 0 0 1 0 0 0 0 0 0 0 0 0 0 0 3 0 0 10 0 0 0 0 5
0 0 0 0 0 0 0 0 0 0 0 1 0 0 0 0 0 0 0 0 0 0 0 2 0 1 0 0 0 0 0 11
0 0 0 0 0 0 0 0 3 0 0 0 0 0 0 0 0 0 0 0 0 0 0 0 0 5 1 5 1 2 0 10
0 0 0 0 0 0 0 0 1 0 0 0 0 0 0 0 0 0 0 0 0 0 1 0 3 0 0 3 2 0 0 9
0 0 0 0 0 0 0 0 0 0 0 0 0 0 0 0 0 0 0 0 0 6 2 3 1 0 0 0 1 0 0 9
0 0 0 0 0 0 0 0 0 0 0 0 0 1 0 0 0 0 0 0 0 4 0 7 0 0 0 0 0 0 1 9
0 0 0 0 0 0 0 0 3 0 0 0 0 3 0 0 0 0 0 0 0 0 3 3 0 0 0 0 0 0 0 8
0 0 0 0 0 0 0 0 4 2 0 1 2 1 0 0 0 2 0 0 0 0 5 0 0 0 0 2 0 0 0 8
0 0 0 0 0 0 0 0 8 2 1 1 0 0 0 0 0 0 0 0 0 0 0 0 0 0 0 1 0 0 0 8
0 0 0 0 0 0 0 4 5 1 0 0 0 2 0 0 1 0 0 2 2 0 0 0 0 0 2 0 0 0 0 7
0 0 0 0 1 1 3 4 1 1 2 1 0 1 3 0 1 2 0 5 0 0 0 0 0 0 0 0 0 0 0 7
0 0 0 0 0 2 5 6 7 5 3 1 0 0 0 0 0 0 0 0 0 0 0 0 0 0 0 0 0 0 0 8
0 0 0 0 3 5 6 5 3 0 0 0 0 0 0 0 0 0 0 0 0 0 0 0 0 0 0 0 0 0 0 8
0 0 3 5 5 4 1 0 0 0 0 0 0 0 0 0 1 0 0 0 0 0 0 0 0 0 0 0 0 0 0 8
5 5 4 4 1 0 0 0 0 0 0 0 0 0 0 1 0 0 0 0 0 0 0 0 2 0 0 0 0 0 0 7
6 5 1 0 0 0 0 0 0 0 1 0 0 0 0 0 0 0 0 0 0 0 0 0 0 0 0 0 0 0 0 5
2 0 0 0 0 0 0 0 0 0 0 0 0 0 0 0 0 0 0 0 0 0 0 0 0 0 0 0 3 1 0 12
