0 0 0 0 0 0 0 0 0 0 0 0 0 0 0 0 0 0 0 0 0 0 0 0 0 0 0 0 0 0 0 0
0 0 0 0 0 0 0 0 0 0 0 0 0 0 0 0 0 0 0 0 0 0 0 0 0 0 0 0 0 0 0 15
0 0 0 0 0 0 0 0 0 0 0 0 0 0 0 0 0 0 0 0 0 0 0 0 0 0 0 0 0 0 0 15
0 0 0 0 0 0 0 0 0 0 0 0 0 0 0 0 0 0 0 0 0 0 0 0 0 0 0 0 0 0 0 15
0 0 0 0 0 0 0 0 0 0 0 0 0 0 0 0 0 0 0 0 0 0 0 0 0 0 0 0 0 0 0 15
0 0 0 0 0 0 0 0 0 0 0 0 0 0 0 0 0 0 0 0 0 0 0 0 0 0 0 0 0 0 0 15
0 0 0 0 0 0 0 0 0 0 0 0 0 2 3 3 3 3 2 0 0 0 0 0 0 0 0 0 0 0 0 14
0 0 0 0 0 0 0 0 0 26 49 55 59 61 61 58 56 54 43 22 14 12 0 0 0 0 0 0 0 0 0 14
0 0 0 0 0 0 0 0 7 46 63 65 65 64 62 59 55 50 38 32 29 16 1 0 0 0 0 0 0 0 0 14
0 0 0 0 0 0 0 0 6 18 15 11 10 9 8 7 6 4 4 8 12 18 24 29 23 5 0 0 0 0 0 15
19 19 3 0 0 0 0 0 2 6 1 0 2 3 0 0 0 0 0 0 12 32 47 45 34 23 4 0 0 0 0 23
34 48 43 15 0 0 0 0 1 2 0 0 2 2 0 0 0 0 0 0 10 17 13 11 17 20 12 18 20 20 21 44
19 50 54 24 0 0 0 21 24 10 0 0 0 0 0 0 0 0 0 0 2 0 0 0 11 11 28 50 55 52 50 57
0 5 4 15 27 26 43 55 51 25 1 0 0 0 0 0 0 0 1 2 0 0 0 0 3 12 34 43 38 30 21 23
0 0 0 9 50 63 63 34 25 17 3 2 1 0 0 0 1 1 0 0 0 0 0 0 0 0 0 0 0 0 0 0
0 0 0 0 0 5 0 0 0 0 8 7 2 0 1 2 3 2 0 0 0 0 0 7 0 0 0 0 0 0 0 12
0 0 0 0 0 0 0 0 0 2 7 4 0 0 0 0 3 4 0 0 4 0 6 20 10 10 0 0 0 11 19 28
0 0 0 0 0 0 0 1 10 9 3 1 0 0 0 0 0 0 0 9 0 0 21 25 25 22 6 5 16 21 11 20
0 0 0 2 3 5 5 8 11 8 2 0 0 0 0 1 0 0 2 1 7 28 25 9 9 0 0 0 15 14 4 17
0 6 5 4 2 0 0 0 2 5 0 0 0 0 3 4 2 3 6 16 39 41 10 0 0 0 0 0 18 12 3 15
0 0 0 0 0 0 0 0 4 2 1 2 8 15 12 4 0 3 13 20 25 12 0 2 0 0 0 4 14 0 0 12
0 0 0 0 1 6 10 10 9 5 3 5 12 17 13 7 5 8 6 2 6 0 0 0 0 0 0 14 7 0 0 10
0 9 11 13 13 10 6 5 15 14 4 3 7 4 4 4 5 6 0 0 6 3 0 0 0 0 2 14 3 0 0 11
0 9 8 6 3 0 0 8 17 4 0 7 5 0 0 2 1 0 0 9 12 0 0 0 0 0 12 13 0 0 0 11
0 0 0 0 0 0 0 2 0 0 8 15 12 17 21 17 16 14 19 27 5 0 0 0 0 7 19 7 0 0 0 10
0 0 0 0 0 3 13 19 26 26 19 10 8 13 17 15 16 18 17 1 0 0 0 0 1 13 19 11 6 0 0 12
0 0 0 3 15 31 42 43 35 20 8 1 0 0 0 0 0 0 0 0 0 0 0 0 5 21 18 9 5 2 2 15
0 2 14 29 39 39 30 18 8 1 0 0 0 0 0 0 0 0 0 0 0 0 0 0 14 24 8 0 0 0 3 14
5 26 37 37 27 15 5 2 1 0 0 0 0 0 0 0 0 0 0 0 0 0 0 3 19 17 0 0 0 0 5 15
23 36 26 14 6 3 2 0 0 0 0 0 0 0 0 0 0 0 0 0 0 0 0 11 22 2 0 0 0 5 6 13
14 15 5 1 1 1 0 0 0 0 0 0 0 0 0 0 0 0 0 0 0 0 4 20 13 0 0 5 13 10 1 7
17 24 24 25 24 22 21 23 23 23 22 22 21 14 10 23 52 74 81 80 81 82 86 79 57 53 61 63 64 59 52 56
