-580 3 -445 -1024 -843 -895 -1349 -809
-616 363 -538 -1150 -615 -973 -2119 -1176
-522 -403 -544 -208 220 -282 -1266 -956
-1162 -1129 -739 -247 95 99 -555 -790
-967 -816 -815 -472 92 248 -390 -341
-414 -836 -900 -11 322 119 -111 -518
78 -241 -83 466 -153 -203 30 -849
201 68 -18 -163 -376 -36 -216 -815
