-612 -108 -276 -427 -522 -260 -186 -57
-1470 -878 -426 -39 -356 -582 -671 -523
-1618 -1707 -1508 126 12 29 153 -43
-1113 -1338 -1525 -452 -761 -701 -438 396
-724 -959 -1182 -1107 -1290 -1731 -1329 -77
-996 -1088 -1490 -1375 -1762 -2400 -1914 -723
-919 -508 -428 -1587 -2148 -1832 -964 -146
-475 -40 -201 -1422 -1152 -1017 -851 -273
