-1390 -1281 -672 -897 -879 -648 -679 -715
-1845 -1954 -988 -832 -745 -974 -1536 -1105
-1722 -1764 -907 187 -297 -1063 -1358 -524
-1598 -1438 154 1421 7 -1328 -2019 -1022
-719 -854 -218 634 11 -638 -1577 -736
-798 -900 -887 -73 27 -523 -604 -205
-696 -548 -120 495 24 -481 -224 -204
-511 -170 442 462 -348 -574 -655 -392
