65 -33 -45 -267 -49 428 642 -129
605 386 476 -143 -139 651 594 -259
240 -959 -898 -653 -484 136 531 -103
-381 -1350 -885 -330 -722 -732 177 -10
-1001 -1635 -418 11 -915 -871 -61 139
-726 -1102 -380 -313 -845 -634 217 365
-564 -538 -629 -478 -253 -366 -316 90
-487 -446 -596 28 488 -125 -737 106
