-464 -465 -378 -320 -300 -355 -432 -324
-652 -718 -664 -579 -466 -479 -592 -390
-683 -826 -877 -642 -743 -646 -572 -325
-683 -853 -742 -651 -628 -979 -740 -367
-504 -755 -769 -599 -541 -737 -667 -429
-481 -621 -661 -507 -555 -709 -725 -484
-431 -425 -415 -513 -676 -729 -680 -423
-245 -257 -215 -455 -550 -498 -444 -277
