-651 -811 -840 -703 -465 -320 -373 -241
-1004 -937 -1605 -1553 -1054 -1038 -1004 -857
-1160 -1174 -1289 -892 -633 -1441 -1367 -900
-1026 -1980 -1614 -328 -777 -2084 -2160 -1396
-1058 -1660 -1462 -838 -1116 -2394 -1957 -1228
-428 -1210 -1437 -1273 -1464 -2056 -2065 -1074
-623 -1111 -1126 -1180 -1646 -2470 -2187 -1107
-410 -573 -248 -244 -1391 -1615 -1254 -922
