507 358 273 328 445 457 508 667
488 808 236 326 -10 -163 -144 617
168 1516 336 -584 -921 -808 -480 463
-770 577 -132 -925 -1148 -1295 -825 129
-218 -116 -271 -138 -496 -606 -569 -268
-410 -154 -284 -330 -175 45 -47 218
-9 121 -515 -449 415 486 273 40
-139 -403 -802 -142 98 173 -184 -275
