272 -497 -941 -857 -734 -564 -156 198
-830 -1971 -2824 -1824 -1817 -1815 -1289 -402
-460 -1504 -2584 -883 -947 -1628 -1172 -679
395 -368 -1667 -239 -268 -1502 -1508 -911
217 -25 -1157 -116 -454 -1368 -1560 -453
-700 -534 -1182 -358 -728 -1440 -1282 -679
-571 -527 -512 -122 -639 -701 -826 -622
-99 -32 208 363 233 824 680 336
