-79 -174 -134 264 167 -199 -301 -129
305 914 1045 1368 1216 1007 827 915
416 1018 583 935 1135 1325 993 974
499 574 -422 -14 148 369 218 473
37 167 -390 -336 -608 -725 -987 -430
-118 20 -552 -625 -707 -1140 -1164 -322
-116 -160 -605 -675 -1170 -1794 -1343 -163
-68 -281 -431 -236 -974 -1140 -422 -237
