-269 -305 -412 -259 -422 -324 -495 -302
-427 -1806 -1112 -76 -392 -291 -652 -102
-482 -1661 -1412 351 -135 -100 209 220
-1153 -802 -729 98 -579 -939 -526 238
-1107 -214 341 226 -15 -517 -709 -207
-606 75 -166 150 647 -190 -142 -115
-491 -297 -97 712 687 -536 -523 9
-648 -322 130 178 81 -186 -331 79
