330 28 -513 -534 -525 -187 38 -46
55 -149 -672 -574 -1018 -826 -438 57
-1035 -1039 -143 1145 500 -702 -762 -91
-696 -1237 -349 1429 820 -495 -611 -220
161 -436 -1141 -198 -203 -915 -461 217
-189 -820 -1338 -803 -904 -1196 -570 -488
-208 -394 -122 -173 -518 -537 -963 -1070
188 516 581 273 -113 -728 -1004 -589
