-1110 -1636 -973 -1038 -1028 -884 -1187 -987
-1552 -1715 -1100 -1265 -1005 -1138 -1046 -669
-1684 -1879 -674 -154 -299 -874 -1293 -1334
-284 -966 -279 -463 -599 -752 -982 -866
367 -595 -392 -834 -576 -1320 -841 -472
499 -83 -153 -631 -1324 -1150 -386 -195
105 -74 372 -485 -1453 -863 -504 -182
139 376 526 -403 -679 -116 -111 -363
