-2510 -2874 -2031 -1526 -1696 -2219 -2925 -2328
-2642 -2623 -1789 -706 -890 -1445 -2389 -2133
-1799 -861 59 911 638 -381 -1005 -730
-2125 -1905 -193 1068 701 205 -536 -423
-1568 -1415 -389 538 651 27 -706 -679
-1045 -691 -9 741 888 -98 -1575 -814
-349 -415 296 970 825 -758 -1565 -356
-114 -28 296 775 -701 -1679 -1039 -374
