-1147 -1392 -500 -114 -318 -500 -932 -950
-1034 -1349 -677 -350 -330 -163 -356 -452
-1572 -1059 -676 -930 -670 -774 -383 69
-1772 -1303 -475 -482 -376 -889 -390 90
-1440 -1847 -811 -137 62 2 129 -50
-897 -807 -370 -3 255 691 653 540
-445 -400 -286 -29 891 961 366 384
51 -132 -79 629 1135 573 152 0
