-794 -593 -511 -799 -788 -710 -413 20
-1908 -1968 -1580 -2026 -2038 -2144 -2126 -1519
-1626 -1369 -475 -707 150 -1024 -1792 -1650
-299 -500 -116 -242 1074 309 -823 -746
-201 -652 -84 -154 662 444 -486 -532
-1011 -1202 259 432 386 262 -497 -746
-995 -1121 663 605 -84 385 -495 -395
-644 -529 163 -1 -619 -492 -468 -528
