150 -153 208 98 -77 75 202 -303
388 -111 541 176 -582 -326 -245 -176
523 -1036 589 774 -742 24 155 174
18 -1360 -290 536 -905 -149 1035 628
311 -1800 -680 591 -871 -674 117 894
323 -1405 -490 194 -875 -1177 -533 882
120 -834 -1153 -383 -989 -1336 -429 813
102 -353 -608 -258 -699 -1136 -559 615
