-546 -563 372 613 529 373 337 -309
-733 -1398 -915 -499 -33 -246 -493 -939
-100 -594 -755 -346 37 -198 116 -101
-475 -766 -661 -526 -509 -727 -94 -267
-673 -893 -501 -227 38 -583 -738 -448
-466 -727 -696 48 754 149 -745 -735
-280 -480 -474 481 794 -194 -718 -519
-135 -324 12 499 463 -289 -669 -192
