509 302 410 320 318 178 232 904
-822 -780 -750 -1283 -749 -731 -760 -264
-362 80 -763 -1744 -1225 -1104 -1015 -568
-370 22 -312 -1236 -1085 -1227 -653 -344
-694 -141 348 -657 -1025 -338 298 -197
-276 300 767 -230 -347 802 834 -52
89 408 531 591 1754 1266 345 0
-264 -178 113 1110 1167 209 427 166
