-1246 -1722 -1162 -927 -1026 -1420 -1535 -1138
-2844 -3499 -2122 -1236 -1647 -2302 -2385 -1822
-2076 -2574 -1084 114 -602 -1323 -1868 -1395
-941 -1331 -917 -66 -456 -964 -1317 -973
-582 -858 -671 90 217 230 -751 -738
-458 -701 -213 849 951 -652 -1813 -605
-141 -119 511 978 -181 -1886 -1495 -417
11 -19 140 -326 -1351 -1089 -636 -22
