45 -470 -191 308 364 311 -1 -106
471 559 -508 -118 -189 273 473 713
-1130 -671 -930 -618 -779 -377 -297 173
-1977 -1863 -1000 -722 -986 -957 -949 34
-1536 -1303 -867 -868 -1498 -1786 -1183 -34
-549 -590 -743 -2046 -2192 -1841 -300 603
-769 -942 -1591 -2750 -2606 -992 -121 101
-736 -588 -659 -1220 -824 -163 -546 -883
