-1282 -1144 -1055 -787 -672 -813 -845 -556
-1130 -489 -1008 97 42 -601 -587 -412
-678 -400 -424 722 680 11 -263 -370
499 1495 1032 782 277 -34 -18 -240
78 1413 699 148 -55 -244 -182 -116
-112 103 284 -335 -621 -832 -349 221
-271 -298 -201 -836 -1042 -855 70 69
10 48 -388 -563 125 580 343 -92
