-2705 -1674 -834 -944 -1036 -1617 -1938 -1232
-2707 -1339 -666 -974 -559 -1276 -1912 -1775
-1136 -844 -441 -699 -196 -246 -1057 -1755
-1149 -794 -545 -299 549 816 -372 -1395
-1121 -1082 -517 -161 731 108 -1009 -1181
-484 -849 -355 -72 -237 -981 -991 -1070
-298 -1036 -714 -400 -1130 -1169 -805 -731
-290 -621 -365 -34 -575 -793 -610 -442
