675 100 -191 90 173 99 358 424
-852 -1565 -2243 -1431 -1637 -2321 -1454 -400
-1105 -1373 -1514 -108 -983 -2593 -2557 -1431
-401 -416 -1154 -181 -394 -1597 -1729 -901
113 -185 -1414 -770 -650 -621 -567 -215
-14 -77 -458 -404 -621 -335 -1149 -734
-68 180 561 122 -4 -733 -1255 -638
109 82 358 241 -184 -582 -481 -373
