638 -1053 -174 54 266 250 -106 -266
-185 -1336 -784 -722 -57 353 4 -565
-541 -985 -237 -515 157 333 296 -308
-1271 -2342 -730 -712 200 -109 -133 -842
-514 -1510 -598 -295 -49 -809 -1266 -1324
-300 -1179 -349 -511 -988 -2531 -2051 -332
-221 -1207 -600 -844 -1654 -2557 -1633 -527
-16 -251 64 77 -382 -615 -532 -275
