1052 1218 1225 787 967 1070 1144 1417
-935 -685 -714 -1640 -1032 -1071 -991 -414
-816 -567 -1193 -1371 -987 -1201 -976 -637
-965 -387 -899 -1158 -959 -1289 -1392 -681
-667 -356 -582 -1304 -1242 -1535 -1033 -115
-828 -900 -1095 -1434 -1436 -1174 -348 -858
-439 -582 -408 -638 -49 209 -340 -559
-237 -130 145 70 537 -230 -123 140
