274 777 496 425 236 125 452 656
634 941 555 734 434 20 550 675
-306 -706 -1511 -1132 -924 -1219 247 787
-1213 -2196 -3806 -3592 -3142 -3301 -1233 487
-1345 -2844 -3519 -3452 -3829 -4419 -2496 -495
-597 -1477 -2214 -2541 -3638 -4047 -3134 -1161
-51 -235 -1612 -2521 -2787 -3223 -2963 -1066
-184 -353 -1397 -2458 -2225 -2581 -2513 -1250
