-776 -353 -135 -306 -359 -443 -887 -161
-618 -642 -295 -761 -329 69 -236 -281
-198 -1150 -900 -1539 -773 84 -468 -169
-706 -422 339 -126 -112 467 -506 107
-918 44 541 456 -3 347 -50 210
-410 -273 -309 -9 -460 85 388 327
-640 -994 -1081 -875 -1243 -722 307 99
-781 -886 -944 -1040 -1134 89 356 257
