-1416 -1192 -20 550 95 -526 -876 -933
-230 -134 411 738 374 -125 -223 -268
190 145 -490 -1283 -1209 -958 -744 -1
220 -411 -713 -724 -469 -214 -1074 -651
63 -863 -779 237 695 4 -1143 -1123
-51 154 211 264 74 -336 -457 -164
85 102 -393 -426 -693 -91 -318 -132
19 -366 -396 92 -124 125 -499 -523
