-510 -677 -602 -726 -834 -957 -1168 -281
-1450 -1091 -677 -1030 -965 -1164 -1091 -202
-1155 -282 -467 -1205 -546 -907 -625 -37
-1064 -14 575 -637 -133 -1142 -994 -103
-901 -631 135 -256 -266 -670 -471 21
-379 -274 80 -700 -630 -190 -11 141
114 55 100 -813 -712 -86 188 202
155 4 -141 -750 -536 456 593 440
