-1089 -750 -196 -674 -591 -771 -1083 -1031
-643 -633 265 -884 -230 -116 -616 -1189
-456 -1167 67 -668 -491 160 -602 -1285
-70 -827 462 187 -592 161 -36 -1044
-400 -681 728 357 -1039 -49 290 -270
-664 -747 367 -165 -1281 232 796 279
-802 -888 -339 -943 -783 55 771 102
-261 -255 -329 -24 245 -130 351 6
