-820 -1682 -786 -939 -908 -991 -955 -878
-121 -937 457 266 351 626 -1 -679
1252 116 279 224 102 1540 522 -64
-361 -1557 -730 -157 -327 292 -644 -256
-616 -1621 -963 60 -80 -459 -672 -33
237 -1282 -1349 -462 -1765 -1714 -316 389
-1 -952 -1248 -1651 -2625 -1113 -101 91
-253 -501 -721 -1300 -1083 -420 -636 -421
