793 961 885 846 746 581 571 126
748 932 242 -109 207 93 169 -308
784 173 -1195 -1707 -806 -415 -310 -385
-436 -2186 -1900 -1134 -799 -744 -1693 -1518
-824 -1905 -1891 -1144 -367 -1133 -2388 -1997
275 -1015 -1535 -857 -132 -1864 -2491 -1709
76 -1228 -1391 -666 -1627 -2642 -2935 -1750
-675 -1194 -818 -1043 -2113 -2422 -2207 -1771
