-1646 -1227 -510 -511 -591 -858 -869 -530
-1171 -632 -401 -822 -563 -723 -654 -304
-519 -893 -1128 -1080 -118 -661 -947 -826
-177 1 -389 -976 -17 -495 -848 -670
-866 -451 -260 -414 282 -53 -320 -254
-402 -508 -198 -308 -141 349 752 229
-502 -646 -192 -420 -300 912 1107 -95
-239 -112 150 -69 187 1286 555 -125
