539 -129 -428 -745 -560 -409 42 501
-274 -1443 -1892 -2172 -2054 -1508 -1193 -565
-890 -1706 -2305 -2262 -1776 -1309 -1463 -1047
-230 -618 -1270 -764 -235 -338 -749 -446
304 -866 -1590 -574 -359 165 95 -92
-574 -976 -1438 -927 -313 396 -439 -907
-730 -1022 -913 46 652 89 -1443 -906
-841 -1028 -358 455 4 -800 -935 -191
