-649 159 10 221 -66 12 209 -69
-1643 -863 -748 -353 -1104 -1119 -20 -149
-2393 -2046 -1279 240 -1476 -1895 -469 -29
-2127 -2265 -1636 -49 -1415 -1783 -370 682
-439 -760 -1559 -884 -1389 -1231 -55 719
-22 -738 -1483 -952 -868 -881 85 120
-629 -329 -493 -558 -499 -584 -725 -369
-326 289 136 -224 238 -687 -1302 -145
