-544 -50 -2 446 323 -16 271 -649
-676 -867 -974 332 -67 -689 -357 -1008
-239 -1163 -1281 463 301 -438 -182 -388
-159 -889 -1348 -322 38 -434 -665 -596
264 -243 -1106 -313 98 -179 -657 -971
319 -233 -730 -113 438 20 -1107 -1521
-132 152 425 888 553 -476 -1762 -1097
-48 75 171 -21 -831 -1434 -1257 -415
