-317 -662 -661 -566 -488 -440 -512 -364
-532 -1147 -1108 -877 -732 -779 -746 -393
-715 -1272 -1110 -879 -812 -996 -859 -427
-644 -1203 -1095 -987 -828 -1158 -991 -512
-450 -730 -897 -1062 -983 -1230 -926 -552
-390 -640 -865 -1027 -1069 -1028 -985 -702
-347 -476 -648 -929 -1044 -970 -1134 -590
-202 -350 -456 -570 -521 -743 -705 -377
