-375 -629 -416 -370 -332 -307 -382 -385
-488 -801 -632 -513 -543 -525 -611 -424
-392 -689 -662 -569 -688 -659 -603 -381
-492 -827 -815 -784 -660 -762 -686 -453
-447 -661 -675 -739 -799 -882 -786 -564
-273 -589 -737 -637 -777 -907 -793 -453
-234 -390 -531 -742 -921 -912 -666 -411
-179 -245 -379 -571 -612 -483 -444 -323
