-901 -1403 -1171 -617 -390 -751 -1191 -731
-801 -1321 -1972 -1090 -404 -617 -788 -536
-704 -48 -957 -818 -438 -350 -535 -346
-257 137 -224 -22 564 724 56 -441
-705 161 -449 -344 361 359 -27 -751
-615 70 -79 -8 459 -55 59 -723
-474 -438 -320 23 183 -424 -690 -808
-430 -390 -2 38 -27 -308 -547 -285
