-1353 -1506 -900 -364 -638 -844 -900 -657
-644 -349 -675 753 244 -164 129 313
-639 529 -1023 -79 -142 -1206 53 787
-501 699 -1008 -3 228 -1242 -312 137
-449 164 -1086 253 716 -667 -1022 -1061
-247 415 -8 490 746 -858 -1588 -1057
-276 69 534 325 9 -1026 -1197 -270
-141 -130 185 -108 -423 -134 -245 -86
