-107 -496 -257 -227 -39 -7 -435 -108
-647 -1798 -1373 -1681 -1019 -755 -994 -486
-1135 -1647 -649 -1168 -1077 -594 -845 -542
-753 -1106 -210 -626 -1079 -572 29 -61
-424 -595 -25 -795 -942 -383 1069 1012
-249 -765 -526 -496 -163 -164 486 249
-387 -709 -610 -655 -219 -110 -153 84
-344 -484 -664 -953 -188 -12 -11 504
