-676 -1271 -928 -450 -466 -486 -374 -787
-592 -1029 -685 -340 41 150 507 -335
-660 -548 -903 -890 -501 -248 23 -95
-320 -1214 -1163 -617 -627 -848 -886 -722
-122 -1170 -1612 -918 -215 -701 -658 -991
-191 -490 -652 -705 -218 181 -467 -698
-541 -458 -334 -900 -281 -181 -710 -656
-396 -342 -165 -252 -460 -702 -985 -1036
