-1378 -885 -304 -187 -512 -647 -439 -320
-1430 -866 -442 -739 -513 -926 -1342 -546
-36 573 -91 -788 -339 -632 -538 -90
134 381 -203 -764 -234 -201 -613 -803
-1043 -710 -589 -254 519 412 -841 -1333
-793 330 648 441 883 161 -1171 -1176
6 161 134 98 109 -837 -931 -257
-371 -764 -470 -594 -1074 -1053 -387 -528
