-755 -885 -143 -183 -233 -487 -861 -837
-230 -406 940 769 861 602 -714 -1283
476 -260 131 85 233 1208 848 -264
-618 -631 -360 -860 -929 438 560 -284
-1370 -1683 -530 -1155 -841 -271 -510 -652
-445 -855 -510 -284 -156 -1320 -1131 -943
-116 -721 -785 -108 -1334 -2282 -1332 -581
-200 -629 -366 -774 -1696 -2055 -1484 -543
