-484 -563 -554 -558 -474 -458 -509 -390
-691 -696 -671 -726 -670 -543 -584 -471
-817 -814 -829 -960 -790 -784 -678 -521
-794 -971 -886 -809 -880 -1054 -1009 -674
-466 -866 -1009 -832 -951 -1165 -1258 -560
-407 -782 -923 -956 -1164 -1266 -1120 -796
-366 -634 -743 -994 -1236 -1055 -966 -674
-218 -320 -395 -722 -712 -755 -690 -442
