-974 -262 -105 75 -146 -463 -676 -318
-242 373 -397 -203 -57 -88 275 180
-145 899 679 557 233 196 476 241
222 950 632 532 229 826 721 471
-8 1223 883 307 -475 -638 -406 200
-16 797 302 -324 -1518 -1472 -498 97
-477 -322 -693 -1691 -2433 -1800 -662 -47
-247 -17 -409 -1297 -1169 -772 -302 -48
