-248 -393 -107 -29 71 -16 -81 -96
-1346 -2487 -3068 -2389 -2206 -2099 -1984 -1109
-1375 -1916 -2142 -1236 -1552 -1833 -2654 -1676
-251 -722 -1282 -467 -621 -1144 -1950 -1430
739 1071 -211 -489 -1238 -1587 -1677 -782
-179 805 6 -732 -1633 -1998 -1531 -1205
-721 -27 16 -566 -1152 -711 -822 -1068
-702 28 429 214 -57 -21 -156 -111
