-1328 -535 -588 -120 78 -208 -645 -269
-716 -433 -992 -457 -97 -422 -755 -563
-1037 -335 -219 -81 -282 -182 -239 -94
-1800 -219 273 104 -813 -494 -463 239
-1272 -129 193 274 -1235 -1427 -347 843
-815 -503 -611 -402 -2115 -1933 -95 544
-1089 -1111 -1179 -1914 -2549 -1149 71 317
-816 -507 -808 -1995 -1625 -735 -580 185
