-384 -256 -429 -721 -418 -499 -566 -388
-396 -311 133 -1262 -274 -626 -1089 -929
-35 -399 157 -568 159 126 -940 -1109
3 631 783 -115 175 -101 -200 -358
-40 639 898 -432 -834 -279 612 282
46 266 108 -1097 -969 713 959 66
-310 -17 -366 -1000 -129 1206 689 -533
-93 -74 44 47 637 706 100 -551
