-701 -1007 -253 -49 -90 -434 -717 -46
-2296 -3301 -2209 -1892 -2110 -2265 -1897 -794
-2684 -2443 -1572 -1930 -1933 -2047 -1756 -974
-805 -473 -877 -1577 -1366 -817 -934 -800
-260 -22 -862 -911 -258 497 64 -477
-690 -527 -511 279 1000 561 -665 -1018
-394 -570 -339 672 782 -419 -1145 -362
-124 -412 -76 327 -72 -484 -111 207
