-446 -336 -242 -331 -387 -493 -76 -761
-453 -878 -770 -475 -843 -968 -415 -528
-57 -563 -1561 -1461 -1516 -1413 -831 -339
634 -749 -1373 -1156 -1038 -1003 -1719 -1175
1350 -377 -1546 -403 403 -365 -2322 -2083
814 559 -736 -78 287 -1592 -2902 -1915
307 385 -236 -367 -1737 -2465 -3451 -2361
-81 -173 -335 -955 -2484 -2343 -2216 -1517
