-1292 -1583 -838 -770 -532 -428 -720 -1024
-1604 -1816 -900 -1088 -703 -449 -635 -1118
-1475 -924 436 65 -36 167 -33 -252
-578 -786 213 417 -86 27 402 -258
-864 -1566 -413 147 -477 -278 148 -418
-841 -1136 -416 23 15 -286 -286 -397
-581 -568 -144 163 -159 -590 -78 54
-514 -249 -29 -812 -973 -765 -493 -238
