-317 -581 88 166 149 -43 -62 -315
846 -960 -976 -85 502 536 289 -421
1040 -567 -1742 -830 52 156 467 -105
519 181 -922 -869 -592 -845 -961 -651
-571 -141 -201 -346 -436 -1491 -2193 -1614
-486 -748 -635 -582 -307 -1544 -2168 -1615
-559 -935 -857 -799 -1137 -2325 -1980 -1282
-546 -805 -504 -697 -1266 -1732 -1126 -369
