-184 -468 -157 -351 -381 -531 -241 -299
24 -116 481 -11 -169 -285 -681 -694
364 -1017 -285 -77 -147 178 -588 -625
-480 -1596 -1455 -309 -327 134 -1 -309
-1104 -1936 -1359 -147 -674 1 106 -134
-388 -1215 -407 -30 -916 -252 -405 296
-64 -408 -278 -606 -856 -956 -345 127
347 -67 -514 -675 -795 -1078 -577 -274
