-149 -696 -735 -466 -430 -351 -402 -673
97 -297 -1008 -106 -244 -94 160 -56
-367 -1321 -1864 -682 -1038 -771 -493 -532
-648 -1135 -906 141 -332 -684 -825 -691
-91 -598 -832 123 69 -355 -621 -256
468 395 -157 24 -601 -1555 -970 -121
46 -58 -220 -360 -1474 -1846 -869 -144
-404 -319 -319 -610 -959 -546 -93 247
