-1284 -1592 -1050 -527 -687 -982 -1137 -1060
-209 -297 -1064 -96 -47 -529 -308 -195
-109 415 -1073 -485 -147 -686 -143 -94
26 309 -545 -129 191 124 -80 -238
226 484 -568 -354 -255 -318 -660 -597
-449 98 -265 -421 -543 -628 -888 -573
-499 -592 -533 -576 -334 -323 -447 -643
-308 -236 -56 376 94 249 -390 -777
