-1133 -980 -521 -208 -387 -695 -341 -607
-1626 -869 -1315 -829 -783 -1433 -761 -965
-985 -232 -1554 -1460 -726 -1271 -692 -647
-898 -849 -1407 -896 78 -427 -1069 -841
27 -273 -1011 151 600 -180 -581 -11
-6 221 -220 25 -34 -89 -349 0
-195 -162 -428 -874 -403 531 -375 -530
-511 -472 -456 -807 -448 154 -708 -550
