-178 -416 -590 -586 -655 -772 -452 -560
-557 -1500 -1412 -1068 -1386 -1314 -1254 -1068
-386 -971 -1131 -710 -710 -538 -758 -432
436 -444 -1511 -589 -569 -244 -175 -207
-24 -760 -1296 -377 -953 -303 -110 -320
-36 -312 -656 -217 -5 255 8 -679
96 54 -386 -66 147 -311 -667 -635
-56 -184 -498 -592 -573 -525 -213 122
