532 -1040 -1423 -1407 -1014 -335 -331 -139
-768 -2678 -3084 -2598 -2440 -2204 -2040 -1105
-1810 -2833 -1259 -508 -769 -1828 -1904 -1387
-406 -598 166 46 -115 -709 -371 -228
155 -74 -300 -1050 -706 535 1384 491
-700 -1136 -741 -1210 62 1361 348 27
-331 -476 61 517 1384 366 -399 -97
437 188 546 1068 865 311 287 428
