-415 -446 -37 211 -34 -160 -216 -399
-1203 -1695 -822 -120 -528 -1125 -1044 -985
-930 -1515 -870 -275 -376 -630 -448 -704
-141 -1221 -1615 -1254 -1090 -631 -113 -250
-791 -1876 -1429 -713 -1071 -1640 -970 -622
-288 -929 0 230 -928 -1771 -1236 -733
-154 -265 383 80 -811 -1149 -1279 -558
34 -150 -262 -692 -820 -745 -856 -257
