-641 -1280 -628 -195 -414 -572 -915 -990
-1742 -2915 -1538 -715 -788 -820 -995 -1312
-1583 -1609 -936 -473 -709 -731 -528 -253
-1427 -1268 -281 895 17 -238 -606 -685
-823 -980 -426 544 597 894 8 -328
-760 -787 -813 411 1096 822 405 138
-559 -1003 -918 177 624 -407 -120 116
-515 -529 -253 458 -217 -912 -673 -432
