132 342 87 -39 -1 4 123 -227
268 408 762 779 327 -163 -114 -308
-591 -881 -87 758 180 -477 -443 -295
-667 -1108 -362 231 -574 -1151 -1275 -454
339 -479 -407 -117 -538 -1109 -1168 -151
64 -766 -1117 -362 -482 -1215 -945 -709
-311 -500 -427 -82 -1007 -1076 -1246 -1080
-298 -35 -9 -383 -1027 -1172 -1552 -970
