691 -113 -178 40 21 193 554 -222
563 60 526 711 154 302 293 -199
185 -35 450 772 189 260 252 194
-330 -1456 -1213 -194 -811 -646 302 644
275 -922 -1173 -709 -1843 -1393 731 1043
377 -507 -1164 -1592 -2698 -559 691 590
-90 -50 -802 -2120 -1184 248 64 149
267 452 -293 -1008 173 3 -284 -241
