-2155 -1573 -1507 -1172 -1110 -1308 -1479 -979
-2210 -1593 -1728 -1587 -1572 -1762 -2185 -1643
-1764 -924 -21 -265 -680 -197 -851 -944
-1315 -365 75 251 -420 1031 333 -168
-1761 -1048 -355 255 -241 1274 1296 338
-1417 -1738 -958 57 176 703 977 297
-913 -1412 -968 -440 -457 -644 104 183
-615 -778 -842 -849 -1186 -1169 -602 83
