738 581 507 491 488 471 595 488
601 315 150 160 209 247 479 489
291 252 0 0 0 0 270 317
0 0 0 78 0 0 0 98
368 225 0 0 0 0 0 286
220 236 0 0 0 0 0 211
244 76 0 0 0 72 36 278
0 45 85 0 86 161 0 219
