0 0 0 0 0 0 0 0
0 0 0 0 26 0 0 0
0 52 198 140 0 9 0 0
0 119 152 117 0 261 0 0
0 15 33 24 0 392 181 43
0 0 123 146 340 335 0 79
0 0 274 186 229 0 295 144
0 56 0 25 0 125 239 0
