0 0 0 0 0 0 0 0
0 0 0 0 0 0 0 0
0 0 0 402 199 109 0 0
133 0 0 0 0 113 119 125
0 78 0 0 0 0 0 0
0 50 14 153 48 27 0 0
0 192 294 255 256 271 0 0
55 204 97 117 56 0 56 0
