57 12 66 41 28 76 15 0
0 0 252 43 48 105 15 0
66 0 249 0 170 109 148 0
127 0 159 0 55 319 468 44
38 0 311 93 0 42 26 27
69 0 194 263 0 0 0 107
62 0 9 205 0 0 3 128
0 0 60 110 0 0 133 197
