0 0 0 0 0 0 0 0
0 0 239 0 0 0 0 0
50 0 481 397 42 244 84 0
178 0 37 106 0 121 423 0
20 0 284 108 147 0 0 0
0 0 0 188 42 0 0 41
0 0 0 106 74 0 0 37
37 0 0 0 0 0 0 216
