36 0 0 0 0 0 0 10
0 0 443 457 76 0 0 47
0 0 40 342 2 27 0 93
156 160 0 0 0 0 0 95
266 321 0 0 21 0 0 0
310 203 0 140 138 0 0 0
124 131 0 117 0 0 0 0
0 0 39 1 0 0 0 0
