879 172 197 184 192 183 148 349
727 0 0 0 0 0 0 49
473 141 420 309 302 366 220 0
538 222 198 4 270 239 271 119
246 126 293 0 135 103 108 138
321 82 61 0 122 185 75 156
218 49 92 112 203 133 0 41
200 58 15 82 73 53 43 24
