539 68 64 32 31 26 22 0
392 0 168 0 0 17 0 0
85 0 249 0 0 74 0 0
0 0 40 0 0 0 319 135
250 0 87 0 0 13 360 118
216 0 0 0 0 32 0 37
73 0 0 0 0 90 0 52
141 0 0 0 94 0 0 32
