0 0 0 0 0 0 0 0
0 0 0 2 0 0 0 0
0 0 0 0 0 0 0 18
79 17 0 122 3 74 31 0
149 0 0 66 58 97 0 0
66 104 44 25 31 0 0 24
67 0 0 0 0 0 0 103
0 0 0 0 0 0 51 66
