0 0 0 0 0 0 0 0
0 23 143 239 191 11 0 0
98 0 0 0 0 80 36 30
0 0 0 0 0 0 0 0
141 251 0 0 0 0 0 0
0 41 0 0 0 0 0 0
81 266 162 0 66 0 0 0
71 113 7 0 0 0 0 40
