0 0 0 0 0 0 0 0
0 0 0 0 0 0 0 0
0 0 33 0 0 1 0 0
304 295 201 0 56 215 89 85
0 0 0 0 0 200 214 0
0 0 0 0 0 288 34 0
0 0 0 28 163 0 165 236
88 0 0 234 0 85 231 51
