21 0 0 0 0 0 0 78
0 0 245 283 237 80 0 0
550 0 1 226 236 421 356 154
602 317 49 0 0 0 102 83
7 0 0 0 3 25 60 17
0 0 0 145 0 75 0 0
0 6 0 88 109 0 16 68
81 0 0 0 127 57 55 213
