0 1 1 0 28 13 124 222
0 219 0 111 70 0 89 239
261 240 40 130 168 19 108 114
185 52 0 67 156 0 0 0
0 208 59 106 171 0 0 0
0 0 0 68 62 0 0 0
0 0 0 89 0 0 0 0
0 0 56 0 0 0 0 30
