66 0 0 0 0 0 0 587
0 12 130 0 0 0 0 354
39 415 408 0 27 0 2 364
151 436 330 0 229 279 75 363
0 240 30 0 257 255 368 319
16 79 0 0 0 0 268 0
0 0 0 0 0 192 200 0
0 0 0 0 107 100 0 39
