0 0 0 0 0 0 0 68
0 0 471 381 199 217 31 49
174 106 600 279 0 162 98 306
0 340 551 0 0 67 141 346
37 9 144 11 26 390 298 183
101 71 198 117 110 257 95 168
340 409 312 42 26 0 301 198
363 127 0 7 0 94 152 167
