0 0 0 0 0 0 0 0
0 0 0 0 0 0 0 44
0 275 410 85 0 0 0 30
0 0 230 315 18 0 9 0
0 0 173 142 136 69 122 100
0 0 163 135 67 0 166 94
0 0 0 0 0 156 255 102
0 0 0 0 44 50 38 0
