0 0 0 0 0 0 0 0
0 0 0 0 0 0 0 0
80 0 0 119 257 322 185 0
260 270 110 164 230 463 399 9
133 72 102 65 264 406 311 8
9 0 127 262 283 346 185 0
0 0 80 257 279 154 44 43
0 0 0 263 176 0 209 85
