282 326 227 189 195 281 355 480
103 96 0 0 0 0 160 242
0 0 2 188 0 0 0 0
50 118 0 123 0 72 0 0
352 361 0 0 0 23 121 70
70 2 0 0 0 0 0 0
38 30 28 56 0 0 0 0
0 40 52 178 0 0 0 0
