0 0 0 0 0 0 0 0
0 0 0 0 62 126 0 0
0 248 73 0 64 81 0 0
0 65 287 149 30 92 0 33
0 336 417 46 5 143 263 111
0 182 180 0 30 92 336 170
0 0 1 0 193 104 112 108
0 0 0 0 0 63 35 115
