0 0 0 0 0 0 0 39
0 0 0 0 0 0 0 3
0 0 218 0 0 69 0 0
190 0 198 66 136 163 138 0
0 0 236 23 9 82 82 0
0 0 175 31 4 27 0 0
0 0 149 121 0 0 54 78
0 0 0 33 0 0 125 63
