0 0 0 0 0 0 0 0
0 0 0 0 0 0 0 0
0 0 0 68 229 0 37 0
134 0 38 187 488 178 25 0
99 0 202 53 423 66 304 0
0 0 0 110 226 406 184 71
0 0 0 117 348 262 0 124
0 0 0 125 149 8 66 97
