180 253 239 244 263 251 294 434
0 341 0 60 99 74 9 22
0 538 0 150 167 0 7 0
27 274 0 0 116 0 62 0
0 380 55 0 0 0 147 0
0 318 98 0 47 30 0 0
0 0 120 0 251 0 69 0
0 0 45 18 242 198 256 0
