252 203 177 183 168 168 170 167
69 1 59 34 0 17 0 0
0 0 0 0 41 0 0 0
165 0 0 42 65 23 68 166
66 0 48 0 0 161 369 36
0 0 26 0 20 987 835 172
158 98 60 0 1349 1254 80 0
164 167 0 694 1233 266 138 0
