0 0 0 0 0 0 0 0
0 0 0 64 16 0 0 0
0 0 336 327 174 349 62 0
78 0 0 0 0 194 24 164
0 0 0 8 0 0 0 0
0 0 0 190 0 0 0 0
0 0 4 184 0 0 0 0
0 0 15 0 0 0 0 0
