0 0 0 0 0 0 0 0
0 0 0 0 0 0 0 0
0 9 0 0 63 0 23 0
0 0 0 43 202 163 112 0
0 79 126 18 209 445 0 0
0 165 121 39 395 419 108 0
100 122 10 216 225 33 224 43
0 0 4 126 0 98 168 0
