0 0 0 0 0 0 0 0
147 21 96 0 8 167 113 0
220 172 37 0 0 204 178 0
0 0 316 327 83 104 121 0
0 0 398 259 183 159 34 55
0 0 317 230 131 158 321 213
46 0 0 38 14 105 415 111
0 0 0 58 0 295 234 20
