388 148 110 90 109 122 120 63
284 57 98 0 84 258 226 0
437 425 0 0 0 270 377 119
0 61 0 57 0 0 61 61
73 0 47 167 0 0 160 0
98 0 38 118 0 0 41 0
0 0 0 0 0 0 76 24
0 45 0 61 77 104 131 33
