0 0 0 0 0 0 0 0
0 0 0 0 0 0 0 0
0 148 193 6 326 289 0 0
84 48 117 195 302 370 231 23
0 0 186 258 257 241 144 71
0 0 105 187 228 193 77 151
0 0 0 0 9 18 152 165
0 0 0 137 184 0 274 238
