289 85 57 34 71 105 92 186
342 265 87 99 70 73 145 253
196 353 0 0 0 0 110 230
0 0 0 0 0 0 0 0
0 67 0 0 0 0 0 0
0 0 0 0 0 0 194 74
77 0 0 0 0 212 87 37
0 0 0 0 55 136 0 0
