0 0 0 0 0 0 74 314
0 91 0 0 0 0 0 140
0 415 0 0 91 0 0 0
0 332 0 0 0 0 0 80
0 573 54 0 0 0 0 157
0 366 56 0 0 0 37 0
0 26 122 0 0 178 271 0
0 0 103 0 0 0 0 0
