397 288 303 248 267 273 255 159
414 168 0 0 0 155 186 174
166 59 0 17 14 0 17 77
133 0 0 0 0 0 0 0
197 79 0 0 0 0 0 0
107 36 0 0 0 0 0 5
0 36 38 0 30 140 0 0
224 181 169 181 359 249 172 131
