0 0 0 0 0 0 0 0 0 0 0 0 0 0 0 0 0 0 0 0 0 0 0 0 0 0 0 0 0 0 0 0 
0 0 0 0 0 0 0 0 0 0 0 0 0 0 0 0 0 0 0 0 0 0 0 0 0 0 0 0 0 0 0 29 
0 0 0 0 0 0 0 0 0 0 0 0 0 0 0 0 0 0 0 0 0 0 0 0 0 0 0 0 0 0 0 0 
0 0 0 0 0 0 0 0 0 0 0 0 0 0 0 0 0 0 0 0 0 0 0 0 0 0 0 0 0 0 0 0 
0 0 0 0 0 0 0 0 0 0 0 0 0 0 0 0 0 0 0 0 0 0 0 0 0 0 0 0 0 0 0 0 
0 0 0 0 0 0 0 0 0 6 10 14 16 15 14 15 18 14 5 0 0 0 0 0 0 0 0 0 0 0 0 0 
0 0 0 0 0 0 0 4 16 0 0 0 0 0 0 0 0 0 0 0 0 0 0 0 0 0 0 0 0 0 0 0 
0 0 0 0 0 0 0 6 0 0 0 0 0 0 0 0 0 0 0 0 0 0 0 0 0 0 0 0 0 0 0 0 
0 0 0 0 0 0 0 0 0 0 43 75 81 82 81 83 82 82 66 11 15 44 8 0 0 0 0 0 0 0 0 0 
0 0 0 0 0 0 0 0 0 31 40 45 41 38 37 35 28 16 10 14 17 0 0 0 0 0 0 0 0 0 2 0 
0 0 0 0 0 0 0 0 0 12 0 0 0 0 0 0 0 0 2 0 0 0 0 37 31 0 0 0 0 0 0 0 
16 0 0 0 0 2 9 0 0 7 0 0 4 14 9 5 1 11 19 0 0 30 64 53 0 11 0 0 0 0 0 0 
10 0 67 53 0 6 0 0 0 0 0 0 5 2 0 0 0 0 0 0 0 32 19 0 0 0 0 0 0 0 0 0 
35 39 62 0 0 0 0 0 0 19 5 0 0 0 0 0 0 0 0 0 3 50 0 0 12 0 0 34 50 77 79 55 
15 2 0 0 0 14 45 93 57 52 0 0 0 1 0 0 0 0 3 24 40 8 0 0 0 25 49 106 106 99 46 0 
0 0 14 42 82 94 110 72 4 0 0 0 5 0 0 0 0 0 13 13 0 0 0 0 2 0 0 2 0 0 0 0 
0 0 0 0 0 0 0 0 0 0 0 14 0 0 2 0 0 0 9 0 0 20 0 0 0 0 0 0 0 0 0 14 
0 0 0 0 1 0 0 0 0 8 0 0 14 16 3 0 0 0 0 2 54 0 0 0 0 14 32 0 0 17 28 0 
5 0 0 0 0 0 0 0 0 12 0 19 14 0 0 0 0 0 0 0 0 0 23 37 21 39 15 0 0 1 0 0 
0 0 0 11 33 47 51 38 1 10 0 0 0 0 0 0 1 0 0 0 0 42 38 0 0 44 0 0 0 14 0 0 
30 41 52 35 12 0 0 0 0 2 0 0 0 0 0 9 0 0 0 0 36 67 0 0 86 24 0 0 12 32 6 0 
5 0 0 0 0 0 0 10 1 0 0 0 0 0 9 0 0 0 20 13 0 0 0 54 36 0 0 0 14 0 0 0 
0 0 0 0 13 28 25 0 0 0 14 0 15 34 27 19 12 16 20 0 0 0 13 16 0 0 0 0 15 0 0 0 
7 11 22 19 13 4 0 0 16 72 5 0 0 0 0 0 0 0 0 0 0 42 43 0 0 0 0 0 0 0 1 0 
10 0 4 7 9 4 0 22 18 0 0 0 0 0 0 0 0 0 0 0 69 50 0 0 0 0 0 29 4 0 0 0 
6 0 0 0 0 0 0 0 0 0 24 20 6 22 48 36 29 28 36 84 79 0 0 0 0 0 0 0 0 0 0 0 
8 0 0 0 0 0 0 19 71 76 29 8 18 16 12 10 6 8 46 39 0 0 0 10 0 0 2 13 34 1 0 0 
0 0 0 0 0 34 65 57 23 0 0 0 0 0 0 0 0 6 25 0 0 0 3 0 0 0 27 30 25 2 0 0 
0 0 0 33 64 49 19 0 0 2 0 0 0 0 0 0 15 42 0 0 0 7 0 0 0 18 29 0 0 0 0 0 
0 16 64 50 13 0 0 0 0 0 0 0 0 0 0 38 42 0 0 0 0 0 0 0 0 41 18 0 0 0 2 4 
35 53 22 0 0 0 2 0 0 0 0 0 0 31 78 48 0 0 0 0 0 0 0 0 26 6 0 0 0 0 0 0 
6 0 0 0 0 0 0 0 0 0 0 0 0 0 0 0 0 0 0 0 0 0 0 16 17 0 0 12 37 24 0 0 
