0 0 0 0 0 0 0 0 0 0 0 0 0 0 0 0 0 0 0 0 0 0 0 0 0 0 0 0 0 0 0 3 
0 0 0 0 0 0 0 0 0 0 0 0 0 0 0 0 0 0 0 0 0 0 0 0 0 0 0 0 0 0 27 40 
0 0 0 0 0 0 0 0 0 0 0 0 0 0 0 0 0 0 0 0 0 0 0 0 0 0 0 0 0 0 0 0 
0 0 0 0 0 0 0 0 0 0 0 0 0 0 0 0 0 0 0 0 0 0 0 0 0 0 0 0 0 0 0 0 
0 0 0 0 0 0 0 0 0 0 0 0 0 0 0 0 0 0 0 0 0 0 0 0 0 0 0 0 0 0 0 0 
0 0 0 0 0 0 0 0 0 0 0 0 0 0 0 0 0 0 0 0 0 0 0 0 0 0 0 0 0 0 0 0 
0 0 0 0 0 0 0 0 0 0 0 0 0 4 4 1 1 11 23 0 0 0 0 0 0 0 0 0 0 0 0 0 
0 0 0 0 0 0 0 0 0 32 71 53 48 48 42 36 37 57 45 0 3 34 0 0 0 0 0 0 0 0 0 0 
0 0 0 0 0 0 0 0 2 72 51 17 3 0 1 0 0 0 0 0 17 0 0 0 0 0 0 0 0 0 0 0 
17 0 0 0 0 0 0 0 29 32 0 0 0 0 0 0 0 0 0 0 0 0 4 38 37 0 0 0 0 0 0 0 
66 0 0 0 0 0 0 0 16 15 0 0 7 4 0 0 0 0 0 0 0 20 35 0 0 10 0 0 0 0 0 0 
26 6 88 2 0 0 0 0 14 11 0 0 8 0 0 0 0 0 0 0 1 29 0 0 0 10 0 1 5 0 16 19 
0 53 69 0 0 0 0 71 56 0 0 0 0 0 0 0 0 0 0 0 8 0 0 0 28 0 0 28 20 2 26 15 
0 0 0 0 32 6 56 68 38 0 0 0 0 0 0 0 0 0 0 0 0 0 0 0 2 0 31 11 0 0 0 0 
0 0 0 0 44 46 60 0 0 0 0 0 0 0 0 0 0 0 0 0 0 0 14 0 9 0 14 0 0 0 0 0 
0 0 0 0 0 0 0 0 0 0 24 1 0 0 0 0 0 0 0 0 0 0 0 41 17 0 0 0 0 0 62 38 
0 0 5 0 0 0 0 0 1 21 6 0 0 0 0 0 0 0 0 0 28 0 0 49 0 44 0 0 2 73 68 0 
0 0 0 0 0 0 0 0 16 16 0 0 0 0 0 0 0 0 0 21 0 0 63 5 10 32 0 0 10 35 0 0 
0 0 0 0 0 0 0 0 0 3 0 0 0 0 0 3 0 0 0 0 0 85 28 0 0 0 0 0 16 7 0 0 
3 0 0 0 0 0 0 0 0 12 0 0 0 0 0 0 0 0 0 0 64 64 0 0 16 0 0 0 39 0 0 0 
0 0 0 0 0 0 0 0 9 0 0 0 0 17 0 0 0 0 16 21 0 0 0 30 0 0 0 39 29 0 0 0 
0 0 0 0 0 1 1 0 0 0 0 0 0 2 0 0 0 0 0 0 0 0 25 0 0 0 23 47 0 0 0 0 
0 0 0 0 0 0 0 0 12 29 0 0 0 0 0 0 0 0 0 0 0 27 11 0 0 7 26 26 0 0 0 0 
5 0 0 0 0 0 0 1 31 0 0 21 4 0 0 0 0 0 0 1 41 0 0 0 22 9 31 19 0 0 0 0 
2 0 0 0 0 0 0 0 0 0 37 21 0 16 24 5 2 0 8 77 0 0 0 20 3 0 40 0 0 0 0 0 
0 0 0 0 0 0 10 11 26 62 26 0 0 13 1 0 0 8 44 0 0 0 39 14 0 4 19 0 7 0 0 0 
0 0 0 0 10 38 38 33 17 0 0 0 0 0 0 0 0 10 0 0 0 28 19 0 0 38 2 0 0 0 0 0 
0 0 3 37 45 24 0 0 0 0 0 0 0 0 0 0 12 16 0 0 27 29 0 0 8 55 0 0 0 0 7 0 
0 12 47 24 0 0 0 0 0 0 0 0 0 2 1 23 19 0 0 17 26 0 0 0 34 21 0 0 0 2 16 0 
32 26 0 0 0 0 0 0 0 0 0 0 0 7 35 7 0 0 0 26 0 0 0 5 56 0 0 0 0 0 0 0 
18 0 0 0 0 0 0 0 0 0 0 0 0 0 0 0 0 6 15 0 0 0 0 43 4 0 0 22 29 0 0 0 
0 0 0 0 0 0 0 0 0 0 0 0 0 0 0 0 36 34 5 0 0 0 14 0 0 0 9 0 0 0 0 0 
