0 0 0 0 0 0 0 0 0 0 0 0 0 0 0 0 0 0 0 0 0 0 0 0 0 0 0 0 0 0 0 0 
2 19 0 1 2 0 0 1 1 0 0 0 0 0 1 3 0 0 0 0 6 3 0 0 3 2 2 3 3 2 5 0 
0 14 0 0 0 0 0 0 0 0 0 0 0 0 0 0 1 0 0 0 0 3 0 0 0 0 0 0 0 0 0 0 
0 11 0 0 0 0 0 0 0 0 0 0 0 0 0 0 0 2 0 0 0 0 6 1 0 0 0 0 0 0 0 0 
0 11 0 0 0 0 0 0 0 0 0 0 0 0 0 0 0 0 0 0 0 0 0 0 0 0 0 0 0 0 0 0 
0 13 0 0 0 0 0 0 0 0 0 0 0 0 0 0 0 0 0 2 0 0 0 0 0 0 0 0 0 0 0 0 
0 12 0 0 0 0 0 0 0 0 0 0 0 0 0 0 0 0 0 0 0 0 0 0 0 0 0 0 0 0 0 0 
0 7 0 0 0 0 0 0 0 32 18 4 8 15 15 8 12 21 22 0 0 0 0 0 0 0 0 0 0 0 0 0 
0 13 0 0 0 0 0 0 0 4 39 44 44 50 55 51 39 48 66 56 13 20 15 0 0 0 0 0 0 0 0 0 
0 1 0 0 0 0 0 0 0 0 0 0 0 0 0 0 0 0 0 0 40 45 21 18 0 0 0 0 0 0 0 0 
35 0 0 0 6 0 0 0 0 0 0 0 1 0 0 0 0 0 12 0 0 21 39 31 82 44 0 0 0 0 0 0 
64 80 31 0 0 0 0 0 0 0 0 2 15 12 12 4 0 0 0 17 0 0 4 13 7 63 22 14 0 9 0 0 
0 63 108 39 0 0 5 47 0 0 0 0 0 0 1 4 9 3 0 0 0 0 0 14 0 12 21 33 29 22 12 5 
0 0 41 120 38 0 0 38 53 0 0 8 2 0 0 0 0 18 23 0 0 16 0 0 23 12 17 4 41 29 2 24 
0 0 0 42 92 68 11 0 77 48 0 0 0 12 4 5 0 0 19 16 0 11 19 0 0 0 0 0 0 11 2 0 
0 0 0 0 0 27 48 0 0 54 29 0 0 0 3 4 23 0 0 7 1 0 11 28 0 0 11 0 0 0 0 0 
0 7 0 0 0 0 0 0 0 0 14 14 0 4 0 0 9 26 21 0 0 0 0 27 35 0 11 2 0 0 0 1 
0 10 0 0 6 12 12 6 0 0 1 6 0 0 22 0 0 0 12 2 3 6 0 2 16 38 20 26 2 11 0 4 
0 13 17 9 0 0 0 0 0 0 0 18 2 0 0 13 0 0 0 38 0 0 0 0 14 12 18 28 0 0 0 0 
6 1 0 0 6 3 6 12 0 8 0 4 21 0 0 0 0 12 0 0 37 41 9 0 0 0 0 14 21 11 0 0 
0 19 14 1 3 5 0 0 0 0 12 0 24 18 0 0 0 0 7 0 0 45 5 10 0 0 0 0 0 0 15 0 
0 0 0 0 0 0 0 11 0 0 1 1 11 32 19 6 0 0 0 20 6 0 2 0 0 0 4 9 10 0 0 0 
0 9 0 3 10 10 2 15 13 0 0 0 0 0 19 11 22 28 0 0 40 16 36 0 0 0 0 3 4 19 0 0 
0 19 17 10 0 0 1 0 0 0 22 5 0 0 0 0 0 0 34 0 0 0 13 39 0 0 0 2 0 0 0 0 
0 0 0 6 0 0 0 0 19 3 0 0 33 33 0 11 17 0 0 9 0 0 0 0 0 0 3 0 7 0 0 0 
0 10 0 0 0 10 17 2 0 0 0 0 0 17 23 0 29 20 0 0 0 8 3 0 0 0 19 21 0 0 1 0 
0 1 0 4 2 0 5 15 27 19 8 0 0 0 0 0 0 0 0 0 0 0 0 0 0 2 0 21 62 12 0 0 
0 5 8 0 0 0 9 10 0 0 0 0 0 0 0 0 0 0 0 0 0 0 0 0 0 19 0 0 0 46 0 0 
0 0 0 2 5 5 0 0 0 0 0 0 0 5 0 0 0 0 0 0 0 0 0 0 5 8 37 15 0 0 0 0 
7 0 4 5 0 0 0 0 0 0 0 0 0 1 0 0 0 0 0 3 0 0 0 0 3 0 10 3 0 3 2 0 
0 2 0 0 0 0 0 0 0 0 0 0 0 0 0 0 0 0 0 0 0 0 0 2 3 0 0 29 0 0 0 5 
15 1 1 0 0 0 0 2 0 0 0 0 0 15 9 0 0 13 2 0 0 0 0 0 13 16 0 0 54 33 11 0 
