31 83 69 66 65 65 65 62 63 62 61 58 57 56 53 51 52 52 52 52 52 48 45 45 44 43 40 39 38 38 50 45 
95 165 131 130 132 132 129 126 125 126 125 123 122 123 123 120 119 119 120 121 119 115 112 114 117 115 113 111 110 110 116 49 
59 104 81 77 78 79 76 71 71 71 70 68 68 67 65 61 61 61 62 64 64 58 54 54 55 55 52 50 51 51 84 32 
59 103 79 75 74 75 72 68 69 71 70 69 68 66 64 60 58 58 59 64 64 60 59 56 55 52 48 46 48 51 83 32 
59 102 77 72 72 72 68 65 66 70 70 69 69 67 64 61 61 62 60 62 61 57 56 57 55 54 51 49 51 51 83 32 
58 100 74 69 68 69 67 65 66 68 72 74 73 72 70 70 70 66 63 63 58 52 53 54 55 56 55 54 53 54 83 31 
57 96 70 67 65 67 66 75 68 65 73 76 71 67 62 60 57 49 48 50 42 40 47 50 51 51 52 51 52 52 81 29 
53 93 67 64 62 64 67 80 48 25 43 41 32 31 28 28 27 24 19 18 8 21 34 39 44 48 47 46 47 47 77 26 
46 85 60 58 60 62 66 74 28 24 49 45 34 29 26 27 25 19 7 12 13 16 39 34 34 44 45 45 45 45 73 24 
45 75 58 55 56 56 62 68 34 20 24 18 9 4 0 0 0 0 0 0 5 13 33 35 34 39 42 42 41 43 71 23 
43 54 43 44 48 48 52 64 37 16 8 0 0 0 0 0 0 0 0 0 0 3 38 46 30 42 40 34 36 42 70 26 
22 6 14 34 34 53 42 45 31 15 10 0 0 0 0 0 0 0 0 0 0 0 31 31 29 34 33 32 40 46 74 29 
11 0 0 25 42 65 27 24 32 9 10 0 0 1 0 0 0 0 0 0 0 0 19 22 24 19 17 19 45 40 69 19 
14 5 0 0 30 35 8 24 50 7 3 0 0 5 0 0 0 0 0 0 6 0 14 4 13 10 8 17 34 35 56 8 
12 23 25 11 12 19 25 13 31 0 0 0 3 8 1 0 0 0 0 3 12 19 2 0 0 0 0 6 34 32 42 8 
13 17 11 10 10 13 18 11 13 0 0 0 0 5 0 0 0 0 0 0 17 21 0 0 0 0 0 12 40 26 20 0 
21 14 0 0 0 0 8 11 3 0 6 0 0 0 0 0 0 0 0 5 12 0 0 0 0 0 0 38 33 2 13 0 
34 28 15 16 17 18 17 18 7 0 5 0 0 0 0 0 0 0 0 2 0 0 0 0 0 3 13 23 18 7 9 0 
35 29 14 11 7 9 8 12 5 0 1 0 0 1 0 0 0 6 0 0 0 0 0 0 0 9 3 18 7 6 17 0 
30 21 13 14 16 15 11 10 0 0 0 0 0 0 0 0 6 1 0 0 0 0 0 0 0 3 20 21 5 5 12 0 
32 22 9 8 9 10 6 1 0 0 0 0 0 0 0 0 2 0 0 0 0 0 9 21 7 25 32 3 2 6 10 0 
23 17 7 10 10 10 9 7 0 0 12 8 4 9 0 0 0 0 0 0 0 0 3 0 26 52 18 2 0 3 5 0 
29 21 12 13 8 2 0 0 0 7 23 19 21 27 16 9 9 14 8 0 0 0 0 0 45 25 0 2 7 3 1 0 
29 19 7 7 3 0 0 0 14 17 26 19 15 25 13 10 17 20 20 3 0 0 0 40 32 4 0 1 8 0 3 0 
26 14 6 8 9 6 7 16 15 18 16 10 0 11 9 0 8 13 5 3 0 0 35 25 12 2 5 2 9 3 3 0 
26 15 6 5 9 10 7 11 19 17 8 2 0 1 1 0 0 0 0 0 0 49 32 8 1 0 0 6 4 0 0 0 
27 18 6 0 2 12 26 34 29 12 9 8 7 4 4 8 0 0 0 0 49 39 6 5 3 0 1 14 4 0 0 0 
26 15 4 7 15 21 22 22 21 18 14 12 9 6 1 0 0 0 0 24 35 1 0 7 0 0 0 0 1 4 5 0 
19 10 16 23 18 18 18 17 18 17 15 14 10 3 0 0 0 0 23 29 1 0 7 4 0 0 0 0 0 0 0 0 
23 22 21 19 17 15 17 15 13 11 11 13 8 1 0 0 0 23 32 2 0 6 10 0 0 0 9 10 0 0 4 0 
28 36 45 39 32 29 29 29 29 27 28 30 27 18 5 5 38 38 12 9 20 25 10 0 3 20 15 9 5 1 2 0 
9 10 15 11 7 4 6 6 6 4 6 7 0 0 0 32 27 3 0 0 7 6 5 0 0 14 12 6 7 0 6 2 
