14 0 0 0 0 0 0 0 0 0 0 0 0 0 0 0 0 0 0 0 0 0 0 0 0 0 0 0 0 0 18 0 
0 0 0 0 0 0 0 0 0 0 0 0 0 0 0 0 0 0 0 0 0 0 0 0 0 0 0 0 0 0 0 57 
3 0 0 0 0 0 0 0 0 0 0 0 0 0 0 0 0 2 0 0 0 0 10 1 2 5 4 3 0 2 0 43 
4 0 0 0 0 0 0 0 0 0 0 0 0 1 0 0 0 2 0 0 0 0 7 5 3 3 4 6 0 2 0 45 
4 0 0 0 0 0 0 0 0 0 0 0 0 2 2 1 1 2 4 3 0 0 2 3 3 2 2 8 2 0 0 45 
4 0 0 0 0 0 0 0 0 0 0 0 2 8 5 6 6 2 5 5 5 4 4 2 4 1 2 4 4 1 0 46 
6 0 0 0 0 0 0 3 0 7 14 14 17 24 22 18 20 18 21 10 2 8 6 0 3 2 4 4 5 4 0 45 
8 0 0 0 0 0 3 6 0 0 0 0 0 0 0 0 0 0 8 21 0 4 16 0 0 2 5 5 6 6 0 46 
9 3 0 0 0 1 7 2 5 0 0 12 5 10 14 22 17 10 0 51 23 0 31 15 2 4 1 6 8 8 0 48 
36 0 13 0 2 1 5 3 45 0 2 27 22 21 19 24 35 18 0 32 14 0 21 13 13 16 0 1 9 10 0 52 
71 1 18 0 0 2 3 6 50 0 0 13 8 11 7 0 18 2 0 35 0 0 12 3 0 48 13 0 9 18 0 60 
4 25 20 22 0 2 1 14 51 0 0 9 0 9 9 3 21 10 0 38 22 0 8 30 0 10 47 0 11 12 0 60 
0 12 0 91 11 0 0 14 83 0 0 15 0 7 3 0 16 19 0 26 37 0 0 6 0 0 51 0 13 0 0 51 
0 9 0 63 59 5 11 0 115 0 0 14 0 11 5 0 8 0 0 36 42 0 35 0 0 0 51 0 19 5 13 49 
0 23 0 0 22 15 78 0 55 41 2 9 0 7 12 0 25 0 0 48 46 0 56 41 0 0 66 0 9 0 10 35 
1 14 0 0 7 22 86 12 0 0 33 20 0 0 13 0 14 30 0 26 50 0 5 81 0 0 46 21 0 0 1 44 
9 5 22 17 15 10 25 26 18 0 8 26 4 0 15 4 0 28 0 26 51 0 0 33 0 0 0 53 0 0 0 60 
5 7 15 17 11 13 14 25 48 0 0 21 15 0 4 21 0 17 0 52 21 14 12 0 0 0 0 50 13 8 0 58 
9 6 15 18 14 13 8 25 42 0 1 2 30 7 0 16 9 23 0 36 28 38 17 0 0 0 1 36 32 3 0 43 
11 11 11 13 18 21 15 25 47 0 17 0 18 44 0 0 11 14 0 0 27 26 27 21 0 0 0 11 27 0 10 35 
3 12 23 20 12 17 13 24 53 0 16 0 0 54 19 0 13 5 0 19 26 0 48 27 0 0 5 17 19 0 8 43 
13 6 7 15 8 8 10 20 56 0 0 3 0 34 32 0 14 23 0 17 51 0 65 16 0 0 0 30 9 10 0 43 
9 8 11 15 15 14 15 0 50 0 0 5 0 15 22 3 4 35 8 0 19 0 39 29 0 0 4 22 0 21 2 40 
10 6 15 20 18 12 11 3 37 0 0 18 0 28 7 5 10 0 4 47 0 0 0 18 15 0 17 13 0 3 8 39 
17 8 11 9 21 11 16 16 14 10 0 2 0 31 10 0 22 2 0 33 0 0 0 8 15 16 15 0 17 0 15 35 
14 11 22 6 7 3 13 16 14 0 5 7 0 3 30 0 3 32 0 22 0 0 12 18 14 24 0 1 26 0 6 42 
14 9 19 3 2 0 1 7 24 0 10 22 1 0 7 14 0 17 4 0 0 0 11 28 12 30 0 0 8 41 0 45 
19 0 10 7 6 8 8 17 21 7 3 9 3 17 0 0 0 0 0 0 0 11 18 16 24 12 25 9 0 25 12 43 
25 0 6 14 8 19 10 9 14 11 0 0 0 21 8 0 0 0 0 9 1 18 26 5 34 0 11 33 0 0 11 46 
30 18 8 19 9 12 13 4 6 10 4 1 0 5 6 0 4 0 0 14 15 16 16 15 35 3 0 19 24 3 1 46 
27 28 17 19 17 7 15 12 8 14 13 11 10 19 11 0 5 24 23 31 38 38 29 48 27 36 0 24 60 28 0 50 
13 10 0 0 0 0 0 0 0 0 0 0 0 0 0 0 0 0 0 0 0 0 0 0 0 8 0 0 10 5 0 50 
