0 40 0 0 0 0 0 0 0 0 0 0 0 0 0 0 0 0 0 0 0 0 0 0 0 0 0 0 0 0 0 64 
0 0 0 0 0 0 0 0 0 0 0 0 0 0 0 0 0 0 0 0 0 0 0 0 0 0 0 0 0 0 0 0 
0 0 0 0 0 0 0 0 0 0 0 0 0 0 0 0 0 0 0 0 2 0 0 0 0 0 0 0 0 0 0 0 
0 0 0 0 0 0 0 0 0 0 0 0 0 0 0 0 0 0 0 0 0 0 0 0 0 0 0 0 0 0 0 0 
0 0 0 0 0 0 0 0 0 0 0 0 0 0 0 0 0 0 0 0 0 0 0 0 0 0 0 0 0 0 0 0 
0 0 0 0 0 0 0 0 0 0 0 0 0 0 0 0 0 0 0 0 0 0 0 0 0 0 0 0 0 0 0 0 
0 0 0 0 0 0 0 0 0 0 0 0 0 0 0 0 0 0 0 0 4 0 0 0 0 0 0 0 0 0 0 0 
0 0 0 0 0 0 0 0 24 20 0 0 0 0 0 0 0 0 0 0 0 0 0 0 0 0 0 0 0 0 0 0 
0 0 0 0 0 0 0 0 24 96 6 0 0 0 0 0 0 6 0 0 0 0 0 0 0 0 0 0 0 0 0 0 
0 0 0 0 0 0 0 0 0 118 28 0 0 4 5 0 0 26 0 0 9 0 0 0 0 0 0 1 0 0 0 0 
0 0 0 0 0 0 0 0 0 115 30 0 0 0 0 0 0 26 0 0 30 55 0 0 0 0 0 0 0 0 0 0 
0 0 0 0 0 3 0 0 0 106 33 0 13 0 0 0 0 14 8 0 0 74 0 0 50 0 0 0 0 0 0 0 
54 21 0 0 0 0 31 0 0 92 25 0 24 0 2 0 0 0 0 0 4 38 0 16 54 0 0 7 0 0 0 0 
4 62 107 0 0 0 0 43 0 30 21 5 28 0 3 0 0 20 0 0 5 46 0 28 91 0 0 45 0 0 0 0 
0 14 103 19 0 0 0 62 0 0 0 3 28 0 0 2 0 20 1 0 0 59 0 0 94 0 0 14 19 0 0 0 
0 0 14 39 9 0 0 0 23 45 0 0 17 6 0 11 0 0 8 0 0 30 0 0 54 3 0 0 10 21 0 0 
0 0 0 0 0 0 0 0 0 91 2 0 0 8 0 9 7 0 0 0 0 3 0 5 37 0 0 0 0 24 0 0 
0 0 0 0 0 0 0 0 0 74 23 0 0 10 11 0 8 14 22 0 0 0 0 35 58 2 0 0 0 21 0 0 
0 0 0 0 0 0 0 0 0 65 23 6 0 0 40 4 0 6 31 0 0 0 0 40 89 11 0 0 0 18 0 0 
0 0 0 0 0 0 0 0 0 76 10 32 0 0 33 23 0 15 17 0 0 0 0 11 83 2 0 0 0 7 0 0 
0 0 0 0 0 0 0 0 0 93 10 22 0 0 1 21 0 19 23 0 0 0 0 0 56 0 0 0 22 6 0 0 
0 0 0 0 0 0 0 0 0 76 20 14 15 0 0 9 0 0 27 0 0 7 0 0 34 0 0 0 24 0 0 0 
0 0 0 0 0 0 0 0 0 43 12 14 19 0 9 9 0 0 0 0 34 0 0 0 0 0 0 15 26 0 0 0 
0 0 0 0 0 0 0 0 0 34 16 11 12 0 17 11 0 24 0 0 49 0 0 0 0 0 6 17 4 0 0 0 
0 0 0 0 0 0 0 0 0 13 11 29 42 0 0 22 0 0 10 0 19 0 0 0 0 0 20 13 0 0 0 0 
0 0 0 0 0 0 0 0 0 2 0 20 52 0 0 25 0 0 2 0 13 0 0 0 0 0 48 7 0 0 0 0 
0 0 0 0 0 0 0 0 0 8 0 0 6 8 20 7 21 0 0 0 0 0 0 0 0 0 34 32 0 0 0 0 
0 0 0 0 0 0 0 0 0 6 8 2 0 0 19 6 6 18 0 0 0 0 0 0 0 26 0 0 30 0 0 0 
0 0 0 0 3 0 1 0 0 0 11 15 8 0 0 0 0 20 0 0 0 0 0 0 0 49 0 0 0 7 0 0 
0 0 0 0 8 1 0 0 0 0 3 10 16 0 0 0 0 0 0 0 0 0 0 0 0 26 32 0 0 9 0 0 
0 0 0 0 0 7 0 0 0 0 0 0 8 1 0 6 0 0 0 2 0 0 0 0 11 0 38 0 0 0 0 0 
0 0 0 0 0 0 0 0 0 0 0 0 1 8 0 0 0 0 0 0 0 0 0 0 19 0 0 26 0 0 0 0 
