0 86 0 0 0 0 0 0 0 0 0 0 0 0 0 0 0 0 0 0 0 0 0 0 0 0 0 0 0 0 0 44 
0 149 21 26 23 24 26 27 25 26 27 27 24 26 28 28 29 31 31 29 29 22 30 34 25 30 31 31 32 28 20 14 
0 118 3 10 6 5 10 12 9 9 9 10 6 7 9 8 10 11 14 9 10 0 6 13 5 7 8 8 9 4 13 12 
0 119 3 9 6 4 8 12 9 9 9 11 7 7 9 8 9 10 12 11 9 4 4 8 4 4 3 4 9 3 11 11 
0 121 4 10 7 5 9 13 9 10 10 11 8 8 11 9 11 12 11 12 9 5 4 4 3 4 3 2 8 5 11 10 
0 122 7 11 8 7 10 14 11 12 15 11 10 10 12 9 10 10 8 7 7 7 3 5 4 5 3 4 6 6 13 11 
0 124 7 13 11 10 12 13 7 0 0 0 0 0 0 0 0 0 0 0 0 0 0 5 6 3 2 5 5 6 14 12 
0 125 5 13 12 10 11 0 0 0 0 0 0 0 0 0 0 0 0 0 0 0 0 15 14 0 1 5 4 4 13 12 
0 120 0 18 13 10 6 1 0 22 0 0 0 0 0 0 0 0 0 0 4 0 0 0 0 0 1 4 3 3 12 12 
0 104 0 22 11 9 3 0 0 61 0 0 0 0 0 0 0 0 0 0 0 0 0 0 0 0 0 11 1 1 9 12 
0 50 0 0 10 10 4 6 0 84 0 0 5 0 0 0 0 0 0 0 10 0 0 0 0 0 0 13 0 0 0 0 
0 0 0 0 19 22 0 3 0 67 0 0 13 0 0 0 0 2 8 0 16 23 0 0 8 0 0 0 0 0 0 0 
0 0 0 0 10 1 0 0 0 54 0 0 19 0 0 0 0 0 3 0 21 37 0 1 14 0 0 6 0 0 0 12 
0 4 17 0 0 0 0 0 0 67 0 0 19 0 3 1 0 0 0 0 27 45 0 26 24 0 0 47 0 0 0 38 
0 31 37 0 0 0 0 59 0 52 0 0 15 0 0 4 0 2 0 0 15 53 0 24 46 0 0 53 0 17 0 27 
0 62 14 0 0 0 0 40 0 31 0 0 8 0 0 5 0 0 11 0 0 41 0 0 30 0 0 23 22 9 0 0 
0 77 0 5 7 8 1 14 0 39 0 0 3 0 0 0 0 0 0 0 0 35 0 0 0 0 0 0 42 8 0 0 
0 80 4 0 0 0 0 0 0 39 0 0 0 9 0 0 0 0 5 0 0 0 0 0 0 0 0 0 46 0 0 0 
0 71 0 0 0 0 0 1 0 45 0 0 0 4 13 0 0 0 3 0 0 0 0 0 0 0 0 0 31 0 0 3 
0 72 0 0 0 0 0 1 0 41 0 0 0 0 20 0 0 0 0 0 0 0 0 0 20 0 0 0 28 0 0 21 
0 73 0 0 0 0 0 0 0 45 0 0 0 0 10 0 0 0 0 0 0 4 0 17 16 0 0 3 22 0 0 19 
0 65 0 0 0 0 0 0 0 34 0 0 0 0 4 1 0 0 0 0 0 18 0 23 12 0 0 7 9 0 2 17 
0 70 0 0 0 0 0 0 0 21 0 0 0 0 2 0 0 0 0 0 0 1 0 5 9 6 0 3 0 0 9 16 
0 73 0 0 0 0 0 0 0 22 0 0 0 0 0 0 0 0 0 0 21 0 0 0 12 5 0 0 0 0 6 18 
0 74 0 0 0 0 0 0 0 0 0 0 6 0 3 0 0 0 0 0 20 0 0 0 6 0 0 0 0 0 0 21 
0 75 0 4 0 0 0 0 0 0 0 0 18 0 4 12 0 0 12 0 2 0 0 6 0 0 2 0 0 4 6 16 
0 67 0 0 0 0 0 0 0 8 0 0 7 0 5 0 3 0 0 0 0 0 0 0 0 0 0 0 0 0 22 10 
0 41 0 0 0 0 0 0 0 12 7 5 5 0 20 4 9 0 0 0 1 0 0 0 0 0 0 0 16 0 11 5 
0 24 0 0 0 0 1 5 4 9 13 8 9 0 23 19 0 0 0 0 9 0 0 0 0 8 0 0 14 0 0 0 
0 28 0 0 3 1 3 8 7 9 12 6 12 7 17 9 0 0 2 0 0 0 0 0 0 0 0 0 0 9 0 0 
0 3 0 0 0 0 0 0 0 0 0 0 0 0 0 0 0 0 0 0 0 0 0 0 0 0 0 0 0 0 0 0 
0 10 0 0 0 5 0 0 3 5 4 0 5 0 0 0 0 0 0 4 0 0 3 8 27 0 16 17 0 9 10 23 
