0 0 0 0 0 0 0 0 0 0 0 0 0 0 0 0 0 0 0 0 0 0 0 0 0 0 0 0 0 0 0 0 
0 0 0 0 0 0 0 0 0 0 0 0 0 0 0 0 0 0 0 0 0 0 0 0 0 0 0 0 0 0 0 0 
0 0 0 0 0 0 0 0 0 0 0 0 0 0 0 0 0 0 0 0 0 0 0 0 0 0 0 0 0 0 0 0 
0 0 0 0 0 0 0 0 0 0 0 0 0 0 0 0 0 0 0 0 0 0 0 0 0 0 0 0 0 0 0 0 
0 0 0 0 0 0 0 0 0 0 0 0 0 0 0 0 0 0 0 0 0 0 0 0 0 0 0 0 0 0 0 0 
0 0 0 0 0 0 0 0 0 0 0 0 0 0 0 0 0 0 0 0 0 0 0 0 0 0 0 0 0 0 0 0 
0 0 0 0 0 0 0 0 0 0 0 0 0 0 0 0 0 0 0 0 0 0 0 0 0 0 0 0 0 0 0 0 
0 0 0 0 0 0 0 0 0 0 0 0 0 0 0 0 0 0 0 0 0 0 0 0 0 0 0 0 0 0 0 0 
0 0 0 0 0 0 0 0 22 33 47 62 61 61 55 49 51 35 9 1 0 0 0 0 0 0 0 0 0 0 0 0 
0 0 0 0 0 0 0 0 16 6 10 26 21 22 24 19 15 5 0 28 13 0 0 0 0 0 0 0 0 0 0 0 
0 0 0 0 0 0 0 0 10 0 0 0 0 0 0 0 0 0 0 0 18 15 20 21 0 0 0 0 0 0 0 0 
2 0 0 0 0 0 0 0 0 0 0 13 1 0 0 0 0 0 0 9 15 5 39 35 18 0 0 0 0 0 0 0 
62 51 0 0 0 0 0 0 0 0 0 0 0 0 0 0 0 0 0 0 0 0 14 29 0 0 0 0 0 0 0 0 
57 64 10 0 0 0 0 0 0 0 0 0 0 0 0 0 0 0 0 0 0 0 0 28 15 22 52 46 65 38 30 30 
0 23 53 76 42 14 23 28 58 0 0 0 0 0 0 0 0 0 0 0 1 0 0 0 0 12 25 39 60 44 0 14 
0 0 9 46 66 57 33 0 53 9 0 0 0 0 0 0 0 0 0 0 0 0 0 0 0 0 0 0 0 0 0 0 
0 0 0 0 0 0 0 0 0 0 2 0 0 1 0 0 0 0 0 0 0 0 0 0 0 0 0 0 0 0 0 0 
0 0 0 0 0 0 0 0 0 0 0 0 0 17 3 0 0 0 0 0 0 0 0 2 0 0 0 0 0 0 0 0 
0 0 0 0 0 0 0 0 9 0 0 0 0 0 1 0 0 0 0 0 0 0 0 32 7 0 0 0 0 0 0 3 
1 0 0 10 10 9 8 2 22 0 0 0 0 0 0 0 0 0 0 0 1 0 0 0 0 0 10 5 0 0 0 0 
20 0 3 0 0 0 0 0 0 0 0 0 0 0 0 0 0 0 0 3 26 0 4 9 0 0 0 0 0 0 0 0 
0 0 0 0 0 0 0 0 0 0 6 13 7 9 0 0 0 0 0 1 0 0 0 0 0 0 0 0 0 0 0 1 
0 0 0 0 0 0 0 0 0 0 2 18 12 34 29 16 14 0 0 11 4 0 0 0 0 0 0 0 0 0 0 0 
24 0 7 0 0 0 0 0 13 9 6 0 0 0 0 0 0 13 0 0 0 0 0 0 0 0 0 0 0 0 0 2 
3 0 0 0 0 0 0 0 0 0 0 27 7 0 0 0 0 0 10 19 0 0 0 0 0 0 0 0 0 0 0 2 
0 0 0 0 0 0 0 0 0 0 10 33 54 71 52 48 51 49 38 13 0 0 0 0 0 0 0 0 0 0 0 0 
0 0 0 0 0 0 10 31 38 26 8 0 3 34 39 29 36 26 0 0 0 0 0 0 0 0 2 26 0 0 0 0 
0 0 0 0 8 30 37 25 11 10 10 0 0 0 0 15 16 0 0 0 0 0 0 0 0 0 0 0 30 19 0 2 
0 0 7 28 32 20 13 14 11 10 13 15 1 0 0 0 0 0 0 0 0 0 0 0 0 0 0 0 0 0 0 0 
21 12 31 25 16 9 5 8 6 2 5 16 27 33 17 0 0 0 0 0 0 0 0 0 0 0 0 0 0 0 0 6 
26 9 4 4 5 3 0 0 0 0 0 0 0 0 0 0 0 0 0 0 0 0 0 0 0 0 0 0 0 0 0 0 
12 9 7 4 5 6 5 0 0 1 0 0 0 0 0 0 0 0 0 0 0 0 0 3 0 0 0 28 18 0 0 0 
