0 0 0 0 0 0 0 0 0 0 0 0 0 0 0 0 0 0 0 0 0 0 0 0 0 0 0 0 0 0 5 0 
0 0 0 0 0 0 0 0 0 0 0 0 0 0 0 0 0 0 0 0 7 0 0 1 0 0 0 0 0 0 51 0 
0 0 0 0 0 0 0 0 0 0 0 0 0 0 0 0 0 0 0 0 0 0 0 0 0 0 0 0 0 0 40 0 
0 0 0 0 0 0 0 0 0 0 0 0 0 0 0 0 0 0 0 0 0 0 0 0 0 0 0 0 0 0 41 0 
0 0 0 0 0 0 0 0 0 0 0 0 0 0 0 0 0 0 0 0 0 0 0 0 0 0 0 0 0 0 42 0 
0 0 0 0 0 0 0 0 0 0 0 0 0 0 0 0 0 0 0 0 0 0 0 0 0 0 0 0 0 0 43 0 
0 0 0 0 0 0 0 0 0 0 5 5 10 6 9 8 6 4 16 0 0 0 0 0 0 0 0 0 0 0 43 0 
0 0 0 0 0 0 0 8 0 21 35 22 26 21 20 19 9 4 42 0 0 26 0 0 0 0 0 0 0 0 42 0 
0 6 0 0 0 0 0 14 0 2 0 0 0 0 0 0 0 0 14 0 0 33 0 0 0 0 0 0 0 0 42 0 
0 25 0 0 0 0 0 6 0 2 0 0 0 0 0 0 0 0 7 0 0 41 0 0 25 0 0 0 0 0 34 0 
0 31 0 0 0 0 0 0 0 44 42 0 0 0 0 1 0 0 48 0 0 35 0 0 3 15 0 0 0 0 26 0 
0 0 41 0 0 0 0 9 0 47 49 0 0 0 0 5 0 0 50 0 0 31 0 0 0 28 0 15 0 28 22 0 
0 0 47 0 0 0 0 64 0 56 49 0 15 0 0 7 0 0 45 0 0 80 0 0 0 70 0 36 0 24 0 0 
0 0 44 0 0 40 0 109 0 42 30 0 25 0 0 11 0 0 44 0 0 106 0 0 13 59 0 6 0 0 0 0 
0 0 24 0 0 0 0 55 0 11 5 0 21 0 0 6 0 0 42 0 0 74 0 0 41 10 0 0 0 0 0 0 
0 0 0 0 0 0 0 0 0 9 0 0 11 0 0 0 0 0 58 0 0 43 0 0 61 0 0 0 0 0 26 0 
0 0 0 0 0 0 0 0 0 50 0 0 0 0 0 0 1 0 63 0 0 12 0 0 42 0 67 0 0 0 56 0 
0 0 0 0 0 0 1 0 0 57 8 0 0 0 0 0 0 0 47 0 0 0 0 0 0 10 53 0 0 0 43 0 
0 0 0 0 0 0 5 0 0 58 0 13 0 0 0 0 0 0 29 0 0 0 0 0 0 38 3 0 0 19 23 0 
0 0 0 0 0 0 0 0 0 60 0 17 8 0 0 20 0 0 21 15 0 0 0 0 23 62 0 0 0 34 7 0 
0 0 0 0 0 0 0 2 0 63 4 4 22 0 0 23 0 0 4 0 0 36 0 0 46 34 0 0 0 13 0 0 
0 0 0 0 0 0 0 2 0 53 20 0 21 0 0 20 0 0 10 0 0 60 0 0 13 0 0 0 36 0 11 0 
0 0 0 0 0 0 0 0 0 43 24 0 26 0 0 6 0 0 27 0 0 44 0 0 0 0 0 0 35 0 13 0 
0 0 0 0 0 0 0 0 0 22 9 0 56 0 0 19 0 0 25 0 33 23 0 0 0 0 0 17 9 0 2 0 
0 0 0 0 0 0 0 0 0 25 8 0 58 0 0 30 4 0 19 0 36 23 0 0 0 0 0 29 0 0 0 0 
0 0 0 0 0 0 0 10 0 18 0 0 26 0 0 0 0 0 0 0 31 0 0 0 0 0 12 19 4 0 5 0 
0 0 0 0 0 0 0 0 0 0 0 0 6 0 0 0 0 0 0 0 0 0 0 0 0 0 24 0 22 0 20 0 
0 0 0 0 0 0 0 0 0 0 0 0 16 0 0 2 0 0 14 0 0 0 0 0 0 0 18 0 0 0 14 0 
0 0 0 0 0 0 0 0 0 0 0 0 14 0 0 15 0 0 0 0 0 0 0 0 0 11 22 0 0 0 27 0 
0 0 0 0 0 0 0 0 0 0 0 0 3 0 0 11 0 0 0 0 0 0 0 0 0 12 8 0 0 0 34 0 
0 0 0 0 0 4 0 0 0 0 0 0 0 0 0 0 0 0 0 0 0 0 0 0 29 0 0 14 0 0 27 0 
0 0 3 1 0 13 10 4 4 6 11 2 1 12 1 0 0 0 0 6 0 0 0 0 48 0 0 20 0 0 12 0 
