0 55 0 0 0 0 0 0 0 0 0 0 0 0 0 0 0 0 0 2 0 0 7 0 0 0 0 0 0 0 2 57 
19 9 0 0 0 0 0 0 0 0 0 0 0 0 0 0 0 0 0 0 0 0 0 0 0 0 0 0 0 0 0 0 
19 20 4 1 0 1 3 0 1 0 1 0 1 1 0 0 0 1 0 2 0 7 3 0 3 0 0 5 0 0 16 10 
18 21 5 0 0 2 3 0 1 0 1 0 0 1 0 0 0 0 0 2 0 1 0 0 4 0 0 6 0 0 15 11 
17 24 5 0 0 2 4 0 0 0 0 0 0 2 0 1 0 0 1 1 0 0 0 0 2 0 1 1 0 1 15 12 
17 24 5 0 0 3 4 0 0 2 0 0 0 4 0 0 0 1 1 0 0 0 0 0 0 0 2 0 0 2 15 12 
16 26 4 0 0 3 3 0 0 9 0 0 0 1 0 0 1 8 0 0 15 0 0 0 2 0 2 0 0 2 15 11 
18 27 1 0 0 1 0 0 52 11 0 0 0 0 0 0 0 0 0 17 33 0 0 18 2 0 1 0 0 1 13 11 
31 10 0 5 0 0 0 0 120 0 0 0 0 0 0 0 3 0 0 54 8 0 20 41 0 0 0 0 0 0 13 12 
36 0 18 6 0 0 0 8 125 0 0 10 0 0 0 0 10 0 0 37 7 0 40 19 0 0 10 4 0 0 13 13 
0 0 42 0 4 0 0 15 115 0 0 26 0 0 0 0 13 8 0 44 59 0 7 0 0 0 23 14 0 0 22 5 
0 30 0 0 21 0 3 18 104 0 0 38 0 0 0 0 13 1 0 67 71 0 0 25 15 0 82 2 0 0 38 0 
0 73 0 7 56 0 69 0 85 0 0 43 0 0 4 0 16 0 0 67 54 0 14 74 0 0 148 0 9 0 44 0 
0 46 0 38 63 1 105 0 99 0 0 44 0 5 0 0 22 0 0 49 15 0 89 68 0 0 142 0 14 0 54 1 
0 23 0 33 29 5 49 0 125 0 16 22 0 3 0 0 12 8 0 12 17 0 63 65 0 0 72 0 34 0 69 6 
0 23 0 0 0 0 0 0 118 0 10 0 0 1 1 0 0 24 0 13 71 0 44 50 0 34 0 0 54 19 24 0 
0 35 4 0 0 0 0 12 91 0 0 0 0 0 3 3 0 17 0 68 15 0 98 0 0 32 0 71 59 14 0 0 
9 23 0 0 0 0 0 12 72 0 0 0 0 14 11 1 0 9 0 36 0 80 30 0 9 0 0 105 58 0 0 20 
16 11 0 4 0 0 0 8 78 0 0 0 0 50 8 0 0 5 0 0 67 51 0 15 5 0 0 124 44 0 1 13 
24 8 0 0 0 0 0 9 93 0 0 0 0 58 0 0 0 7 0 11 87 0 0 97 0 0 67 126 0 0 31 2 
11 2 0 2 1 6 4 6 80 0 4 0 0 44 0 0 7 36 0 2 38 0 89 32 0 0 111 83 0 0 46 0 
8 19 0 9 3 0 0 0 73 0 0 10 0 15 0 0 15 34 0 21 17 0 91 0 0 61 78 20 0 8 31 0 
30 9 0 2 0 0 0 18 71 0 0 47 0 5 11 0 13 6 0 79 0 0 0 0 60 34 51 0 0 29 13 0 
36 0 0 0 1 0 17 32 10 0 25 35 0 36 18 0 9 0 0 98 0 0 0 79 31 21 37 0 0 15 20 0 
26 0 5 0 2 0 20 1 0 0 22 0 0 52 0 0 4 9 15 43 0 0 98 59 0 55 0 0 21 0 30 0 
17 0 9 0 10 13 11 1 15 0 0 0 0 25 0 0 0 28 0 0 0 92 80 0 0 75 0 0 0 4 26 0 
11 0 15 11 19 6 0 0 0 0 1 1 0 18 0 0 2 24 0 0 37 88 0 0 64 33 0 0 0 43 15 0 
15 21 22 8 0 0 0 0 1 0 0 0 0 25 0 0 13 0 0 42 66 0 0 5 89 0 0 0 0 57 0 0 
45 20 0 0 0 0 0 4 3 0 0 0 0 21 0 0 0 0 11 82 0 0 0 46 58 0 0 16 37 23 0 0 
55 0 0 0 2 0 0 0 1 1 0 0 2 18 0 0 0 20 58 10 0 0 4 76 0 0 1 29 36 0 0 2 
23 0 0 11 6 0 0 0 2 0 0 0 7 0 0 0 24 40 6 0 0 4 30 45 0 0 41 3 15 0 0 14 
2 0 1 0 0 0 0 0 0 0 0 0 0 0 0 9 24 0 0 0 5 7 24 0 0 48 20 0 3 0 11 0 
