3 0 0 0 0 0 0 0 0 0 0 0 0 0 0 0 0 0 0 0 0 0 0 0 0 0 0 0 0 0 0 0 
0 0 0 0 0 0 0 0 0 0 0 0 0 0 0 0 0 0 0 0 0 0 0 0 0 0 0 0 0 0 0 0 
0 0 0 0 0 0 0 0 0 0 0 0 0 0 0 0 0 0 0 0 0 0 0 0 0 0 0 0 0 0 0 0 
0 0 0 0 0 0 0 0 0 0 0 0 0 0 0 0 0 0 0 0 0 0 0 0 0 0 0 0 0 0 0 0 
0 0 0 0 0 0 0 0 0 0 0 0 0 0 0 0 0 0 0 0 0 0 0 0 0 0 0 0 0 0 0 0 
0 0 0 0 0 0 0 0 0 0 0 0 0 0 0 0 0 0 0 0 0 0 0 0 0 0 0 0 0 0 0 0 
0 0 0 0 0 0 0 0 0 0 0 0 0 0 0 0 0 0 0 0 0 0 0 0 0 0 0 0 0 0 0 0 
0 0 0 0 0 0 0 0 0 0 0 2 2 8 9 9 7 9 10 0 0 6 1 0 0 0 0 0 0 0 0 0 
0 0 0 0 0 0 0 0 0 0 38 36 28 29 27 25 23 22 11 0 0 27 0 0 0 0 0 0 0 0 0 0 
0 0 0 0 0 0 0 0 0 0 47 28 13 19 17 11 6 0 0 0 0 10 0 0 2 2 0 0 0 0 0 0 
0 0 0 0 0 0 0 0 0 0 18 0 0 0 0 0 0 0 0 0 0 11 30 29 10 6 0 0 0 0 0 0 
9 0 0 0 0 0 0 0 0 0 9 0 0 3 0 0 0 0 0 0 0 36 43 2 0 14 0 0 2 4 0 0 
15 0 6 0 0 0 0 0 0 4 21 4 5 5 0 0 0 0 0 0 0 42 10 0 5 5 0 3 43 36 22 0 
19 14 10 0 0 0 0 25 21 25 30 8 10 6 0 0 0 0 0 0 0 7 0 0 0 1 5 31 36 3 0 0 
0 0 0 0 0 0 41 48 0 0 11 12 22 12 0 0 0 3 7 0 0 0 0 0 3 0 0 12 0 0 0 0 
0 0 0 0 0 0 2 0 0 0 11 24 23 8 0 0 1 6 17 0 0 0 0 0 17 0 0 0 0 0 0 0 
0 0 0 0 0 0 0 0 0 0 31 24 14 0 0 0 4 14 6 0 0 0 0 0 17 15 0 0 0 0 0 0 
0 0 0 0 0 0 0 0 0 6 39 19 9 0 0 0 14 19 0 0 0 0 0 25 34 45 6 0 0 7 31 0 
0 0 1 1 0 1 0 0 0 5 40 18 0 0 0 12 20 16 7 0 0 0 44 40 52 63 0 0 0 23 25 0 
0 0 3 2 2 0 0 0 0 2 41 15 0 0 0 29 22 1 0 0 0 53 41 3 65 53 0 0 0 32 13 0 
0 0 0 0 0 0 0 0 0 7 37 20 0 0 15 33 12 0 2 13 37 59 0 9 68 0 0 0 8 32 0 0 
0 0 0 0 0 0 0 0 0 21 53 32 19 24 19 22 5 2 42 34 42 27 0 22 0 0 0 0 30 14 0 0 
0 0 4 9 13 14 10 0 0 45 57 23 39 31 7 21 15 20 37 17 34 34 24 0 0 0 0 0 33 4 0 0 
0 0 19 13 7 1 0 0 21 47 21 13 30 2 0 17 17 17 5 3 51 81 0 0 0 0 0 28 28 0 0 0 
0 0 4 0 0 0 0 4 12 10 10 30 23 0 3 20 13 6 10 48 101 21 0 0 0 0 0 38 17 0 0 0 
0 0 0 0 0 0 0 0 9 36 49 42 32 27 24 31 27 21 47 96 33 0 0 0 0 0 19 29 11 0 0 0 
0 0 0 0 0 5 28 45 57 55 44 30 27 22 17 30 25 27 68 23 0 0 0 0 0 0 42 45 8 0 0 0 
0 0 0 6 35 58 67 57 42 30 22 18 7 0 0 14 16 38 5 0 0 0 0 0 0 10 54 28 0 0 0 0 
0 0 35 60 67 59 41 24 15 13 16 14 4 0 4 16 30 0 0 0 0 0 0 0 0 42 39 0 0 0 0 0 
0 22 72 58 36 26 18 12 8 10 11 9 2 14 33 30 0 0 0 0 0 0 0 0 18 64 16 0 0 0 22 0 
24 33 39 15 5 10 9 2 0 3 3 0 0 26 32 0 0 0 0 0 0 0 0 0 37 25 0 0 0 1 3 0 
23 31 22 16 22 26 22 17 17 21 18 13 27 40 9 0 0 2 26 42 42 38 39 73 72 37 31 48 49 49 30 29 
