87 66 17 18 20 19 18 17 16 15 14 13 13 14 12 13 12 12 11 9 7 11 14 7 6 6 6 6 5 4 8 0 
106 29 18 21 22 21 20 19 19 20 18 19 23 22 21 21 21 21 19 17 22 31 19 12 19 18 18 19 17 17 0 0 
65 25 2 2 2 4 0 0 0 0 0 0 2 1 1 1 2 0 0 0 5 4 0 0 3 0 0 0 0 0 0 0 
66 28 5 0 4 5 0 0 0 0 1 1 1 2 1 2 1 1 1 0 0 0 0 3 2 0 1 0 0 0 0 0 
66 29 2 0 3 4 0 0 0 1 0 0 2 3 2 2 1 2 1 0 0 0 3 3 0 1 2 0 0 0 0 0 
66 28 2 0 2 4 0 0 0 2 0 0 0 0 0 0 0 0 0 0 0 0 0 0 0 1 0 0 0 0 0 0 
65 29 1 0 2 0 0 0 2 2 0 0 0 0 0 0 0 0 0 0 2 0 0 1 1 0 1 0 0 0 0 0 
67 28 0 1 0 0 0 2 0 0 0 0 0 0 0 0 0 0 0 14 0 0 15 23 1 0 0 0 0 0 0 0 
70 16 5 8 0 0 0 6 0 0 0 0 0 0 0 0 0 0 17 31 0 9 70 26 0 0 0 0 0 0 0 0 
68 3 33 8 0 0 4 0 0 0 0 0 0 0 0 8 12 22 50 45 15 40 38 0 0 17 19 5 0 0 0 0 
41 24 49 8 4 3 7 0 0 0 0 3 0 0 13 26 32 19 38 62 1 0 0 0 7 33 37 16 0 0 0 0 
23 24 0 23 35 15 9 0 0 0 0 0 0 5 23 29 31 20 56 47 0 0 0 45 28 26 73 0 0 0 0 0 
15 0 0 100 76 25 0 0 0 0 0 0 0 21 26 31 36 30 57 33 0 0 78 31 0 41 35 0 0 0 0 0 
4 0 66 148 45 0 0 0 0 0 0 0 0 20 19 33 37 26 44 16 0 33 84 0 0 28 0 0 0 0 0 0 
20 40 71 56 0 0 0 0 0 0 0 0 0 16 18 28 24 20 30 24 23 68 21 0 0 17 0 0 57 46 10 0 
37 56 29 0 0 0 0 37 0 0 0 0 0 19 19 19 19 17 33 88 55 0 6 0 0 49 27 99 75 16 0 0 
55 52 17 10 19 18 35 25 0 0 0 0 7 17 21 16 16 17 65 93 0 14 0 0 0 20 81 121 0 0 0 0 
56 28 14 18 15 15 15 0 0 0 0 1 18 34 16 0 6 28 60 35 35 32 0 0 0 0 108 80 0 0 0 0 
46 20 9 7 5 4 3 0 0 0 0 15 53 36 0 0 8 26 38 67 70 0 0 0 0 25 139 59 0 0 0 0 
37 6 1 5 7 13 15 0 0 0 0 38 58 8 0 0 17 26 36 44 0 0 0 0 0 79 154 3 0 0 0 0 
24 18 20 26 27 25 14 0 0 0 0 21 27 0 0 0 30 14 0 0 0 1 85 0 0 159 89 0 0 0 3 0 
46 38 24 17 0 0 0 0 0 0 0 3 0 0 0 12 18 0 0 13 0 62 32 0 129 114 0 0 0 26 0 0 
46 0 0 0 0 0 1 0 0 0 0 2 0 7 5 5 9 0 24 34 0 21 25 123 121 18 0 0 0 28 0 0 
22 0 0 0 3 17 24 0 0 0 17 0 0 43 0 0 13 17 37 0 0 21 150 137 22 0 0 0 8 28 0 0 
21 8 17 16 20 26 0 0 0 0 0 0 3 15 0 0 4 4 0 0 0 156 165 28 0 0 0 0 35 16 0 0 
28 21 21 22 25 5 0 0 0 0 0 0 0 0 0 0 3 0 0 0 128 189 32 0 0 0 0 0 21 24 0 0 
35 30 22 4 0 0 0 0 0 0 0 0 0 2 0 0 13 0 0 109 173 47 0 14 0 0 0 0 33 44 0 0 
50 15 0 0 0 0 0 0 0 0 0 0 10 8 0 1 3 0 90 160 52 0 13 21 0 0 0 35 67 28 0 0 
44 0 0 0 0 0 0 10 0 0 0 0 12 3 0 0 0 76 149 59 0 11 27 0 0 0 20 75 48 0 0 0 
0 0 0 0 0 5 5 2 0 0 0 0 12 0 0 8 93 138 62 0 2 26 15 0 0 0 82 63 0 0 0 0 
0 0 7 11 0 0 4 7 1 0 0 6 0 0 32 108 129 44 0 0 11 8 0 0 0 51 52 0 0 0 0 0 
0 0 0 0 0 0 0 0 0 0 0 0 0 7 62 55 0 0 0 0 0 0 0 0 0 1 0 0 0 0 0 0 
