0 0 0 0 0 0 0 0 0 1 1 2 2 2 2 2 4 5 5 5 3 4 5 5 7 7 6 6 7 7 40 59 
0 0 0 0 0 0 0 0 0 0 0 0 0 0 0 0 0 0 0 0 0 0 0 0 0 0 0 0 0 0 56 111 
0 0 0 0 0 0 0 0 0 0 0 0 0 0 0 0 0 0 0 0 0 0 0 0 0 0 0 1 1 0 64 102 
0 0 0 0 0 0 0 0 0 0 0 0 0 0 0 0 0 0 0 0 0 0 0 0 0 0 0 1 3 2 64 101 
0 0 0 0 0 0 0 0 0 0 0 0 0 0 0 0 0 0 0 0 0 0 0 0 0 0 0 1 2 3 64 102 
0 0 0 0 0 0 0 0 0 0 0 0 0 0 0 0 0 0 0 0 0 0 0 0 0 0 0 0 2 3 65 102 
0 0 0 0 0 0 0 1 0 0 0 0 0 0 0 0 0 0 0 0 0 0 1 4 0 0 0 0 1 3 65 103 
0 0 0 0 0 0 0 5 0 0 0 0 0 0 0 0 0 0 0 0 0 0 0 0 0 2 0 0 1 2 66 103 
0 0 0 0 0 0 0 10 44 45 15 0 0 0 0 0 0 0 0 0 0 0 0 0 0 1 4 1 1 2 66 103 
0 0 0 0 0 0 0 26 101 82 38 0 0 0 0 0 0 0 0 0 0 0 0 0 0 0 0 0 0 1 64 105 
0 0 0 0 0 0 0 33 121 88 54 7 0 0 0 0 0 0 0 0 0 0 0 0 0 0 0 0 0 0 60 111 
0 0 0 0 0 0 0 22 127 94 61 21 0 0 0 0 0 0 0 0 7 13 0 0 0 0 0 0 0 0 55 108 
0 0 0 0 0 0 0 28 119 102 65 34 4 0 0 0 0 0 0 0 31 15 0 0 0 0 0 0 0 0 42 72 
0 0 0 0 0 0 30 51 69 62 46 31 5 0 0 0 0 0 0 0 33 0 0 13 0 0 0 0 0 0 7 21 
17 0 0 0 0 0 32 21 25 0 13 24 10 0 0 0 0 0 0 0 0 0 0 34 20 0 0 0 0 0 6 38 
9 0 0 0 0 0 0 0 24 5 17 19 7 0 0 0 0 0 0 0 0 0 14 40 12 0 0 0 0 0 60 93 
0 0 0 4 1 0 0 19 60 50 34 5 1 0 0 0 0 0 0 0 0 6 19 47 0 0 0 0 0 47 90 94 
0 0 0 0 0 0 0 23 78 62 28 0 0 0 0 0 0 0 0 0 0 0 62 47 0 0 0 0 1 62 76 73 
0 0 0 0 0 0 0 27 74 52 22 0 0 0 4 3 0 0 0 0 0 23 82 50 0 0 0 0 4 44 64 69 
0 0 0 0 0 0 0 19 69 49 18 0 0 0 21 14 0 0 0 0 0 22 17 14 7 0 0 0 34 33 52 62 
0 0 0 0 0 0 0 27 83 52 21 0 0 0 14 1 0 0 0 0 0 0 0 14 5 0 0 0 51 22 40 55 
0 0 0 0 0 0 0 23 70 51 33 0 0 0 0 0 0 0 3 0 0 0 0 0 0 0 0 43 36 9 41 60 
0 0 0 0 1 0 0 8 58 56 29 0 0 0 0 0 0 0 0 0 0 0 0 0 0 0 23 57 19 5 37 61 
0 0 0 0 0 0 0 20 66 39 18 9 0 0 0 0 0 0 0 0 0 0 0 0 0 17 53 49 9 0 38 60 
0 0 0 0 0 0 1 38 52 29 37 25 0 0 0 0 0 0 0 0 0 0 0 0 0 31 56 17 0 0 42 62 
0 0 0 0 0 0 12 29 39 50 44 12 0 0 0 0 0 0 0 0 0 0 0 0 10 50 49 0 0 0 41 64 
0 0 0 0 0 7 14 19 31 17 3 0 0 0 0 0 0 0 0 0 0 0 0 0 17 62 42 11 0 0 29 62 
0 0 0 12 25 24 12 0 0 0 0 0 0 0 0 0 0 0 0 0 0 0 0 0 37 65 24 0 0 0 30 62 
0 0 24 26 14 0 0 0 0 0 0 0 0 0 0 0 0 0 0 0 0 0 0 10 64 47 0 0 0 4 53 61 
0 0 15 0 0 0 0 0 0 0 0 0 0 0 0 0 0 0 0 0 0 0 0 27 71 25 0 0 0 24 60 55 
0 0 0 0 0 0 0 0 0 0 0 0 0 0 0 0 0 0 0 0 0 0 5 45 26 0 0 0 0 9 44 60 
0 0 0 0 0 0 0 0 0 0 0 0 3 0 0 0 0 0 0 0 0 3 30 40 0 0 0 1 0 0 17 42 
