24 83 59 60 61 63 64 65 66 66 68 68 69 69 71 71 72 72 73 72 72 74 78 77 74 75 76 76 76 76 75 136 
5 0 0 0 0 0 0 0 0 0 0 0 0 0 0 0 0 0 0 0 0 0 0 0 0 0 0 0 0 0 0 3 
2 11 9 11 10 10 10 10 9 9 8 9 9 9 9 7 6 6 7 7 8 3 0 2 7 7 7 5 5 1 16 56 
3 13 10 10 10 12 10 10 8 8 8 7 7 7 8 6 6 3 5 6 5 0 0 2 3 3 4 3 0 0 14 55 
3 14 10 10 10 9 8 7 6 7 7 7 8 7 6 5 4 5 6 7 8 8 6 4 1 0 0 0 0 0 15 55 
4 15 10 11 10 10 8 5 7 10 13 14 14 14 12 11 12 14 13 9 10 9 6 3 1 1 0 0 0 1 16 55 
5 16 12 13 12 11 8 7 6 7 0 0 0 0 0 0 0 0 0 0 7 6 0 1 5 3 2 2 2 2 18 58 
6 19 10 11 11 10 9 11 2 0 0 0 0 0 0 0 0 0 0 0 0 0 0 5 8 2 4 3 3 3 17 58 
6 14 0 12 10 10 11 22 2 0 0 0 0 0 0 0 0 0 0 0 0 0 0 0 0 0 0 3 3 3 18 58 
0 0 0 14 10 11 12 24 0 0 0 0 0 0 0 0 0 0 0 0 0 0 0 0 0 0 0 6 6 4 18 59 
0 0 3 0 9 11 15 23 0 0 0 0 0 0 0 0 0 0 0 0 0 0 0 0 0 0 0 0 0 0 5 44 
0 0 0 0 6 14 17 25 0 0 0 0 0 0 0 0 0 0 0 0 0 0 0 0 0 0 0 0 0 0 0 0 
0 0 0 0 0 11 0 0 0 0 0 0 0 0 0 0 0 0 4 0 0 0 0 24 0 0 0 0 0 0 0 0 
0 0 0 0 0 0 0 0 0 0 0 0 0 0 0 0 0 0 0 0 0 5 37 3 0 0 0 0 0 0 0 0 
18 24 19 0 0 0 0 0 0 0 0 0 0 0 0 0 0 0 0 0 0 44 21 0 20 18 0 0 43 63 62 77 
28 63 57 11 0 0 0 2 2 0 0 0 0 0 0 0 0 0 0 6 28 14 0 0 0 30 32 85 109 69 27 30 
17 40 31 28 35 36 34 43 0 0 0 0 0 0 0 0 0 0 0 3 0 0 0 0 0 0 0 13 0 0 0 0 
0 0 0 0 0 0 0 0 0 0 0 0 0 0 0 0 0 0 0 0 0 4 0 0 0 0 0 0 0 0 0 5 
0 0 0 0 0 0 0 0 0 0 0 0 0 8 0 0 0 0 0 0 0 0 0 0 0 0 0 0 0 0 0 10 
0 0 0 0 0 0 0 0 0 0 0 0 0 0 0 0 0 0 0 0 0 0 0 0 0 0 38 1 0 0 0 11 
0 0 0 6 10 7 1 2 0 0 0 0 0 0 0 0 0 0 0 0 0 0 0 0 0 43 69 0 0 0 0 16 
0 18 0 0 0 0 0 0 0 0 0 0 0 0 0 0 0 0 0 0 0 2 0 0 55 103 5 0 0 0 1 22 
0 0 0 0 0 0 0 0 0 0 0 0 0 0 0 0 0 0 0 0 0 0 0 27 113 27 0 0 0 0 0 24 
0 0 0 0 0 0 0 0 0 0 0 0 0 0 0 0 0 0 0 0 0 0 0 91 11 0 0 0 0 0 0 21 
0 0 0 0 0 0 0 0 0 0 0 0 0 0 0 0 0 0 0 0 0 0 120 27 0 0 0 0 0 0 0 20 
0 0 0 0 0 0 0 0 0 0 0 0 0 0 0 0 0 0 0 0 0 124 38 0 0 0 0 0 0 0 0 14 
0 0 0 0 0 0 0 0 0 0 0 0 0 0 0 0 0 0 0 2 145 66 0 0 0 0 0 0 0 0 0 9 
0 0 0 0 0 0 0 0 0 0 0 0 0 2 7 8 2 0 5 126 77 0 0 0 0 0 0 0 13 0 0 4 
0 0 0 0 0 0 0 0 0 0 0 0 0 0 0 0 0 3 120 82 0 0 0 0 0 0 0 0 17 0 0 0 
0 0 0 0 0 0 0 0 0 0 0 0 0 0 0 0 31 142 96 0 0 0 0 0 0 0 0 0 0 0 0 0 
0 0 0 0 0 0 0 0 0 0 0 1 10 4 16 75 138 81 1 0 0 0 0 0 0 0 4 0 0 0 0 17 
0 0 0 0 0 0 0 0 0 0 0 0 0 0 49 75 15 0 0 0 0 0 0 0 0 0 0 0 0 0 0 0 
