60 104 95 97 97 98 97 97 98 98 98 99 99 99 99 99 99 99 99 100 101 97 94 97 98 97 96 95 96 95 97 46 
1 0 0 0 0 0 0 0 0 0 0 0 0 0 0 0 0 0 0 0 0 0 0 0 0 0 0 0 0 0 0 0 
0 0 1 2 2 1 1 0 0 0 0 1 1 1 0 0 0 2 1 1 1 0 0 0 0 0 0 0 0 1 0 0 
0 0 2 2 1 2 2 1 1 1 0 0 0 0 0 0 0 0 0 0 0 0 0 0 0 0 0 0 0 0 0 0 
0 0 1 1 1 0 0 1 2 2 3 2 2 2 2 2 3 2 0 0 1 2 2 2 1 0 0 1 1 1 0 0 
0 0 0 0 0 0 0 0 0 0 0 0 0 0 2 2 2 2 3 2 0 0 0 1 1 1 2 2 2 2 0 0 
0 0 0 0 0 0 0 0 0 13 37 46 52 55 55 53 53 49 38 14 7 12 6 2 2 1 1 1 1 1 0 0 
0 0 0 0 0 0 0 7 3 19 30 23 17 11 8 6 0 0 1 4 14 14 0 0 0 0 0 0 0 0 0 0 
0 2 0 0 0 0 0 0 0 0 0 0 0 0 0 0 0 0 0 0 0 0 0 19 19 7 2 0 0 0 0 0 
0 4 0 1 0 0 0 0 0 0 0 0 0 0 0 0 0 0 0 0 0 18 33 35 31 19 5 2 0 0 0 0 
17 24 25 7 0 0 0 0 0 0 0 0 0 0 0 0 0 0 0 0 0 0 0 0 0 0 1 12 12 19 14 0 
0 0 20 3 0 0 0 0 0 0 0 0 0 0 0 0 0 0 0 0 0 0 0 0 0 0 0 31 39 43 29 15 
0 0 0 0 0 18 10 34 9 10 4 0 0 0 0 0 2 11 15 0 0 10 0 0 4 0 0 0 0 0 0 0 
0 0 0 0 25 54 9 0 0 0 0 0 3 0 0 0 0 0 1 0 0 0 0 0 0 0 0 0 0 0 0 0 
0 0 0 0 0 0 0 0 0 0 0 2 0 0 0 0 0 0 0 0 0 8 6 0 0 0 0 0 0 0 0 0 
0 0 0 0 0 0 0 0 0 0 0 0 0 0 0 0 0 2 7 0 12 16 0 0 13 16 31 37 54 58 47 9 
8 13 32 51 63 61 46 39 8 1 0 0 0 0 0 0 0 0 0 7 14 0 0 0 0 17 15 23 22 0 0 0 
0 0 0 0 0 0 0 0 0 0 0 0 0 0 0 0 0 0 0 0 0 0 0 0 0 0 0 0 0 0 0 0 
0 1 14 20 17 11 0 0 0 0 0 0 1 5 7 4 5 5 0 13 12 19 0 0 0 0 0 0 0 1 0 0 
0 1 0 0 0 0 0 0 0 0 0 0 6 8 9 4 0 0 0 0 0 0 0 14 25 0 0 0 0 0 0 0 
0 0 0 0 14 32 42 25 0 0 0 0 0 0 0 0 0 0 0 0 0 0 0 0 0 0 5 0 0 0 0 0 
6 28 40 38 27 8 0 0 0 0 1 0 0 0 0 2 4 0 0 0 10 4 0 0 0 16 0 0 2 2 1 0 
0 0 0 0 0 0 0 0 0 8 5 4 5 0 0 0 0 5 24 9 12 0 0 0 23 18 0 0 0 0 0 0 
0 0 0 0 0 0 0 0 0 0 0 20 24 22 33 27 15 16 28 26 13 0 0 0 17 0 0 2 0 0 0 0 
0 0 0 0 0 0 0 0 15 31 14 0 0 0 2 4 16 19 1 0 0 0 7 18 0 0 0 0 0 6 0 0 
0 0 0 0 10 29 48 53 30 0 0 0 0 0 0 0 0 0 0 0 0 0 15 0 0 0 0 4 15 0 0 0 
0 0 2 12 12 0 0 0 0 0 0 2 11 8 9 12 5 4 8 5 23 26 0 0 0 0 0 0 0 0 0 0 
0 13 14 0 0 0 0 0 6 11 8 7 14 13 9 9 6 7 0 0 18 0 0 0 0 0 0 0 0 0 0 0 
5 3 0 0 0 0 4 1 0 0 0 0 0 0 0 0 0 0 0 11 0 0 0 0 0 0 0 8 19 15 2 0 
0 0 0 0 4 5 0 0 0 1 0 0 0 0 0 0 0 3 20 4 0 6 7 0 0 0 0 0 0 0 0 0 
0 5 20 18 8 3 5 8 8 9 11 12 12 4 0 4 35 52 24 13 22 25 6 0 0 7 30 35 25 15 1 0 
16 19 16 13 14 14 15 15 15 15 16 19 29 53 84 90 70 37 30 41 42 33 14 20 19 33 18 0 0 6 19 29 
