10 243 171 166 163 158 169 173 159 151 155 159 171 149 70 0
7 397 288 274 303 264 248 239 267 265 273 269 255 213 159 74
43 376 124 7 0 0 0 0 0 0 90 155 186 150 97 0
68 414 168 0 0 0 0 0 0 0 0 42 122 167 174 0
0 166 59 0 0 0 0 17 14 0 0 0 0 17 77 0
0 0 0 0 0 0 0 0 0 0 0 0 0 0 0 0
0 0 0 0 0 0 0 0 0 0 0 0 0 0 0 0
15 133 0 0 0 0 0 0 0 0 0 0 0 0 0 0
0 197 79 0 0 0 0 0 0 0 0 0 0 0 0 0
0 47 0 0 0 0 0 0 0 0 0 0 0 0 0 0
0 107 36 0 0 0 0 0 0 0 0 0 0 0 5 0
0 101 0 0 0 0 0 0 0 0 0 0 0 0 4 0
0 0 0 0 0 0 0 0 0 0 0 0 0 0 0 0
0 0 0 36 38 0 0 0 0 30 140 0 0 0 0 0
0 0 15 50 0 0 0 0 0 0 0 0 0 0 0 0
101 224 181 160 169 161 109 181 319 359 249 132 172 125 131 41
