0 0 0 0 0 0 0 0 0 0 0 0 0 0 0 0
0 0 0 0 0 0 0 0 0 0 0 0 0 0 0 0
0 0 0 0 0 0 0 0 0 0 0 0 0 0 44 0
0 0 0 0 0 0 0 0 0 0 0 0 0 0 43 0
0 0 0 101 141 0 0 0 0 0 0 0 0 0 30 0
0 0 0 275 410 280 85 0 0 0 0 0 0 0 0 0
0 0 0 0 0 230 315 191 18 0 0 0 0 0 0 0
0 0 0 0 0 23 219 187 0 0 0 0 9 0 0 0
0 0 0 0 0 98 121 140 34 0 0 69 122 0 0 0
0 0 0 0 36 173 101 142 136 0 0 0 0 54 100 11
0 0 0 0 0 163 135 92 67 28 0 0 0 0 15 24
0 0 0 0 0 0 0 0 0 0 0 0 0 166 94 94
0 0 0 0 0 0 0 0 0 0 0 0 180 255 99 102
0 0 0 0 0 0 0 0 0 0 0 156 217 128 0 0
0 0 0 0 0 0 0 0 0 0 50 16 17 23 0 0
0 0 0 0 0 0 0 0 0 44 0 0 0 38 0 0
