0 0 0 0 0 0 0 0 0 0 0 0 0 0 0 0
0 0 0 0 0 0 0 0 0 0 0 0 0 0 0 0
0 0 0 0 0 0 0 0 0 0 0 0 0 0 0 0
0 0 0 0 0 0 0 0 0 26 0 0 0 0 0 0
0 0 0 0 0 0 0 0 0 0 0 0 0 0 0 0
0 0 0 52 0 198 140 64 0 0 0 9 0 0 0 0
0 0 0 119 45 152 117 9 0 0 261 163 0 0 0 0
0 0 0 0 0 0 0 0 0 0 0 0 0 0 0 0
0 0 0 15 19 33 24 0 0 0 0 74 126 0 0 0
0 0 0 0 0 6 15 0 0 0 203 392 181 110 43 0
0 0 0 0 0 17 95 0 0 55 335 137 0 0 79 0
0 0 0 0 0 123 146 0 0 340 243 0 0 0 76 0
0 0 0 0 51 274 113 0 229 227 0 0 0 168 144 0
0 0 0 0 14 131 135 186 82 0 0 0 82 295 0 0
0 0 32 56 0 0 25 0 0 0 0 51 239 183 0 0
0 0 38 0 0 0 0 0 0 0 0 125 154 0 0 0
