0 180 253 233 228 239 244 228 229 263 251 207 224 294 434 223
0 0 0 0 0 0 0 0 0 0 0 0 0 0 0 0
0 0 0 111 0 0 53 45 87 96 48 0 0 9 22 0
0 0 0 341 0 0 0 60 99 99 74 0 0 0 0 0
0 0 58 538 0 0 0 150 167 11 0 0 0 0 0 0
0 0 91 454 0 0 0 0 46 0 0 0 7 0 0 0
27 0 0 274 0 0 0 0 116 37 0 0 0 0 0 0
0 0 0 25 0 0 0 0 29 10 0 0 62 0 0 0
0 0 0 154 0 0 0 0 0 0 0 0 147 0 0 0
0 0 0 380 55 0 0 0 0 0 0 0 137 0 0 0
0 0 0 318 98 0 0 0 0 0 0 0 0 0 0 0
0 0 0 121 0 0 0 0 0 47 30 0 0 0 0 0
0 0 0 0 0 72 0 0 0 251 0 0 0 2 0 0
0 0 0 0 38 120 0 0 135 106 0 0 69 12 0 0
0 0 0 0 0 6 0 1 242 0 0 53 256 0 0 0
0 0 0 0 0 45 18 0 0 0 0 198 18 0 0 0
