0 0 0 0 0 0 0 0 0 0 0 0 0 0 0 0
0 0 0 0 0 0 0 0 0 0 0 0 0 0 0 0
0 0 0 0 0 0 0 0 0 0 0 0 0 0 0 0
0 0 0 0 0 0 0 0 0 0 0 0 0 0 0 0
0 0 0 0 0 0 104 70 112 238 253 86 0 0 0 0
80 0 0 0 0 0 105 119 148 257 293 322 185 23 0 0
253 260 270 91 59 110 164 100 140 230 279 426 353 242 0 0
187 9 139 94 96 99 46 0 56 189 256 463 399 283 9 0
133 0 31 72 102 24 65 18 102 209 224 313 221 122 0 0
34 0 0 0 38 1 49 35 148 264 298 406 311 132 8 0
9 0 0 0 0 20 117 120 144 262 346 328 185 0 0 0
0 0 0 0 7 127 262 240 217 283 316 74 61 0 0 0
0 0 0 0 0 80 257 208 199 279 154 0 0 0 0 0
0 0 0 0 0 63 200 141 159 104 0 0 0 44 43 0
0 0 0 0 0 0 109 263 176 75 0 0 45 209 85 0
0 0 0 0 0 0 45 80 112 0 0 0 152 188 18 0
