0 0 0 0 0 0 0 0 0 0 0 0 0 0 0 0
0 0 0 0 0 0 0 0 0 0 0 0 0 0 0 0
0 0 0 0 0 0 0 0 0 0 0 0 0 0 0 0
0 0 0 0 0 0 0 0 0 0 0 0 0 0 0 0
0 0 0 13 65 0 0 0 0 0 0 0 0 0 0 0
0 0 0 148 193 0 0 6 146 326 289 48 0 0 0 0
0 0 0 48 77 53 109 155 187 302 370 308 231 179 21 0
84 0 0 0 99 117 153 195 210 236 312 207 135 187 23 0
0 0 0 0 31 103 139 195 252 257 241 208 129 144 0 0
0 0 0 0 4 186 258 233 240 179 200 166 111 101 71 0
0 0 0 0 12 105 187 186 210 228 193 150 40 28 151 0
0 0 0 0 0 39 138 187 172 117 30 34 0 77 122 0
0 0 0 0 0 0 0 0 0 0 0 0 0 65 107 0
0 0 0 0 0 0 0 0 0 9 18 0 0 152 165 0
0 0 0 0 0 0 0 0 47 156 0 0 168 274 238 0
0 0 0 0 0 0 0 137 184 50 0 0 116 57 0 0
