0 135 177 120 124 125 120 116 110 106 98 95 102 120 161 0
0 282 326 230 227 205 189 178 179 195 247 281 307 355 480 218
0 103 96 0 0 0 0 0 0 0 0 0 29 160 242 33
0 0 0 0 0 0 0 0 0 0 0 0 0 0 83 0
0 0 0 0 0 0 58 67 0 0 0 0 0 0 0 0
0 0 0 0 0 2 117 188 0 0 0 0 0 0 0 0
0 0 0 0 0 0 121 123 0 0 0 0 0 0 0 0
32 50 118 0 0 0 0 0 0 0 0 72 0 0 0 0
48 352 361 0 0 0 0 0 0 0 0 23 97 121 70 22
0 216 209 0 0 0 0 0 0 0 0 0 0 0 0 20
0 21 2 0 0 0 0 0 0 0 0 0 0 0 0 0
0 70 0 0 0 0 0 0 0 0 0 0 0 0 0 0
0 38 0 0 0 0 0 0 0 0 0 0 0 0 0 0
0 0 0 30 0 28 50 56 0 0 0 0 0 0 0 0
0 0 0 40 52 39 127 178 0 0 0 0 0 0 0 0
0 0 0 0 0 0 114 152 0 0 0 0 0 0 0 0
