225 252 125 179 167 163 166 158 148 153 168 155 140 104 167 80
209 120 159 203 177 167 183 169 158 168 154 149 170 134 121 4
69 0 0 1 47 58 34 0 0 0 0 0 0 0 0 0
10 0 0 0 59 0 0 0 0 0 0 17 0 0 0 0
0 0 0 0 0 0 0 0 0 1 0 0 0 0 0 0
0 0 0 0 0 0 0 0 41 0 0 0 0 0 0 0
60 0 0 0 0 0 0 42 65 0 0 0 0 0 0 85
165 103 0 0 0 0 0 0 0 22 23 0 0 68 166 102
66 29 0 0 0 0 0 0 0 0 36 100 84 154 24 36
0 0 0 0 0 48 0 0 0 0 80 161 279 369 11 35
0 0 0 0 0 9 0 0 0 20 33 466 835 520 172 34
0 0 0 0 26 0 0 0 0 0 282 987 650 262 132 0
0 9 98 91 19 0 0 0 0 435 1254 845 80 31 0 0
0 158 27 51 60 4 0 0 509 1349 1046 94 0 48 0 0
65 164 167 113 0 0 0 397 1233 1111 266 0 50 94 0 0
109 136 57 38 0 0 230 694 590 76 0 16 138 0 0 0
