0 0 0 0 0 0 0 0 0 0 0 0 0 0 0 68
0 0 0 0 0 0 0 0 0 0 0 0 0 0 0 2
0 0 0 0 0 159 207 168 130 81 29 0 0 0 0 12
0 0 0 0 143 471 381 205 175 199 217 153 31 0 0 49
0 51 0 0 312 600 279 54 0 0 132 162 98 0 62 181
0 174 55 106 303 331 0 0 0 0 111 105 0 5 306 272
0 0 89 340 551 242 0 0 0 0 67 0 0 108 346 158
0 0 20 67 215 210 0 0 0 0 40 0 111 141 135 161
0 0 9 0 0 144 6 0 0 0 195 265 216 197 108 183
0 37 0 0 0 56 11 0 0 26 384 390 298 56 117 115
0 101 30 0 10 166 66 73 73 110 257 254 53 0 168 55
0 0 12 71 198 168 33 117 96 69 176 15 0 95 101 28
0 27 185 347 312 100 0 42 6 26 0 0 0 218 198 108
0 340 409 302 68 0 0 0 0 0 0 0 122 301 131 97
93 363 127 0 0 0 0 7 0 0 0 26 138 152 95 167
92 77 0 0 0 0 0 0 0 0 17 94 18 59 45 53
