224 314 139 118 98 89 84 90 98 109 117 119 120 56 30 63
146 388 117 148 110 77 56 55 72 102 112 122 106 42 0 0
139 191 0 20 44 13 0 0 0 84 63 32 0 0 0 0
143 284 33 57 98 66 0 0 0 76 182 258 226 78 0 0
103 437 193 0 0 0 0 0 0 0 55 270 377 339 31 0
0 324 425 86 0 0 0 0 0 0 0 58 185 355 119 28
0 0 61 0 0 0 12 0 0 0 0 0 0 61 39 61
0 0 0 0 0 0 57 0 0 0 0 0 0 57 3 26
0 0 0 0 0 0 167 26 0 0 0 0 0 160 0 0
8 73 0 0 0 47 159 61 0 0 0 0 59 84 0 0
1 98 0 0 0 38 118 45 0 0 0 0 0 0 0 0
0 40 0 0 0 0 47 0 0 0 0 0 0 41 0 0
0 0 0 0 0 0 0 0 0 0 0 0 0 48 24 0
0 0 0 0 0 0 0 0 0 0 0 0 3 76 0 0
0 0 0 0 0 0 0 0 36 27 104 0 55 131 33 0
0 0 13 45 0 0 0 61 50 77 0 0 0 5 0 0
