539 54 68 66 64 39 22 32 31 6 1 26 22 0 0 0
539 0 0 0 0 2 0 0 0 0 0 0 0 0 0 0
392 0 0 0 0 40 0 0 0 0 0 0 0 0 0 0
331 0 0 0 0 168 0 0 0 0 0 17 0 0 0 0
85 0 0 0 0 249 0 0 0 0 0 74 0 0 0 0
0 0 0 0 0 45 0 0 0 0 0 0 0 0 0 0
0 0 0 0 0 0 0 0 0 0 0 0 0 181 135 0
0 0 0 0 0 40 0 0 0 0 0 0 0 319 74 0
141 0 0 0 0 87 0 0 0 0 0 0 0 360 118 0
250 0 0 0 0 0 0 0 0 0 13 0 0 0 0 83
216 0 0 0 0 0 0 0 0 0 0 0 0 0 0 15
183 0 0 0 0 0 0 0 0 0 0 32 0 0 0 37
73 0 0 0 0 0 0 0 0 0 0 90 0 0 0 12
0 0 0 0 0 0 0 0 0 0 35 0 0 0 0 52
141 109 0 0 0 0 0 0 0 82 0 0 0 0 0 32
118 38 0 0 0 0 0 0 94 39 0 0 0 0 8 0
