426 0 0 0 0 0 0 0 0 0 0 0 0 0 0 0
879 183 109 172 180 197 175 184 192 191 183 142 135 148 349 33
700 0 0 0 0 0 0 0 0 0 0 0 0 0 12 0
727 0 0 0 0 0 0 0 0 0 0 0 0 0 49 0
330 0 0 141 356 420 258 85 194 121 53 0 0 0 0 0
473 0 0 38 386 393 309 240 302 282 366 284 220 62 0 0
538 55 0 0 0 0 0 4 217 270 239 156 271 118 119 0
322 98 0 222 198 63 0 0 181 225 131 0 63 0 0 0
224 0 0 126 293 252 0 0 108 116 41 0 9 28 48 33
246 0 0 53 163 95 0 0 53 135 103 66 108 43 138 66
297 0 0 82 61 7 0 0 0 122 185 41 75 0 156 0
321 0 0 0 0 0 0 0 0 38 136 94 12 0 22 0
218 0 0 0 0 0 0 21 191 203 133 0 0 0 0 0
128 0 0 49 92 83 42 112 169 115 15 0 0 0 0 41
179 0 0 38 15 0 0 0 0 0 0 0 0 0 0 0
200 159 58 32 0 6 27 82 0 73 53 21 12 43 12 24
