0 0 0 0 0 0 0 0 0 0 0 0 0 0 0 0
0 0 0 0 0 0 0 0 0 0 0 0 0 0 0 0
0 0 0 0 0 0 0 0 0 0 0 0 0 0 0 0
0 0 0 0 0 0 0 0 0 0 0 0 0 0 0 0
0 0 0 9 0 0 0 0 0 0 0 0 0 0 0 0
0 0 0 0 0 0 0 0 0 63 0 0 0 23 0 0
0 0 0 0 0 0 0 43 75 202 62 0 36 112 0 0
0 0 0 0 0 0 0 43 33 170 160 163 26 0 0 0
0 0 0 0 10 0 0 15 0 188 285 210 0 0 0 0
0 0 7 79 126 0 0 18 40 209 351 445 0 0 0 0
0 0 69 107 115 77 20 39 168 204 419 315 0 78 0 0
0 0 91 165 121 37 0 15 163 395 213 0 0 108 0 0
0 57 82 122 10 0 0 0 225 166 0 0 115 10 0 0
0 100 5 0 0 0 43 216 144 0 0 33 224 23 0 43
0 0 0 0 0 0 126 41 0 0 0 98 168 20 0 0
0 0 0 0 0 4 0 0 0 0 0 65 85 64 0 0
