0 0 0 0 0 0 0 0 0 0 0 0 0 0 0 0
0 0 0 0 0 0 0 0 0 0 0 0 0 0 0 0
0 0 0 0 0 0 0 0 0 0 0 0 0 0 0 0
0 0 0 0 0 0 0 0 0 0 0 0 0 0 0 0
0 0 0 0 0 0 0 0 0 0 0 0 0 0 0 0
0 0 0 0 33 0 0 0 0 0 0 1 0 0 0 0
227 147 0 64 201 0 0 0 0 23 215 47 0 0 15 0
103 304 213 295 57 0 0 0 0 56 56 0 0 89 85 0
0 0 0 0 0 0 0 0 0 0 0 0 0 0 0 0
0 0 0 0 0 0 0 0 0 0 26 200 214 0 0 0
0 0 0 0 0 0 0 0 0 0 192 288 34 0 0 0
0 0 0 0 0 0 0 0 0 0 148 0 0 0 0 0
0 0 0 0 0 0 28 4 0 163 0 0 0 0 0 0
0 0 0 0 0 0 0 17 11 0 0 0 0 165 236 0
0 0 0 0 0 0 87 234 0 0 0 0 0 0 0 0
88 55 0 0 0 0 83 0 0 0 0 85 231 180 51 0
