0 0 0 0 0 0 0 0 0 0 0 0 0 0 39 20
0 0 0 0 0 0 0 0 0 0 0 0 0 0 0 0
0 0 0 0 0 0 0 0 0 0 0 0 0 0 0 0
0 0 0 0 0 0 0 0 0 0 0 0 0 0 3 0
0 0 0 0 218 0 0 0 0 0 0 0 0 0 0 0
0 0 0 0 180 193 0 0 0 0 69 0 0 0 0 0
190 0 0 0 33 198 66 0 46 136 163 70 32 0 0 0
190 13 0 0 51 0 0 44 33 73 55 150 138 0 0 0
0 0 0 0 236 0 0 23 9 0 0 82 82 0 0 0
0 0 0 0 235 55 0 0 0 0 0 60 0 0 0 0
0 0 0 0 152 137 0 0 0 0 0 0 0 0 0 0
0 0 0 0 31 175 31 0 0 4 27 0 0 0 0 0
0 0 0 0 20 149 121 0 0 0 0 0 0 0 0 0
0 0 0 0 0 1 70 0 0 0 0 0 0 54 78 0
0 0 0 0 0 0 33 0 0 0 0 0 0 0 0 0
0 0 0 0 0 0 0 0 0 0 0 0 0 125 63 0
