0 0 0 0 0 0 0 0 0 0 0 0 0 0 0 0
0 0 0 0 0 0 0 0 0 0 0 0 0 0 0 0
0 0 0 0 0 0 0 0 0 0 0 0 0 0 0 0
0 0 0 0 0 0 0 0 0 0 0 0 0 0 0 0
0 0 0 0 0 0 149 299 176 15 0 0 0 0 0 0
0 0 0 0 0 0 269 402 199 89 109 14 0 0 0 0
15 0 0 0 0 0 0 0 0 0 33 113 119 8 0 0
133 44 0 0 0 0 0 0 0 0 0 0 0 93 125 2
0 0 78 0 0 0 0 0 0 0 0 0 0 0 0 0
0 0 34 0 0 0 0 0 0 0 0 0 0 0 0 0
0 0 50 0 0 0 0 0 0 0 0 0 0 0 0 0
0 0 33 0 0 14 153 68 48 0 0 27 0 0 0 0
0 0 0 0 46 155 255 138 102 181 271 2 0 0 0 0
0 0 8 192 294 214 163 97 221 256 4 0 0 0 0 0
0 0 204 162 97 0 0 0 56 0 0 0 0 0 0 0
55 11 0 0 0 11 117 91 0 0 0 0 56 0 0 0
