0 0 0 0 0 0 0 0 0 0 0 0 0 0 0 0
0 0 0 0 0 0 0 0 0 0 0 0 0 0 0 0
0 0 0 0 0 0 0 0 0 0 0 0 0 0 0 0
0 0 0 0 0 0 0 0 0 0 0 0 0 0 0 0
0 0 0 0 0 0 0 0 0 42 0 0 0 0 0 0
0 0 0 0 0 0 0 68 223 229 0 0 37 0 0 0
0 0 0 0 0 0 61 187 335 457 178 0 23 0 0 0
134 14 0 0 38 0 0 139 336 488 143 0 25 0 0 0
99 0 0 0 202 0 0 53 238 423 44 0 0 157 0 0
0 0 0 0 169 0 15 47 160 293 66 0 0 304 0 0
0 0 0 0 0 0 110 61 82 214 298 159 0 184 47 0
0 0 0 0 0 0 96 0 0 226 406 272 46 0 13 71
0 0 0 0 0 0 117 0 122 348 262 168 0 0 113 64
0 0 0 0 0 0 54 8 55 158 257 0 0 0 124 0
0 0 0 0 0 0 125 77 0 149 8 0 0 5 97 0
0 0 0 0 0 0 0 0 58 54 0 0 54 66 47 0
