0 0 0 0 0 0 0 0 0 0 0 0 0 0 0 0
0 0 0 0 0 0 0 0 0 0 0 0 0 0 0 0
0 0 0 23 50 17 12 18 18 1 11 0 0 0 0 0
0 0 0 0 62 143 239 212 191 98 5 0 0 0 0 0
0 0 0 0 0 0 0 0 0 0 37 80 36 0 0 30
98 0 0 0 0 0 0 0 0 0 0 0 0 0 0 3
0 0 0 0 0 0 0 0 0 0 0 0 0 0 0 0
0 0 0 0 0 0 0 0 0 0 0 0 0 0 0 0
0 95 212 0 0 0 0 0 0 0 0 0 0 0 0 0
0 141 251 0 0 0 0 0 0 0 0 0 0 0 0 0
0 0 41 0 0 0 0 0 0 0 0 0 0 0 0 0
0 0 0 0 0 0 0 0 0 0 0 0 0 0 0 0
0 0 0 0 32 0 0 0 66 0 0 0 0 0 0 0
0 81 266 236 162 0 0 0 0 0 0 0 0 0 0 0
17 71 113 34 7 0 0 0 0 0 0 0 0 0 0 0
12 6 40 0 0 0 0 0 0 0 0 0 0 0 0 40
