0 0 0 0 0 0 0 0 0 0 0 0 0 0 0 0
0 0 0 0 0 0 0 0 0 0 0 0 0 0 0 0
0 0 0 0 26 0 0 0 0 8 88 72 0 0 0 0
41 147 0 21 96 0 0 0 0 0 167 150 113 55 0 0
73 220 110 61 37 0 0 0 0 0 204 187 164 139 0 0
0 13 172 30 0 0 0 0 0 0 56 0 25 178 0 0
0 0 0 0 0 55 154 41 0 0 0 0 65 43 0 0
0 0 0 0 0 316 327 234 83 40 0 104 121 18 0 0
0 0 0 0 52 398 259 213 111 64 76 159 34 0 0 0
0 0 0 0 180 398 222 193 183 143 116 115 0 0 55 37
0 0 0 0 179 317 230 165 131 122 158 122 0 0 199 127
0 0 0 0 0 83 118 78 12 67 56 0 0 321 213 128
0 0 0 0 0 0 0 0 0 14 0 0 142 352 88 111
46 0 0 0 0 0 6 38 0 0 0 105 415 161 0 52
0 0 0 0 0 0 0 0 0 0 0 295 234 0 0 20
0 0 0 0 0 0 58 0 0 0 87 215 54 0 0 0
