0 0 0 1 0 1 0 0 5 28 13 0 0 124 222 0
0 0 0 0 0 0 0 0 0 0 0 0 0 55 145 0
0 0 31 38 0 0 0 0 0 0 0 0 0 89 239 0
0 0 61 219 0 0 28 111 70 0 0 0 0 0 172 0
0 0 22 240 2 0 53 130 168 79 0 19 0 0 114 0
261 0 0 131 40 0 0 0 114 70 0 0 108 0 17 0
185 143 0 0 0 0 0 0 86 7 0 0 0 0 0 0
139 145 35 52 0 0 0 67 156 6 0 0 0 0 0 0
0 0 107 208 59 0 0 106 171 72 0 0 0 0 0 0
0 0 0 81 0 0 0 66 81 98 0 0 0 0 0 0
0 0 0 0 0 0 15 68 24 62 0 0 0 0 0 0
0 0 0 0 0 0 0 24 0 0 0 0 0 0 0 0
0 0 0 0 0 0 67 89 0 0 0 0 0 0 0 0
0 0 0 0 0 0 0 0 0 0 0 0 0 0 0 0
0 0 0 0 21 56 0 0 0 0 0 0 0 0 0 0
0 0 0 0 0 9 0 0 0 0 0 0 0 0 30 0
