0 36 0 0 0 0 0 0 0 0 0 0 0 0 0 0
0 0 0 0 0 0 0 0 0 0 0 0 0 0 10 0
0 0 0 0 0 126 149 151 76 0 0 0 0 0 0 0
0 0 0 0 0 443 457 264 73 10 0 0 0 0 47 0
0 0 0 0 0 40 342 279 2 0 27 0 0 0 66 0
0 0 0 0 0 0 0 116 0 0 0 0 0 0 93 0
0 40 0 0 0 0 0 0 0 0 0 0 0 0 95 16
25 156 160 0 0 0 0 0 0 0 0 0 0 0 0 0
0 243 268 0 0 0 0 0 21 0 0 0 0 0 0 0
0 266 321 0 0 0 0 0 20 0 0 0 0 0 0 0
0 310 203 21 0 0 0 0 0 0 0 0 0 0 0 0
0 225 167 143 0 0 0 140 138 0 0 0 0 0 0 0
0 124 129 131 0 0 0 117 0 0 0 0 0 0 0 0
0 51 0 19 0 0 0 0 0 0 0 0 0 0 0 0
0 0 0 0 25 29 0 0 0 0 0 0 0 0 0 0
0 0 0 0 0 39 1 0 0 0 0 0 0 0 0 0
