0 0 0 0 0 0 0 0 0 0 0 0 0 0 0 0
0 0 0 0 0 0 0 0 0 0 0 0 0 0 0 0
0 0 0 0 0 0 0 0 0 48 46 0 0 0 0 0
0 0 0 0 0 0 0 0 0 62 126 0 0 0 0 0
0 0 0 0 0 0 0 0 0 26 81 0 0 0 0 0
0 0 2 248 73 0 0 0 64 4 0 0 0 0 0 0
0 0 0 65 152 217 148 0 30 0 0 0 0 0 0 0
0 0 0 0 287 217 149 0 0 0 0 92 0 0 0 33
0 0 0 305 417 75 43 2 0 0 0 143 133 0 0 91
0 0 0 336 404 0 0 46 5 0 0 0 140 263 111 69
0 0 0 182 180 0 0 0 0 0 0 0 211 336 170 45
0 0 0 25 51 7 0 0 0 30 92 0 55 194 140 65
0 0 0 0 0 1 0 0 0 55 104 31 30 112 85 108
0 0 0 0 0 0 0 0 0 193 0 0 0 83 68 98
0 0 0 0 0 0 0 0 0 0 0 63 35 0 1 115
0 0 0 0 0 0 0 0 0 0 0 46 0 0 0 24
