0 0 0 0 0 0 0 0 0 0 0 0 0 0 0 0
0 0 0 0 0 0 0 0 0 0 0 0 0 0 0 0
0 0 0 0 0 0 0 0 0 0 0 0 0 0 0 0
0 0 0 0 0 0 3 64 16 0 0 0 0 0 0 0
0 0 0 0 0 336 327 277 174 0 0 0 0 0 0 0
0 0 0 0 0 81 252 211 0 0 159 349 62 0 0 0
78 0 0 0 0 0 0 0 0 0 25 194 0 24 164 0
0 0 0 0 0 0 0 0 0 0 0 0 0 0 0 0
0 0 0 0 0 0 0 0 0 0 0 0 0 0 0 0
0 0 0 0 0 0 8 0 0 0 0 0 0 0 0 0
0 0 0 0 0 0 107 28 0 0 0 0 0 0 0 0
0 0 0 0 0 0 190 62 0 0 0 0 0 0 0 0
0 0 0 0 0 0 177 184 0 0 0 0 0 0 0 0
0 0 0 0 0 4 129 103 0 0 0 0 0 0 0 0
0 0 0 0 0 15 0 0 0 0 0 0 0 0 0 0
0 0 0 0 0 0 0 0 0 0 0 0 0 0 0 0
