0 0 0 0 0 0 0 0 0 0 0 0 0 0 255 229
0 66 0 0 0 0 0 0 0 0 0 0 0 0 587 275
0 0 0 0 0 0 0 0 0 0 0 0 0 0 354 117
0 0 0 12 130 0 0 0 0 0 0 0 0 0 324 124
0 0 0 227 408 0 0 0 27 22 0 0 0 0 364 120
0 39 91 415 218 0 0 0 0 0 0 0 0 2 332 56
0 151 221 419 219 0 0 0 0 143 0 0 0 75 363 108
0 123 298 436 330 0 0 0 0 229 279 0 0 63 261 79
0 0 11 240 30 0 0 0 0 257 255 0 0 193 319 0
0 0 45 192 0 0 0 0 0 110 61 0 0 368 0 0
0 16 0 79 0 0 0 0 0 0 0 0 0 197 0 0
0 0 0 62 0 0 0 0 0 0 0 0 268 81 0 0
0 0 0 0 0 0 0 0 0 0 0 192 200 0 0 0
0 0 0 0 0 0 0 0 0 0 53 184 0 0 0 0
0 0 0 0 0 0 0 0 0 0 100 0 0 0 39 0
0 0 0 0 0 0 0 0 79 107 0 0 0 0 0 0
