0 21 0 0 0 0 0 0 0 0 0 0 0 0 0 72
0 0 0 0 0 0 0 0 0 0 0 0 0 0 0 78
0 0 0 0 0 0 0 0 0 0 0 0 0 0 0 0
0 0 0 0 0 245 283 228 237 179 80 0 0 0 0 0
119 0 0 0 0 1 226 176 206 236 309 421 212 0 0 34
550 487 0 0 0 0 0 0 0 0 0 229 356 127 53 154
72 602 317 0 0 0 0 0 0 0 0 0 0 102 47 83
0 0 220 0 0 49 0 0 0 0 0 0 0 10 0 0
0 0 0 0 0 0 0 0 0 0 0 0 0 60 0 17
0 7 0 0 0 0 0 0 0 3 25 0 0 0 0 0
0 0 0 0 0 0 24 63 0 0 75 0 0 0 0 0
0 0 0 0 0 0 8 145 0 0 0 0 0 0 0 0
0 0 0 0 0 0 0 88 109 33 0 0 0 0 0 0
0 0 0 6 0 0 0 0 0 0 0 0 0 16 68 0
81 47 0 0 0 0 0 0 0 0 0 0 0 22 63 0
0 0 0 0 0 0 0 0 30 127 57 0 0 55 213 95
