0 0 0 0 0 0 0 0 0 0 0 0 0 0 84 0
0 0 0 0 0 0 0 0 0 0 0 0 0 74 314 148
0 0 0 0 0 0 0 0 0 0 0 0 0 0 140 18
0 0 0 91 0 0 0 0 0 0 0 0 0 0 51 0
0 0 0 415 0 0 0 0 91 0 0 0 0 0 0 0
0 0 0 220 0 0 0 0 41 0 0 0 0 0 0 0
0 0 0 69 0 0 0 0 0 0 0 0 0 0 0 0
0 0 0 332 0 0 0 0 0 0 0 0 0 0 74 80
0 0 0 573 54 0 0 0 0 0 0 0 0 0 157 0
0 0 0 455 24 0 0 0 0 0 0 0 0 0 0 0
0 0 0 366 0 0 0 0 0 0 0 0 0 0 0 0
0 0 0 179 56 0 0 0 0 0 0 0 37 0 0 0
0 0 0 26 78 79 0 0 0 0 0 0 271 0 0 0
0 0 0 0 0 122 0 0 0 0 0 178 99 0 0 0
0 0 0 0 18 103 0 0 0 0 0 0 0 0 0 0
0 0 0 0 0 0 0 0 0 0 0 0 0 0 0 0
