0 0 0 0 0 0 0 0 0 0 0 0 0 0 0 0
0 0 0 0 0 0 0 0 0 0 0 0 0 0 0 0
0 0 0 0 62 81 0 0 0 0 0 0 0 0 0 0
0 0 0 0 171 239 0 0 0 0 0 0 0 0 0 0
0 0 0 0 68 481 218 0 0 0 185 0 0 0 0 0
50 0 0 0 0 110 397 229 20 42 244 133 84 0 0 0
178 23 0 0 0 0 16 106 0 0 0 121 423 23 0 0
0 80 0 0 0 37 0 0 0 0 0 0 90 0 0 0
0 20 0 0 0 284 31 105 68 0 0 0 0 0 0 0
0 0 0 0 0 47 86 108 147 0 0 0 0 0 0 0
0 0 0 0 0 0 29 71 42 0 0 0 0 0 41 0
0 0 0 0 0 0 49 188 0 0 0 0 0 0 0 0
0 0 0 0 0 0 0 106 0 0 0 0 0 0 0 0
0 0 0 0 0 0 0 58 74 0 0 0 0 0 37 12
37 0 0 0 0 0 0 0 0 0 0 0 0 0 216 59
0 0 0 0 0 0 0 0 0 0 0 0 0 0 40 0
