306 738 581 504 507 501 491 480 488 478 459 471 479 595 234 488
0 0 0 0 0 0 0 0 0 0 0 0 0 0 0 0
144 601 315 157 74 150 160 154 178 209 205 247 297 479 0 489
95 478 249 0 0 0 0 0 0 0 0 5 87 340 0 336
0 291 252 0 0 0 0 0 0 0 0 0 0 270 0 317
0 71 100 0 0 0 0 0 0 0 0 0 0 3 0 276
0 0 0 0 0 0 0 78 0 0 0 0 0 0 0 78
0 0 0 0 0 0 0 0 0 0 0 0 0 0 0 98
0 77 0 0 0 0 0 0 0 0 0 0 0 0 0 171
35 368 225 0 0 0 0 0 0 0 0 0 0 0 0 286
0 220 236 0 0 0 0 0 0 0 0 0 0 0 0 199
0 201 142 0 0 0 0 0 0 0 0 0 0 0 0 211
72 244 76 0 0 0 0 0 0 0 0 0 36 33 0 260
71 130 0 0 0 0 0 0 0 0 0 72 29 0 0 278
0 0 0 0 0 0 0 0 0 0 0 70 0 0 0 207
0 0 14 45 85 0 0 0 0 86 161 0 0 0 0 219
