0 0 0 0 0 0 0 0 0 0 0 0 0 0 0 0
1 57 0 12 66 22 41 23 19 28 76 72 15 0 0 0
0 0 0 0 170 41 43 38 32 48 57 0 0 0 0 0
0 0 0 0 252 0 0 0 0 0 60 105 15 0 0 0
0 66 0 0 213 0 0 0 0 0 0 65 95 40 0 0
0 0 0 0 249 107 0 0 0 170 109 91 57 148 0 0
0 0 0 0 73 15 0 0 0 55 319 310 331 468 0 44
0 127 0 0 159 0 0 0 0 0 196 179 174 279 0 0
0 0 0 0 311 0 0 0 0 0 0 42 0 26 0 0
38 0 0 0 269 17 93 76 0 0 0 41 0 12 27 0
6 0 0 0 194 74 213 111 0 0 0 0 0 0 87 0
69 11 0 0 73 62 263 162 0 0 0 0 0 0 107 0
62 0 0 0 5 9 205 0 0 0 0 0 0 3 128 0
0 0 0 0 0 0 197 0 0 0 0 0 0 0 119 0
0 0 0 0 0 60 110 0 0 0 0 0 3 133 197 0
0 0 0 0 0 0 0 0 0 0 0 0 93 111 142 0
