0 0 0 0 0 0 0 0 0 0 0 0 0 0 0 0
0 0 0 0 0 0 0 0 0 0 0 0 0 0 0 0
0 0 0 0 0 0 2 0 0 0 0 0 0 0 0 0
0 0 0 0 0 0 0 0 0 0 0 0 0 0 0 0
0 0 0 0 0 0 0 0 0 0 0 0 0 0 18 0
0 0 0 0 0 0 0 0 0 0 0 0 0 0 0 0
0 0 0 10 0 0 122 47 0 3 2 16 31 0 0 0
79 0 0 17 0 0 102 7 0 0 68 74 0 0 0 0
149 0 0 0 0 0 66 8 4 49 97 29 0 0 0 0
81 0 0 0 0 0 36 26 51 58 0 0 0 0 0 0
66 0 0 0 0 0 17 2 31 0 0 0 0 0 0 6
34 0 0 104 44 0 25 0 0 0 0 0 0 0 0 24
67 0 0 0 0 0 0 0 0 0 0 0 0 0 28 0
66 0 0 0 0 0 0 0 0 0 0 0 0 0 103 29
0 0 0 0 0 0 0 0 0 0 0 0 0 0 66 0
0 0 0 0 0 0 0 0 0 0 0 0 0 51 43 0
