54 207 5 38 28 30 34 34 32 37 53 48 45 52 170 74
265 289 45 85 57 27 24 5 31 71 105 81 92 72 186 73
301 271 110 187 87 0 99 73 65 70 60 73 135 127 188 75
299 342 224 265 0 0 0 0 0 0 0 1 118 145 253 120
97 196 278 353 0 0 0 0 0 0 0 0 0 110 230 149
0 0 82 205 0 0 0 0 0 0 0 0 0 0 0 22
0 0 0 0 0 0 0 0 0 0 0 0 0 0 0 0
0 0 0 0 0 0 0 0 0 0 0 0 0 0 0 0
0 0 0 0 0 0 0 0 0 0 0 0 0 0 0 0
0 0 0 67 0 0 0 0 0 0 0 0 0 0 0 0
0 0 0 0 0 0 0 0 0 0 0 0 0 141 0 0
0 0 0 0 0 0 0 0 0 0 0 0 194 0 0 74
77 25 0 0 0 0 0 0 0 0 0 212 87 0 0 37
0 0 0 0 0 0 0 0 0 0 122 135 0 0 0 11
0 0 0 0 0 0 0 0 0 55 136 0 0 0 0 0
0 0 0 0 0 0 0 0 0 0 0 0 0 0 0 0
