-13 -67 -81 -81 -77 -77 -75 -72 -72 -72 -66 -66 -70 -68 -88 -36
-272 -303 -242 -242 -237 -242 -240 -240 -244 -246 -245 -238 -242 -237 -267 -168
-89 -85 -31 -39 -43 -73 -77 -72 -65 -66 -56 -21 -23 -21 -46 5
-93 -83 -45 -66 -54 -116 -163 -165 -173 -115 -91 -44 -62 -26 -43 5
-95 -142 -59 -59 -48 -94 -154 -163 -180 -121 -99 -64 -87 -75 -81 -21
-136 -149 -171 -96 11 35 14 -11 -29 -34 -73 -72 -80 -48 -78 -35
-102 -128 -156 -87 -19 63 51 35 15 2 6 -8 -18 -7 -98 -45
16 -150 -190 -137 -23 16 27 31 1 -27 -69 -14 -9 -9 -157 -58
-22 -119 -160 -193 -35 43 37 32 19 -47 -108 -43 -53 -126 -256 -97
-70 -129 -139 -122 30 87 53 22 5 -35 -34 -15 -22 -42 -46 17
-48 -81 -80 -82 -5 49 23 8 -5 15 39 37 -16 30 45 54
-63 -91 -89 -80 -24 45 57 8 0 21 54 20 -67 6 15 39
-12 -27 -35 -64 -59 -31 -2 -12 -14 39 88 -15 -17 38 49 32
-31 -61 -43 -49 -39 -6 1 -8 75 95 -39 -42 48 63 7 40
-49 -46 20 9 3 7 16 74 109 35 -54 33 87 82 -14 1
-35 -32 -14 -17 -19 -29 -39 -28 -134 -111 -82 -37 12 -37 -35 -13
