153 -10 6 8 9 10 10 12 15 10 14 15 16 14 -46 17
182 -42 6 9 12 10 11 15 16 14 9 10 4 12 -50 14
164 -47 1 3 34 21 14 18 -1 14 0 12 -6 -1 -58 31
164 -26 -10 -32 56 -21 -73 -74 -92 -44 -21 27 -10 0 -62 31
121 -14 -10 -96 90 11 -146 -163 -174 -102 -62 -73 -37 38 -51 30
-108 -54 -35 -84 203 168 62 -3 -18 39 36 -63 -88 52 -46 0
-143 -117 -167 -87 99 54 60 -9 -38 36 125 35 69 103 -79 -49
28 -25 -169 -215 24 -5 15 -34 -70 77 40 53 23 147 -67 2
115 10 -43 -37 107 77 -9 -26 -62 16 -51 -53 20 87 -50 -1
99 -27 -42 -116 133 72 -12 2 -34 -70 -106 -70 -8 -27 -11 29
84 -55 -26 -50 119 62 14 -6 -15 -24 -97 -30 -49 -47 5 39
86 -36 -26 -68 43 -11 47 1 -3 -56 -48 -39 -83 12 1 38
84 -18 -24 -49 -26 -18 29 -30 -85 -65 -71 -99 -61 -14 -15 55
71 -68 -64 -100 -92 -44 43 -3 -13 -13 -78 -88 -68 -16 -71 13
6 -63 -39 0 10 40 41 -11 -11 -31 -49 -94 3 1 -60 57
8 -20 6 10 6 6 12 -29 -64 -44 -60 -38 -7 -38 -79 -20
