-175 -235 -212 -214 -217 -219 -222 -222 -223 -223 -228 -225 -220 -219 -285 -180
60 -28 -19 -16 -18 -23 -28 -25 -19 -17 -8 -2 -3 -2 4 -92
36 -43 -33 -18 -24 -23 -44 -52 -44 -35 -26 -8 -14 -16 -41 -89
39 -40 -36 -28 5 56 -5 14 55 29 0 -26 -21 -19 -40 -92
34 -70 -55 -13 48 205 160 115 161 130 77 21 9 2 -3 -79
172 55 -13 43 38 87 133 82 92 68 92 154 111 16 -23 -135
188 96 0 -21 -49 -80 -11 -14 13 2 -47 32 81 15 35 -74
-16 46 191 86 77 35 -24 -4 23 -11 -83 -63 -26 -143 -99 -122
-4 -24 11 37 16 88 21 15 27 -3 -35 13 71 -3 45 -52
34 -14 -17 33 -62 22 -7 2 42 20 -12 -50 -38 -66 31 -28
11 -31 -33 12 -72 12 46 22 35 52 13 -198 -311 -168 -25 -27
48 4 12 15 -91 -45 2 8 -19 -37 -91 -234 -214 -84 -39 -43
38 -28 -59 -47 -72 -16 42 65 54 -133 -323 -229 -98 6 -19 -35
-2 -62 -43 1 5 49 46 45 -109 -343 -275 -101 -34 -22 -6 -22
15 -7 21 63 34 36 39 -149 -360 -311 -144 -74 -43 -25 -36 -48
57 50 37 34 39 26 -74 -214 -174 -70 42 30 -26 25 68 -15
