186 -68 -34 -41 -41 -42 -44 -46 -41 -42 -44 -45 -47 -48 -4 -146
106 -60 -27 -30 -29 -34 -42 -44 -41 -41 -36 -36 -38 -36 9 -118
93 -21 17 26 54 41 24 19 20 5 1 18 13 17 50 -29
90 -21 19 58 91 -30 -84 -68 -79 -68 -14 32 0 8 49 -29
148 -3 14 98 144 -25 -72 -38 -22 -1 26 10 -39 7 49 -42
106 10 9 79 101 25 38 58 117 188 186 68 10 63 35 -107
172 22 -48 19 -28 -45 30 51 115 182 165 116 122 154 -2 -196
182 104 54 17 0 -12 5 45 118 192 118 73 135 171 -40 -225
80 21 10 11 59 22 30 50 96 178 93 25 57 107 -20 -143
84 4 -31 -18 48 68 60 46 86 159 121 26 23 16 13 -17
101 -21 -19 25 51 56 73 21 70 149 176 100 -7 -43 10 9
90 21 44 78 38 42 72 41 70 93 47 25 -20 -21 17 12
72 55 83 31 -26 -22 42 2 43 52 -40 -73 -25 27 26 10
80 20 5 -31 -60 -22 32 5 15 3 -63 -50 38 31 26 -21
107 -16 -10 5 31 62 79 9 -28 -41 -47 75 77 71 51 -15
84 -9 9 17 10 46 83 10 -121 -100 0 48 74 81 15 -52
