-38 151 82 85 85 81 81 81 77 75 76 78 72 74 30 103
-122 61 -18 -17 -19 -22 -15 -16 -22 -18 -15 -17 -21 -26 -47 8
-102 64 -9 -38 -87 -112 -98 -103 -111 -100 -64 -28 -16 -12 -51 -5
-106 55 -29 -93 -128 -71 -9 9 5 -32 -73 -101 -76 -36 -56 -7
-240 -62 -92 -38 -22 61 60 41 38 13 -39 -49 -34 -36 -90 -18
-200 -76 -161 -101 -42 117 61 9 -1 20 11 64 -1 8 -35 9
-27 -32 28 -5 -34 112 10 -1 -10 25 -18 54 -42 -5 14 37
-4 23 132 56 77 115 1 -3 -17 -39 -67 -25 -61 -59 -12 37
-52 66 65 43 53 70 -11 -5 15 -96 -66 -29 13 0 65 15
-58 50 10 3 6 55 33 26 11 -19 39 47 -56 37 54 27
-51 76 47 1 -46 68 55 50 15 35 23 5 -18 102 40 4
-26 74 3 -57 -82 13 18 40 -19 36 7 -10 98 37 8 -3
-66 -34 -78 -17 23 48 41 59 50 -5 -20 44 21 -25 13 -18
-115 -15 16 79 78 55 17 0 -46 -47 69 -1 -18 9 -5 20
-48 87 67 56 17 -3 -15 -91 -93 38 -7 -13 -29 -5 -10 -16
9 88 42 10 4 4 8 55 158 132 90 102 84 124 102 57
