-165 -37 43 45 45 46 47 47 45 43 38 39 46 52 27 7
-41 47 72 75 75 76 76 76 76 72 76 75 78 77 49 123
-65 16 45 59 40 57 56 57 68 49 42 44 50 52 21 81
-69 -4 47 86 1 123 197 186 169 104 46 13 33 38 24 82
-22 -21 18 68 -164 -126 51 86 20 -51 -61 33 65 0 -1 76
130 48 1 1 -212 -184 -8 92 42 -67 -163 -104 -46 -121 2 98
-43 -165 -72 -54 -209 -141 -84 8 -24 -123 -237 -194 -108 -167 -32 90
-53 -48 -14 -42 -169 -42 -12 16 -1 -149 -145 -110 -102 -198 -66 80
-6 78 123 143 -39 -82 -7 0 -20 -66 -50 0 -111 -96 -38 31
8 62 98 65 -133 -160 -42 -19 -22 0 -58 -125 -259 -154 -109 -37
0 67 102 74 -97 -139 -49 -38 -9 -33 -77 -181 -190 -94 -60 -20
1 60 63 19 -52 -91 -61 0 2 -21 -37 -139 2 -21 -63 -5
0 38 79 102 68 -14 -84 -18 83 -54 -222 -56 23 -5 -49 19
21 75 95 76 44 9 3 37 -39 -179 -26 66 -21 -65 -73 0
16 31 1 5 36 25 17 -23 -114 -38 32 -23 -110 -134 -1 29
34 37 51 55 61 54 15 -43 70 121 60 -10 -89 -46 15 54
