135 -43 -20 -21 -24 -22 -20 -21 -19 -13 -18 -24 -17 -21 -98 -65
69 -48 -29 -32 -37 -39 -42 -45 -37 -29 -25 -29 -25 -23 -101 -83
90 -36 -26 -34 -57 -71 -72 -84 -79 -61 -15 -10 -11 -10 -75 -85
80 -22 -27 -5 -45 -15 17 6 11 -2 -8 2 -26 -1 -85 -91
-8 -43 -22 -60 7 111 75 43 33 -7 -25 11 0 -3 -109 -105
5 -56 -43 -120 -64 17 20 -5 -59 -77 -6 134 32 -45 -78 -50
98 -32 -170 -25 -47 -93 4 20 -48 -78 27 3 -91 -147 -113 -116
-5 -152 -220 -40 -79 -112 5 -9 -59 -74 -84 -159 -94 -68 -122 -86
-9 -82 -97 -91 -49 -30 9 -32 -23 -158 -165 -84 15 -99 -165 26
-15 -60 -66 -81 -25 -7 -28 -19 -23 -161 -101 -14 -16 -151 -78 35
41 -36 -39 -102 -92 -43 -17 -10 -73 -120 -106 -102 -174 -208 10 -16
34 -35 -57 -135 -81 12 61 14 -94 -170 -82 -205 -233 -60 27 -64
26 -67 -112 -110 -54 51 65 23 -170 -143 -69 -224 -98 4 -12 -62
-49 -103 13 77 73 38 2 -89 -139 -183 -176 -118 -40 67 -42 -92
-59 21 78 38 1 -53 -146 -199 -236 -279 -113 -125 20 -34 -175 -53
54 60 31 17 26 20 0 -59 -85 12 4 3 88 25 -16 -18
