-120 -115 -104 -102 -103 -103 -102 -101 -102 -106 -107 -99 -99 -97 -160 -11
-125 -75 -103 -101 -99 -99 -94 -87 -91 -90 -89 -81 -80 -79 -142 49
-108 -53 -60 -83 -96 -115 -98 -87 -101 -100 -65 -42 -35 -35 -109 42
-119 -48 -70 -97 -97 -113 -61 -48 -79 -55 -57 -49 -52 -36 -110 46
-127 -55 -59 -103 -32 -29 -22 -5 -6 -10 -31 -81 -85 -50 -121 43
-109 -90 -109 -179 18 124 62 58 68 36 34 -46 -74 -41 -90 71
12 44 -43 -30 110 152 37 29 45 15 49 51 29 60 -10 57
87 184 97 63 105 107 44 44 19 45 101 71 63 108 10 11
36 81 124 70 102 58 34 42 36 104 126 104 47 130 30 69
-12 34 27 -31 53 50 16 50 45 93 80 81 109 83 12 98
-2 42 27 0 66 61 37 59 30 41 61 143 185 76 51 88
4 47 42 43 80 15 -4 27 37 49 98 143 94 77 60 109
-5 39 33 43 66 40 28 42 35 76 133 63 52 40 21 102
2 34 8 -7 11 25 35 27 54 131 64 87 40 56 71 93
10 19 -8 -3 9 3 24 37 81 20 17 27 14 59 56 79
19 25 15 13 -2 1 50 70 10 13 41 29 97 109 76 78
