-129 -103 -135 -138 -141 -142 -141 -145 -146 -148 -153 -148 -151 -150 -203 -204
25 78 32 35 27 24 28 30 30 34 41 42 46 45 50 -1
51 81 45 55 55 34 35 34 43 68 85 52 48 54 30 34
66 81 40 55 11 -106 -79 -69 -69 -25 38 81 75 66 30 29
88 131 65 77 -30 -212 -198 -184 -162 -102 -60 -27 41 93 35 37
-5 18 133 224 114 -61 -118 -99 -98 -70 -110 -101 -10 72 -21 2
-168 -195 -34 12 1 38 29 53 47 38 -42 -52 -105 -171 -225 -100
-104 -319 -328 -148 -83 -20 37 66 68 51 -15 -1 -37 -266 -410 -340
9 -70 -225 -165 -46 -32 34 54 37 26 -12 19 -36 -119 -201 -148
10 -18 -75 28 83 -4 23 35 73 7 -93 -47 -132 52 -5 -2
-77 -97 -89 -15 42 20 27 46 54 24 -123 -186 -225 -9 -17 23
-49 -94 -55 0 -47 -40 -24 -41 -16 -36 -219 -213 -95 20 44 19
28 13 -50 -88 -168 -106 -124 -141 -161 -306 -250 -112 78 28 34 63
35 -31 -130 -159 -158 -39 -38 -119 -225 -326 -183 55 112 -82 -46 32
-61 -116 -115 -83 -75 -25 -51 -206 -278 -133 30 137 -27 -15 -41 14
-94 -103 -70 -17 31 25 -119 -324 -267 -2 54 16 -50 -99 -82 -10
