-99 -59 42 44 46 48 43 40 39 39 26 17 24 30 93 -103
-27 -7 20 21 27 36 30 29 28 33 34 29 29 22 104 -57
-62 -31 20 -4 -52 -50 24 21 17 -34 -50 -40 3 26 88 -87
-95 -85 6 0 -189 -234 21 39 -27 -127 -167 -123 -67 0 74 -88
-75 -157 -60 0 -250 -345 -19 73 53 -121 -202 -204 -168 -186 -59 -122
-53 -355 -343 -215 -423 -415 -174 -61 -28 -145 -261 -258 -229 -328 -217 -135
141 -98 -178 -136 -340 -238 -97 -56 8 -77 -228 -310 -152 -223 -169 -215
61 104 196 149 -170 -188 -30 -36 -10 -92 -211 -218 -99 -245 -190 -242
-12 25 121 81 -179 -270 -108 -104 1 -59 -185 -193 -206 -322 -238 -184
-18 -26 16 62 -178 -262 -161 -142 -13 42 -130 -243 -226 -292 -228 -171
-21 -20 1 42 -146 -193 -143 -102 -78 -62 -128 -181 -187 -224 -168 -152
-30 -37 -5 47 -26 -42 -127 -87 36 -79 -196 -279 -213 -146 -87 -122
-35 -38 11 87 71 97 25 -12 21 -73 -203 -280 -159 -166 -147 -181
-25 -31 18 40 49 73 32 16 -5 -95 -188 -84 -183 -194 -138 -157
17 1 12 0 13 61 34 0 -38 -95 -34 -22 -162 -180 -79 -84
60 28 12 13 16 48 98 66 -36 -30 46 53 11 12 20 -19
