104 120 73 76 75 75 70 70 73 70 65 73 72 72 29 30
67 32 -20 -12 -7 -3 -7 -3 -1 -2 -3 1 4 0 -9 47
81 37 -13 10 26 76 89 90 96 76 52 30 15 4 -17 52
81 62 -2 -42 -77 -4 13 6 -7 -3 16 57 47 32 -20 52
100 107 47 -110 -158 -33 29 -2 -13 -49 -55 -8 39 94 31 67
-84 26 143 -85 -109 -23 26 50 21 -56 -67 -46 -46 13 24 61
-187 -166 -111 -198 -116 -62 -28 8 -14 -70 -94 -116 -176 -57 35 63
-35 -61 -75 -102 -96 -40 -31 -4 -7 -71 -38 -134 -109 -23 38 5
79 105 56 -15 -100 -14 -19 10 -59 -79 -83 -138 -185 -41 -1 71
104 117 85 -20 -126 -26 -41 9 -26 -76 -103 -156 -221 -217 -76 26
115 105 68 -29 -100 -31 -38 11 7 -68 -78 -196 -200 -219 -70 32
124 119 79 0 -111 -74 -44 59 14 -62 -139 -172 -159 -132 -49 41
84 82 53 0 -47 -73 -66 40 -11 -199 -252 -219 -127 -62 -38 73
51 39 18 16 8 5 -16 1 -119 -238 -206 -124 -113 -97 -59 51
29 38 31 37 52 54 25 -15 -106 -75 8 0 -83 -7 26 106
-5 0 -13 1 6 25 -12 -88 -95 -17 14 -100 -118 -92 -18 73
