51 -98 3 0 -2 0 0 -3 -3 1 -1 -13 -18 -13 9 -120
87 -43 20 15 12 18 17 11 11 17 17 9 10 12 28 -97
56 -67 -7 -2 -11 -13 -26 -33 -13 -21 -35 -25 -15 -10 21 -107
59 -94 -11 68 4 -80 -39 -6 27 7 -17 -34 -33 -32 21 -107
108 -99 -46 59 -168 -280 -49 59 127 121 79 20 0 -68 -14 -118
227 33 -83 -42 -296 -387 -103 32 131 85 -7 0 132 -43 -52 -148
203 172 67 -55 -406 -333 -109 24 127 68 -78 -98 68 -78 -121 -114
75 43 72 13 -224 -224 -63 23 146 113 -33 -136 15 -28 -95 -147
40 -47 28 83 -136 -226 -19 25 126 142 14 -80 82 42 -120 -211
31 -30 44 63 -107 -193 -18 -35 56 157 19 -101 105 55 -156 -193
25 -15 37 34 -85 -155 -51 -76 32 100 74 27 171 3 -167 -174
13 -15 38 41 -45 -114 -66 -83 45 79 127 180 65 -92 -128 -134
25 8 53 0 -95 -114 -96 -80 46 161 245 113 -61 -93 -80 -120
59 -14 -34 -75 -79 -36 -35 -42 132 337 177 16 -73 -115 -16 -117
41 -68 -53 -31 -22 -6 -28 43 275 170 7 11 -70 -89 -32 -139
23 -4 16 16 4 15 62 192 195 16 22 15 -32 -28 -21 -86
