-200 -50 -87 -82 -82 -89 -85 -79 -83 -95 -83 -73 -76 -74 -153 31
-168 -111 -106 -101 -111 -122 -112 -102 -106 -105 -94 -90 -87 -83 -154 9
-101 -38 -45 -56 -56 -68 -62 -48 -48 -15 -4 -5 -5 -8 -85 45
-83 -16 -44 -62 -49 -110 -116 -108 -94 -49 -34 -17 4 0 -74 46
-89 -1 -39 -53 39 32 18 8 21 52 -23 -77 -35 3 -60 57
-166 -90 -26 52 156 184 78 18 -9 45 -19 -24 17 19 -78 57
-193 -75 -5 -41 125 187 58 -3 -41 3 -35 43 -24 -133 -148 93
-197 -93 -27 -10 186 180 38 -7 -23 -20 -24 37 -163 -166 -40 113
-105 -76 -54 39 139 110 34 42 -29 -30 -14 -9 -162 -67 25 3
-98 -78 -54 0 80 45 62 69 -1 -46 -49 -61 -184 129 142 71
-79 -23 6 4 30 -7 21 18 -17 -24 -65 -201 -147 108 25 87
-41 -22 -31 -35 -14 -44 -21 -21 -26 -81 -227 -176 -15 -17 1 93
-8 -15 -49 -70 -67 -86 -64 -45 -99 -274 -228 9 -26 -66 48 137
-39 -68 -92 -43 -2 14 32 -41 -217 -286 -118 -94 -43 -44 111 153
-110 -67 -33 7 14 -32 -95 -277 -336 -139 -137 -62 -75 -25 85 100
-56 -8 12 18 11 -18 -100 -253 -172 -88 -64 -12 -80 -15 48 72
