-116 93 102 101 101 101 98 97 94 88 80 84 94 90 21 -78
-21 150 80 79 78 83 78 81 74 64 62 65 68 61 49 28
-53 112 68 62 0 31 37 40 36 21 40 46 66 57 55 11
-82 94 88 -6 -146 -23 38 18 -28 -82 -45 -16 50 48 61 12
-157 24 64 -169 -352 -75 44 2 -69 -172 -103 -71 -42 -32 54 1
-251 -224 -1 -330 -381 -21 6 -4 -94 -244 -218 -213 -206 -243 -24 -31
-451 -342 -243 -518 -361 -19 -30 -62 -135 -281 -224 -193 -315 -259 15 26
-207 -64 -103 -177 -125 29 -9 -40 -120 -278 -118 -186 -187 -120 151 12
-57 89 118 -107 -192 -20 -54 -36 -165 -185 -109 -154 -218 -167 -20 12
-50 51 39 -171 -289 -34 -137 -64 -111 -84 -156 -167 -157 -80 14 32
-43 78 54 -165 -247 -40 -135 -60 -49 -150 -81 -134 43 39 0 34
-50 41 7 -103 -116 -8 -142 -64 -64 -95 -105 47 117 -39 -4 25
-41 62 38 5 25 -13 -114 -18 22 -69 48 128 -66 -62 -48 20
-29 83 69 77 85 54 -5 72 -8 37 185 64 -121 -145 -51 -9
-24 97 124 101 59 -2 -6 6 36 105 69 -102 -209 -72 -18 20
43 112 61 49 38 25 32 72 58 56 12 -104 -63 -7 -9 18
