170 87 68 66 65 67 64 63 65 58 58 63 62 58 37 0
145 10 23 27 24 24 20 19 19 12 13 19 15 14 -58 7
176 26 52 58 67 62 46 47 42 54 44 46 51 51 11 33
180 30 55 28 43 29 -31 -41 -51 -11 33 80 59 47 11 32
177 54 51 -35 -99 -54 -153 -190 -192 -125 -35 14 55 66 9 16
-13 24 83 -100 -101 17 -50 -96 -99 -71 -30 -52 -31 55 -2 -24
-219 -129 -43 -206 -109 44 52 30 -17 -42 -16 -45 -39 -2 -48 -53
-202 -222 -204 -291 -97 41 40 19 -32 -13 20 -49 -71 -111 -71 -15
-46 -138 -188 -176 -31 63 26 -14 -66 -7 24 -113 -70 -24 -2 75
94 -27 -52 -132 -68 69 23 3 -37 -67 -24 -39 -6 56 78 120
36 -55 -26 -89 -77 39 -24 9 -33 -101 -39 4 66 49 99 97
23 -16 17 -94 -109 -36 -26 -15 -41 -94 -51 -6 130 73 96 71
67 16 14 -94 -98 -98 -105 -97 -87 -99 25 84 90 3 82 70
96 -33 -79 -112 -89 -95 -89 -34 -59 -6 158 169 -27 -47 -3 57
9 -101 -44 -8 18 17 5 -16 -53 93 159 35 -103 -22 -16 65
-29 5 51 63 35 -18 -62 -63 2 110 68 -46 -20 -7 -15 32
