-87 -44 -55 -55 -57 -59 -60 -61 -66 -65 -62 -67 -68 -69 -160 -26
-30 -8 22 20 20 20 22 21 21 17 25 25 15 14 -71 -56
-45 -28 -2 -8 7 -13 9 6 11 6 9 0 8 9 -70 -28
-50 -34 -21 -64 70 64 74 56 57 26 9 5 -4 21 -71 -31
-18 -36 -8 -138 38 102 87 73 85 39 62 31 17 -9 -92 -42
104 -14 -73 -115 -54 -20 16 5 11 -38 55 81 78 31 -56 -9
116 206 -15 32 79 -12 36 35 47 -34 -12 -61 63 68 26 14
-101 48 22 -17 67 -12 37 39 49 -22 -52 -42 7 -109 -171 -34
-64 -89 -73 -119 17 41 2 36 50 18 -55 -1 100 -78 -166 -41
10 17 15 -80 34 36 2 24 43 50 10 -20 62 1 -48 -38
15 14 18 -64 25 39 55 36 13 43 42 -73 -80 -33 -23 -21
4 26 23 -27 23 28 61 64 53 28 69 -78 -164 -17 -31 -26
-9 2 34 16 14 22 78 74 30 -17 -50 -119 -58 10 -6 -45
-7 -1 51 38 19 -14 -27 -19 0 -97 -148 -97 -11 51 25 -4
11 1 7 -21 -18 3 29 -16 -56 -76 -81 -43 41 48 -23 23
6 -37 -10 7 8 4 9 -59 -97 -55 -41 -9 -23 46 63 -31
