-20 8 41 41 44 43 39 36 38 37 24 27 35 36 -62 -14
-26 -57 11 12 17 16 10 9 9 10 6 -1 0 2 -73 42
-7 -45 24 15 23 68 64 54 40 42 21 26 29 25 -49 70
-36 -60 23 -20 -47 73 34 -2 -72 -92 -75 -17 21 30 -52 69
-81 -74 16 -159 -124 155 98 40 -87 -121 -131 -111 -93 -27 -58 62
-176 -221 -63 -263 -131 138 50 -24 -170 -260 -209 -76 -172 -192 -132 33
-140 -162 -290 -398 -126 81 21 -61 -197 -300 -278 -132 -256 -210 -90 53
-151 -71 -154 -228 -78 54 -3 -77 -178 -289 -304 -238 -228 -185 -153 1
-91 -94 -66 -190 -126 23 -34 -65 -157 -281 -374 -177 -194 -335 -326 14
-51 -64 -33 -187 -123 15 -133 -85 -74 -210 -357 -240 -190 -308 -223 69
-35 -63 -57 -227 -135 11 -118 -77 -104 -145 -242 -300 -257 -315 -165 33
-43 -69 -60 -142 -47 25 -26 -17 -75 -200 -210 -294 -313 -210 -72 -4
-46 -46 -27 -57 12 32 0 -1 -86 -209 -249 -345 -275 -62 -76 1
-73 -88 5 48 81 32 7 -7 -61 -154 -268 -355 -216 -22 -116 -21
-67 -9 90 60 41 6 -36 -60 -117 -205 -265 -281 -127 -68 -146 42
31 36 37 24 11 11 22 -44 -186 -160 -125 -128 -58 -79 -99 10
