-22 82 14 15 17 13 14 17 16 13 15 17 14 19 50 -62
33 59 4 1 0 -3 -4 -1 3 10 17 17 17 14 69 -54
28 67 4 -8 -33 -47 -21 -18 -10 -14 2 18 22 19 68 -18
17 65 17 -1 -95 -120 -76 -62 -67 -88 -80 -26 24 36 76 -18
5 13 39 29 -96 -169 -78 -48 -55 -94 -117 -67 -21 -5 66 -18
55 -59 -23 4 -97 -95 -32 1 -10 -86 -155 -69 -29 -103 -62 -75
86 10 -86 -145 -102 -53 -5 43 36 -70 -116 -82 -79 -198 -173 -149
63 116 11 -85 -83 -24 22 66 54 -46 -89 -84 -121 -199 -219 -245
31 53 34 -21 -81 -72 26 48 75 -42 -169 -137 -147 -131 -127 -179
-8 8 -20 14 -60 -44 -6 25 61 -19 -227 -244 -188 -94 -89 -60
-28 -30 -54 -40 -89 -79 -37 0 -3 -28 -173 -212 -178 -102 -88 -40
7 -4 -51 -68 -129 -137 -104 -67 -71 -194 -174 -79 -84 -143 -52 8
19 6 -69 -92 -132 -106 -81 -53 -105 -235 -252 -57 -110 -66 -10 -1
-37 -79 -135 -127 -86 -49 -23 -51 -74 -86 -118 -129 -123 -64 23 8
-94 -111 -103 -60 -7 1 -63 -75 -36 -2 -70 -114 -122 -58 47 -4
-32 -72 -15 -6 15 12 -22 -48 -62 -1 -18 -27 -83 1 23 28
