131 108 109 110 109 111 112 110 109 111 112 109 109 108 126 76
-34 -38 -33 -36 -34 -25 -26 -27 -30 -27 -36 -43 -36 -42 -76 -71
6 20 20 13 56 85 86 82 73 50 32 16 15 6 -9 5
-2 25 25 16 57 64 28 24 -6 0 8 58 44 22 -9 5
-3 60 54 -13 -28 -13 -87 -99 -129 -108 -32 4 4 42 25 27
-59 1 64 -47 -45 -33 -82 -56 -83 -105 -86 -46 -132 -14 7 29
-100 -53 -20 -107 -26 23 -4 6 -11 -71 0 -95 -79 9 57 23
-30 -49 -115 -170 -115 -37 12 -5 -52 -55 4 -46 40 107 125 5
31 10 -28 -132 -123 -36 12 -19 -23 -25 -15 -6 31 33 -70 -53
29 38 26 -114 -79 5 -20 -49 -24 -4 -19 5 84 15 -94 -16
44 24 -2 -98 -58 23 -66 -9 -32 -7 -39 65 238 -17 -33 -7
-13 -33 -14 -31 12 10 -15 -16 -9 -38 23 220 108 -50 -21 -24
-16 18 53 32 25 -18 -63 -87 -60 22 289 102 -32 -25 -2 -4
28 55 34 -13 -41 -83 -80 -60 53 340 160 -34 -40 43 -39 -34
34 41 2 -44 -51 -29 20 161 385 244 1 -10 10 50 -20 -12
-21 -52 -70 -57 -49 -21 66 218 102 -98 -66 -80 -23 -79 -128 -58
