132 160 113 112 113 114 113 114 115 116 119 119 120 114 174 155
53 -48 -24 -30 -35 -34 -38 -41 -41 -37 -34 -34 -37 -44 -29 -7
110 24 30 27 -12 11 -3 -3 -8 40 36 31 33 29 49 54
121 25 36 112 32 17 -4 19 49 57 83 25 54 27 48 54
80 85 41 158 -15 -124 -144 -99 -76 10 31 6 54 40 62 52
28 88 93 136 -26 -84 -91 -27 15 49 31 -78 80 46 67 34
-122 8 162 198 77 88 33 63 71 138 49 22 83 -13 -11 48
-88 -116 28 22 50 68 19 62 82 164 166 116 6 -31 -3 55
16 -106 -58 89 55 29 -4 52 47 149 179 -1 6 14 35 -38
27 -37 0 113 27 32 17 67 56 64 99 -15 80 114 42 -19
25 -3 34 123 55 29 -4 0 63 -13 18 47 176 160 3 15
17 7 25 86 52 -11 -78 -29 43 25 44 129 144 19 -18 32
55 22 14 -20 -52 -65 -108 -45 30 51 52 215 61 -41 8 48
74 22 -82 -112 -92 -75 -132 -82 -28 40 163 101 -27 -62 45 51
18 -87 -150 -139 -91 -55 -79 -62 19 71 23 0 -63 -84 -7 13
-28 -51 0 27 34 37 0 55 131 79 85 118 46 69 67 40
