184 247 206 203 198 196 194 191 193 198 196 190 179 179 231 159
-85 22 -5 -6 -7 -5 -12 -17 -18 -17 -18 -16 -17 -18 -15 -34
-24 57 44 52 35 39 20 6 3 10 26 37 36 32 49 21
-33 41 44 89 45 13 -2 -5 -6 -12 23 14 38 26 41 15
-86 24 60 130 54 -66 -111 -86 -54 -66 5 -13 47 25 60 20
-100 13 54 112 52 7 -16 -10 39 18 72 -33 42 47 107 60
-49 10 94 149 73 80 45 36 34 9 54 -51 -22 -6 7 -19
-57 -26 21 -14 -22 41 20 28 11 14 47 16 20 23 25 -3
-18 46 15 28 19 18 9 20 17 2 38 67 63 53 91 3
-33 22 18 20 -1 62 10 18 -1 11 54 -2 49 -11 42 6
-4 32 37 33 40 70 -13 20 13 0 -1 -37 83 0 24 2
-21 12 16 -9 5 40 -45 -20 -15 -59 2 60 15 -29 -4 14
-37 22 47 17 -24 -38 -105 -81 -117 -101 18 52 16 14 -13 22
-25 27 17 -31 -56 -100 -133 -96 -102 -20 -48 -24 33 70 2 22
-24 -38 -95 -129 -94 -43 -85 -67 10 -8 -51 22 44 14 -25 20
-83 -100 -97 -76 -58 -38 -9 27 -44 -58 -38 -62 -60 -23 -38 9
