-127 -173 -188 -181 -176 -173 -172 -166 -161 -158 -161 -154 -152 -148 -156 -127
-91 -238 -208 -195 -186 -180 -177 -170 -168 -169 -169 -164 -159 -155 -137 -132
-90 -185 -161 -138 -131 -125 -137 -123 -112 -116 -115 -121 -119 -118 -122 -132
-81 -169 -153 -123 -76 -26 5 28 43 31 1 -59 -100 -118 -119 -126
-18 -125 -147 -88 -100 -68 -57 -43 -29 -2 33 37 -32 -102 -101 -112
83 -8 -48 -19 -24 -3 38 65 58 70 52 37 -65 0 42 -26
35 -29 128 152 73 -3 -13 19 26 68 36 117 29 62 43 -18
64 -11 21 66 39 17 0 24 35 27 83 120 31 17 53 -7
35 46 61 123 73 15 3 25 22 41 137 110 46 52 93 -3
39 5 21 52 -20 -12 12 41 44 59 150 117 -2 24 20 -23
17 3 43 102 37 32 22 41 50 67 107 -5 -55 22 -5 1
28 -11 12 76 11 27 17 45 78 123 64 -62 58 30 -5 -7
30 -2 51 122 89 39 12 50 61 -10 -83 -2 87 0 29 21
32 35 41 0 -29 11 14 44 -19 -112 33 111 36 -13 9 7
16 -21 -44 -18 -14 -20 15 -5 -86 -25 56 22 36 53 72 -11
0 -6 -4 -12 -17 -9 -44 -62 52 53 8 44 30 51 65 -3
