-47 -132 -103 -106 -107 -102 -105 -105 -104 -102 -105 -105 -99 -103 -135 -89
-35 -64 -58 -63 -59 -53 -57 -55 -52 -52 -64 -55 -53 -52 -93 -2
5 -27 -10 -9 -2 -26 -36 -35 -27 -37 -22 -14 -10 -6 -62 -5
0 -12 -3 -39 0 4 -9 -10 3 45 56 30 -28 -10 -65 -1
21 -14 -19 -40 60 -22 -107 -81 -66 -13 28 41 17 8 -82 -12
33 92 11 -30 99 56 -18 1 6 15 35 -7 -59 2 -78 -12
-124 -36 -92 15 148 66 22 37 32 40 78 -74 -27 -7 -57 -12
-52 -181 -108 -13 -4 65 38 25 33 45 -17 72 121 28 -127 0
-22 -67 -65 -45 77 89 17 3 7 10 38 130 85 -9 -31 101
-14 -45 -48 -12 113 74 -8 37 12 29 130 180 136 -8 22 68
-6 -26 -9 6 135 56 0 24 18 64 73 189 90 19 32 26
-14 10 16 19 100 36 -39 -60 9 13 141 68 -24 75 -4 23
8 10 15 31 95 21 -50 -46 -14 200 68 -106 49 96 -16 10
33 64 67 44 22 -12 -77 -93 91 74 -78 32 105 64 -44 39
75 104 8 -24 -18 -4 -21 89 55 -95 -5 40 143 0 -68 13
14 -17 -28 -16 -14 -13 9 -75 -122 -49 -51 60 38 -64 -57 -22
