68 87 72 78 75 73 73 76 74 69 68 79 69 78 49 220
46 -14 -9 0 -8 -12 -12 -12 -19 -17 -13 -11 -9 0 -6 193
51 -5 -4 -13 -23 -8 5 2 -17 2 6 15 3 0 -15 134
52 -3 -12 -26 21 -147 -88 -62 -109 -87 -65 -10 37 11 -16 132
-36 2 0 8 174 -183 -114 -75 -128 -127 -162 -165 -42 10 -7 136
-198 -124 -45 -7 197 -143 -73 -42 -101 -84 -60 -215 -195 -67 -76 126
-113 -330 -240 -87 42 -86 -49 -67 -124 -124 -74 -108 -183 -103 -203 43
37 19 -138 -130 50 -88 -43 -54 -144 -169 -20 -41 -248 -87 2 77
23 38 25 -21 133 -143 -44 -28 -165 -158 -7 -47 -374 -108 101 3
13 -53 -16 -24 122 -199 -49 -14 -86 -103 -99 -47 -285 -57 36 -12
16 -39 -18 -12 124 -170 -49 -48 -58 -60 -184 -199 -96 49 -76 5
33 -29 -25 -20 51 -121 -60 -54 -92 -106 -264 -177 102 28 -96 44
31 -23 -15 35 57 -72 -44 -59 -74 -227 -239 -14 99 -98 -89 56
43 6 -40 -1 42 -25 20 -32 -147 -209 22 30 17 -156 -47 16
40 3 -9 -1 35 16 -1 -142 -152 29 10 -9 -41 -137 22 1
11 -15 13 0 -6 -13 -34 -111 23 35 -19 1 -35 -22 -19 45
