-124 -99 -71 -69 -66 -69 -65 -64 -64 -63 -60 -58 -55 -54 -70 44
-249 -188 -113 -116 -115 -123 -123 -123 -124 -121 -120 -120 -119 -118 -158 -55
-183 -87 -31 -18 -14 -34 -39 -45 -41 -27 -29 -9 -9 -14 -72 24
-179 -71 -26 22 56 25 -40 -46 -52 -36 -64 -46 -30 -12 -64 26
-204 -113 -53 58 193 187 94 69 68 68 10 -50 -72 -27 -56 41
-136 -123 -58 54 124 118 74 44 45 61 73 80 -2 -15 -45 11
13 -46 -111 4 78 86 48 27 33 31 24 110 16 -1 -17 40
4 0 29 97 95 94 40 33 36 13 0 94 54 19 4 65
-84 -91 -15 14 75 109 57 49 38 -22 -12 69 -43 -145 -123 -35
-75 -44 -26 32 41 80 31 56 55 19 -45 54 28 -40 -9 46
-26 -4 4 23 45 80 41 30 36 78 -14 -54 -70 -18 -13 34
-52 -2 22 35 28 80 56 27 22 -14 -2 -69 -68 -38 -57 31
-47 10 19 16 5 60 78 71 34 -25 -103 -127 -47 23 12 21
-61 -14 3 13 32 59 29 11 -11 -90 -114 -91 -22 98 12 35
-64 -1 3 -9 -8 20 1 -48 -115 -186 -183 -116 44 -2 -38 -6
-21 -21 4 6 1 17 24 -70 -128 -147 -111 -29 -23 -6 -18 -20
