77 73 72 72 74 77 75 76 79 84 77 78 85 78 145 -90
64 29 65 65 69 73 68 65 66 66 57 53 54 46 103 -134
56 -3 39 56 35 41 12 12 20 19 19 19 23 21 69 -120
53 -10 52 94 -47 -4 -9 15 27 -6 8 5 10 9 70 -119
38 -34 49 106 -166 -9 46 85 99 4 0 -6 16 -24 53 -145
26 -90 22 44 -279 -47 66 99 121 37 22 30 52 -86 72 -126
56 -76 1 -29 -230 -64 13 34 67 43 -9 98 119 -36 160 -95
111 26 51 -14 -178 -34 -14 26 67 41 -40 9 79 31 151 -90
57 43 107 81 -155 10 -20 12 43 2 -60 -85 6 -46 -25 -121
29 25 60 92 -224 24 -40 -4 23 -24 -52 -50 54 -132 -86 -136
55 49 61 93 -199 6 -79 -38 10 -41 -34 25 35 -76 -42 -82
40 38 43 38 -164 20 -41 17 47 5 75 0 -51 -88 -45 -73
26 8 9 -19 -99 5 -40 59 81 65 32 -9 -63 -54 -35 -60
4 -38 -25 -21 -36 39 -10 99 115 25 -48 35 -116 -38 -33 -74
-41 -73 -47 -10 -5 24 -6 83 20 -69 9 -62 -145 -41 -51 -75
-9 -2 -2 10 10 21 20 39 -24 -36 -25 -122 -108 -62 -28 -72
