35 -62 -22 -24 -26 -26 -25 -26 -26 -22 -26 -25 -26 -27 -9 -19
117 44 77 76 69 59 55 55 55 61 71 77 75 78 77 66
47 -39 -10 -1 -35 -54 -69 -66 -57 -32 -29 -22 -20 -13 -3 -10
65 -51 -10 26 10 -15 -42 -31 -5 2 0 -49 -23 -42 -9 -11
80 -41 -28 39 68 -41 -72 -69 -43 -13 3 -28 21 -30 -14 -31
132 45 -24 37 97 -8 -4 -13 -2 36 31 -62 71 -61 -39 -61
15 -38 -54 1 -6 -33 -16 -50 -18 16 5 -56 -20 -215 -285 -205
-47 -133 -174 -93 -39 -63 -25 -40 14 1 -21 32 20 -92 -151 -51
20 -21 -25 1 72 -20 -52 -19 6 18 -4 66 94 26 113 69
-34 -109 -107 -30 53 -15 -1 24 -18 -1 -16 47 -44 -141 38 -50
-46 -93 -58 2 77 -63 -28 -48 -49 -19 4 -70 -105 -24 12 -66
-8 -49 -52 -74 -8 -80 -85 -116 -94 48 -33 -120 -23 89 -22 -33
-2 -64 -64 -83 -56 -41 -57 -74 -64 -22 -141 -46 51 61 -88 -54
-2 -65 -74 -75 -43 -43 -19 -23 -86 -126 -30 35 112 6 -78 -57
-28 -69 -37 -22 2 -16 -51 -120 -227 -87 44 47 82 -49 -56 -40
-7 0 26 6 1 -3 -3 -10 -1 86 42 37 60 -2 -4 -11
