-161 -151 -70 -66 -65 -64 -65 -63 -67 -64 -65 -71 -67 -61 -108 27
-24 62 72 72 70 70 66 63 63 65 58 63 61 59 5 134
-63 -7 13 14 12 -14 -28 -29 -15 -42 -37 -14 2 2 -41 70
-76 -28 0 -22 0 46 99 97 109 104 22 -31 -55 -17 -44 71
-41 -103 -68 -35 -2 90 160 129 129 83 67 48 -15 -73 -109 46
110 62 -114 -142 -111 -72 -41 -78 -81 -110 -101 37 29 -26 -93 81
7 122 75 -51 10 33 -17 -60 -43 -71 -122 -119 -84 1 11 117
-174 -123 173 110 61 73 -2 -49 -39 -83 -150 -11 -77 -112 -70 48
-141 -136 -66 -51 -25 -5 -57 -81 -41 -72 -83 36 -51 -123 -54 73
-68 -39 -11 -27 -50 -24 -89 -99 -54 27 40 -3 -36 8 -4 40
-40 -17 -22 -43 -75 -36 -39 -28 -68 -38 47 -66 -149 -41 -53 29
-72 -29 -3 -23 -21 44 -21 -31 -10 -48 -10 -48 -90 -5 -65 17
-69 -74 -47 25 76 72 4 26 66 95 -33 -150 -60 0 -50 -15
-63 -22 52 102 91 14 -52 -24 21 -68 -154 -79 0 -44 -47 -6
-27 42 24 -33 -52 -56 -43 -41 -119 -231 -128 -53 -36 -114 -111 -27
8 22 -17 0 0 -17 12 -37 -67 -52 34 73 13 -23 51 76
