224 130 131 130 127 125 122 125 128 123 119 124 127 125 40 12
228 72 99 101 101 96 90 94 95 89 82 79 78 79 4 -54
217 64 93 90 106 84 53 62 56 66 64 78 77 68 -16 -47
204 78 102 51 111 133 113 114 99 109 85 91 76 65 -18 -45
152 71 71 -40 6 117 62 8 -32 -6 32 75 100 97 -1 -44
77 129 81 -42 -68 60 54 -2 -105 -93 -47 67 6 40 -15 -31
-59 20 -27 -114 -69 7 14 -11 -103 -101 -100 36 -54 -62 -50 -44
0 -42 -53 -152 -60 30 17 -13 -94 -66 -141 5 -89 -41 -7 -16
56 -4 17 -77 -46 35 18 -8 -117 -120 -187 -58 -123 -77 -59 3
49 -22 -36 -101 -122 -45 -17 -19 -52 -173 -185 -40 -132 -97 -91 6
38 -32 -37 -91 -137 -71 -39 -32 -60 -153 -155 -101 -196 -106 -78 31
28 -39 -42 -110 -176 -91 -42 -33 -97 -174 -194 -107 -117 -90 -99 8
39 -41 -57 -65 -83 -33 -27 -34 -116 -206 -206 -116 -90 -70 -14 28
9 -70 -62 -18 4 11 -2 -27 -131 -193 -82 -101 -134 -73 -26 4
-48 -50 -21 10 25 0 -20 -71 -173 -122 -99 -204 -161 -85 -87 13
-14 3 28 44 47 13 -46 -100 -33 -13 -93 -128 -124 -74 -60 -4
