51 -73 10 5 2 2 3 2 0 0 -1 -5 -5 -7 -47 -76
55 -105 53 51 49 43 42 41 38 38 46 36 37 42 84 -67
33 -130 29 13 7 -43 -75 -86 -74 -77 -34 5 9 14 35 -45
32 -130 23 -31 11 -66 -114 -125 -119 -114 -88 -32 -55 -17 33 -48
-9 -222 -29 -48 -77 -41 -95 -137 -102 -90 -59 -33 -86 -50 -12 -82
-3 -248 -162 -16 -42 75 144 109 111 57 13 52 -35 -54 -37 -133
12 -110 -257 -139 -190 -105 29 48 63 15 -12 113 75 -105 -171 -170
91 -14 -283 -247 -143 -87 11 20 33 17 -47 -44 30 -77 -52 -86
109 -29 56 0 -30 37 14 10 31 10 -138 -66 116 133 -33 -48
0 -153 -83 -62 -83 57 54 0 33 -26 -127 -60 81 54 -104 -36
-23 -113 -14 -10 -88 40 19 -54 -20 -32 -26 -21 116 44 -29 -30
22 -72 -39 -111 -171 -33 38 -13 -89 -40 78 139 37 0 6 -42
-5 -90 -30 -84 -149 -49 3 -29 -36 -16 179 136 -40 -18 37 -45
-31 -159 -101 -101 -53 24 74 77 72 220 198 -5 -75 -20 19 -82
-86 -159 -13 74 54 30 -14 -30 63 121 -57 -101 -66 56 -44 -121
0 0 51 30 8 -6 -36 70 83 -5 -63 -79 -31 3 -73 -125
