32 83 68 66 65 66 65 62 61 62 60 59 57 54 53 53 52 52 52 53 53 48 45 45 45 44 41 40 40 38 49 44
95 164 130 128 129 131 129 124 123 124 123 122 123 122 119 119 118 118 119 120 118 114 111 113 115 115 113 111 112 111 116 48
58 103 79 75 76 77 74 71 69 71 69 67 68 66 63 62 61 59 60 62 63 58 54 54 55 54 50 49 50 51 83 31
58 102 76 73 73 74 71 68 68 70 69 68 68 65 61 60 59 58 60 62 63 61 58 57 54 51 47 46 47 48 82 31
58 101 75 71 71 71 69 65 65 68 69 69 69 65 62 61 61 61 60 60 59 56 56 56 56 54 50 48 50 50 82 31
58 99 72 68 67 68 66 64 64 67 70 72 72 70 68 68 68 66 61 62 59 52 52 53 54 54 53 53 54 52 82 30
57 95 68 65 65 67 65 73 67 62 71 75 71 66 61 59 56 48 47 49 42 40 47 49 49 50 50 50 50 49 79 28
53 92 66 63 63 63 66 79 46 23 42 40 32 30 27 29 26 23 20 18 7 21 35 37 42 47 47 46 45 45 76 26
46 83 60 58 59 60 65 74 27 24 51 45 32 29 27 28 25 19 5 11 12 16 38 34 34 44 45 45 43 44 75 24
45 74 58 56 57 56 60 67 33 19 24 17 8 4 0 0 0 0 0 0 4 12 33 34 33 39 42 41 39 41 70 22
42 52 43 45 47 49 51 63 37 16 10 0 0 0 0 0 0 0 0 0 0 3 37 45 28 42 39 33 34 42 69 24
21 5 13 32 33 53 42 44 31 15 11 0 0 0 0 0 0 0 0 0 0 0 32 31 28 33 33 30 39 45 74 28
11 0 0 25 41 64 26 24 31 9 12 0 0 0 0 0 0 0 0 0 0 0 19 23 24 19 16 18 44 39 68 17
15 8 0 0 29 35 8 25 52 8 4 0 0 3 0 0 0 0 0 0 5 0 13 4 12 10 10 18 35 36 56 7
13 23 24 10 12 21 23 13 31 0 0 0 3 7 0 0 0 0 0 2 10 16 1 0 0 0 0 6 33 32 44 8
13 16 9 9 11 12 17 10 12 0 1 0 1 6 0 0 0 0 0 0 16 21 0 0 0 0 0 11 39 26 20 0
20 14 0 0 0 0 7 11 2 1 9 0 0 1 0 0 0 0 0 4 12 0 0 0 0 0 0 37 33 2 12 0
34 29 15 17 19 19 17 16 5 0 5 0 0 0 0 0 0 1 1 3 0 0 0 0 0 6 14 21 16 4 8 0
35 30 14 10 7 8 6 12 5 0 3 0 0 1 0 0 0 7 0 0 0 0 0 0 0 9 3 18 6 5 16 0
29 21 13 13 13 14 10 9 0 0 0 0 0 0 0 0 6 2 0 0 0 0 0 0 0 2 19 20 5 6 12 0
31 21 9 8 8 10 5 1 0 0 0 0 0 0 0 0 3 0 0 0 0 0 10 20 6 25 32 3 2 6 10 0
23 17 6 9 10 10 8 7 0 0 12 8 4 10 0 0 0 0 0 0 0 0 2 0 27 53 19 1 0 3 4 0
29 22 11 12 8 2 0 0 0 6 23 19 21 26 17 9 10 15 7 0 0 0 0 0 45 26 0 1 5 4 3 0
28 19 8 7 2 0 0 0 15 16 24 17 14 24 13 11 18 20 18 2 0 0 0 38 29 3 0 1 7 1 4 0
24 14 7 9 9 5 7 15 14 17 15 8 0 12 11 2 8 11 3 4 0 0 35 26 12 3 6 2 9 3 4 0
24 14 5 5 10 9 8 11 18 16 9 4 0 2 1 0 0 0 0 0 0 48 32 8 1 0 0 6 5 0 1 0
26 18 6 2 2 10 25 35 29 11 8 7 7 5 5 8 1 0 0 0 50 37 5 2 3 0 1 14 4 0 0 0
26 15 3 7 15 21 21 20 20 17 14 10 6 6 3 0 0 0 0 23 35 1 0 7 0 0 0 0 2 4 5 0
18 10 15 21 18 18 16 17 18 18 16 14 12 5 0 0 0 0 24 28 0 0 8 5 0 0 0 0 0 0 0 0
23 22 19 18 17 15 16 15 13 13 13 14 10 2 0 0 0 23 31 1 0 5 9 0 0 1 9 9 0 0 5 0
28 36 43 36 33 29 28 28 27 26 27 28 24 17 5 5 38 39 13 10 18 23 8 0 3 21 15 9 5 2 3 0
8 9 14 9 6 4 5 6 5 3 4 5 0 0 0 31 27 3 0 0 7 5 4 0 0 14 11 5 6 0 6 2
