3 0 0 0 0 0 0 0 0 0 0 0 0 0 0 0 0 0 0 0 0 0 0 0 0 0 0 0 0 0 0 0
0 0 0 0 0 0 0 0 0 0 0 0 0 0 0 0 0 0 0 0 0 0 0 0 0 0 0 0 0 0 0 0
0 0 0 0 0 0 0 0 0 0 0 0 0 0 0 0 0 0 0 0 0 0 0 0 0 0 0 0 0 0 0 0
0 0 0 0 0 0 0 0 0 0 0 0 0 0 0 0 0 0 0 0 0 0 0 0 0 0 0 0 0 0 0 0
0 0 0 0 0 0 0 0 0 0 0 0 0 0 0 0 0 0 0 0 0 0 0 0 0 0 0 0 0 0 0 0
0 0 0 0 0 0 0 0 0 0 0 0 0 0 0 0 0 0 0 0 0 0 0 0 0 0 0 0 0 0 0 0
0 0 0 0 0 0 0 0 0 0 0 0 0 0 0 0 0 0 0 0 0 0 0 0 0 0 0 0 0 0 0 0
0 0 0 0 0 0 0 0 0 0 0 3 2 7 9 9 7 8 11 0 0 5 1 0 0 0 0 0 0 0 0 0
0 0 0 0 0 0 0 0 0 0 37 35 28 30 28 25 23 22 11 0 0 26 0 0 0 0 0 0 0 0 0 0
0 0 0 0 0 0 0 0 0 0 46 27 14 20 17 11 5 0 0 0 0 9 0 0 2 2 0 0 0 0 0 0
0 0 0 0 0 0 0 0 0 0 18 0 0 0 0 0 0 0 1 0 0 12 30 30 10 6 0 0 0 0 0 0
9 0 0 0 0 0 0 0 0 0 9 0 0 2 0 0 0 0 2 0 0 35 44 3 0 14 0 0 1 4 0 0
16 0 6 0 0 0 0 0 0 4 20 4 4 5 0 0 0 0 0 0 0 42 10 0 6 4 0 3 42 35 21 0
19 14 9 0 0 0 0 25 21 25 30 8 9 6 0 0 0 0 0 0 0 8 0 0 0 1 5 30 35 3 0 0
0 0 0 0 0 0 41 47 0 0 11 12 21 11 0 0 0 2 6 0 0 0 0 0 3 0 0 11 0 0 0 0
0 0 0 0 0 0 3 0 0 0 11 24 23 9 0 0 1 5 16 0 0 0 0 0 18 0 0 0 0 0 0 0
0 0 0 0 0 0 0 0 0 0 31 25 14 0 0 0 3 14 6 0 0 0 0 0 16 15 0 0 0 0 0 0
0 0 0 0 0 0 0 0 0 4 37 17 8 0 0 0 14 19 1 0 0 0 0 25 33 44 6 0 0 6 30 0
0 0 1 0 0 1 0 0 0 5 40 17 0 0 0 12 20 17 8 0 0 0 45 39 49 61 0 0 0 22 25 0
0 0 2 2 2 1 0 0 0 0 40 15 0 0 0 28 22 2 0 0 0 53 41 2 64 51 0 0 0 32 13 0
0 0 0 0 0 0 0 0 0 5 36 19 0 0 14 33 13 0 0 12 36 58 0 8 67 0 0 0 7 31 0 0
0 0 0 0 0 0 0 0 0 20 52 31 20 22 18 21 5 1 40 33 40 26 0 22 0 0 0 0 30 14 0 0
0 0 4 9 13 14 11 0 0 45 56 23 38 29 8 22 16 19 37 17 34 34 22 0 0 0 0 0 34 5 0 0
0 0 19 13 6 3 0 0 21 45 20 13 31 1 0 18 18 15 4 3 51 79 0 0 0 0 0 28 28 0 0 0
0 0 4 0 0 0 0 3 10 10 10 29 23 0 3 20 12 4 9 48 100 20 0 0 0 0 0 38 17 0 0 0
0 0 0 0 0 0 0 0 8 35 48 41 32 26 22 30 26 20 46 96 32 0 0 0 0 0 18 29 11 0 0 0
0 0 0 0 0 4 27 43 55 54 41 27 27 22 17 30 26 25 67 23 0 0 0 0 0 0 40 44 9 0 0 0
0 0 0 5 34 58 65 55 40 30 21 18 8 0 0 14 16 36 5 0 0 0 0 0 0 10 54 29 0 0 0 0
0 0 33 59 66 57 38 23 15 11 15 17 6 0 3 16 29 0 0 0 0 0 0 0 0 41 40 0 0 0 0 0
0 21 69 58 36 25 17 12 9 8 11 7 1 13 32 28 0 0 0 0 0 0 0 0 18 63 16 0 0 0 22 0
24 31 38 17 6 8 10 1 0 2 2 0 0 26 31 0 0 0 0 0 0 0 0 0 36 24 0 0 0 1 4 0
21 29 21 16 20 24 20 16 16 20 16 12 26 39 8 0 0 1 25 40 41 36 37 71 72 35 29 46 49 48 28 28
