86 66 18 19 21 20 17 17 16 16 14 14 14 14 13 13 12 12 13 9 7 10 13 7 6 6 6 7 4 4 8 0
106 30 19 21 23 22 21 20 21 20 20 21 23 22 21 22 22 22 19 16 21 30 20 14 20 19 18 18 17 18 0 0
65 26 2 2 2 4 2 0 0 0 0 1 2 2 1 1 2 0 0 0 6 6 0 0 3 0 0 0 0 0 0 0
67 29 4 1 3 6 1 0 0 0 1 0 3 2 1 3 1 1 1 0 0 0 0 3 3 0 2 0 0 0 0 0
67 29 3 0 3 6 0 0 0 0 1 0 3 2 2 2 1 2 2 0 0 0 3 3 0 1 2 0 0 0 0 0
66 28 2 0 4 4 0 0 0 3 0 0 0 0 0 0 0 0 0 0 0 0 0 0 0 2 1 0 0 0 0 0
65 29 1 0 4 0 0 0 4 2 0 0 0 0 0 0 0 0 0 0 1 0 0 0 0 1 0 0 0 0 0 0
67 28 1 1 1 0 0 2 0 0 0 0 0 0 0 0 0 0 0 13 0 0 15 22 2 0 0 0 0 0 0 0
69 17 3 9 0 0 0 7 0 0 0 0 0 0 0 0 0 0 17 31 0 9 71 27 0 0 0 1 0 0 0 0
68 3 32 10 0 0 5 0 0 0 0 0 0 0 0 9 13 22 50 46 16 40 39 0 0 17 20 6 0 0 0 0
41 24 51 10 5 3 7 0 0 0 0 5 0 0 13 27 32 19 38 62 1 0 0 0 6 34 37 16 0 0 0 0
24 25 0 22 35 15 8 0 0 0 0 0 0 4 24 30 32 20 54 47 0 0 0 44 29 27 72 0 0 0 0 0
16 0 0 98 75 25 0 0 0 0 0 0 0 21 26 31 36 29 56 32 0 0 77 31 0 41 35 0 0 0 0 0
4 0 66 146 46 0 0 0 0 0 0 0 0 20 20 34 37 27 44 16 0 32 82 0 0 28 0 0 0 0 0 0
20 40 69 55 0 0 0 0 0 0 1 0 0 18 19 29 24 21 30 24 23 66 21 0 0 18 0 0 58 46 8 0
37 55 29 0 0 0 0 37 0 0 0 0 0 20 20 21 21 17 33 87 56 0 7 0 0 49 27 99 74 16 0 0
55 51 18 10 19 18 36 26 0 0 0 0 7 18 22 18 17 16 64 93 0 14 0 0 0 21 80 120 0 0 0 0
56 29 15 19 16 14 16 0 0 0 0 1 18 34 16 0 7 29 60 35 36 31 0 0 0 0 106 79 0 0 0 0
46 20 10 7 5 5 5 0 0 0 0 14 54 36 0 0 10 27 38 68 70 0 0 0 0 24 137 59 0 0 0 0
36 7 2 4 7 14 16 0 0 0 0 39 58 8 0 0 18 27 37 44 0 0 0 0 0 78 153 3 0 0 0 0
24 18 19 26 28 26 13 0 0 0 0 22 27 0 0 0 32 15 0 0 0 2 84 0 0 158 88 0 0 0 2 0
47 38 24 19 1 0 0 0 0 0 0 4 0 0 0 13 20 0 0 13 0 61 32 0 128 113 0 0 0 24 0 0
46 0 0 0 0 0 1 1 0 0 0 3 0 9 7 6 9 0 24 34 0 21 25 122 119 17 0 0 0 29 0 0
22 0 0 0 3 17 24 0 0 0 17 0 0 43 0 0 13 17 37 0 0 22 148 134 22 0 0 0 8 28 0 0
21 8 18 15 20 26 0 0 0 0 0 0 5 16 0 0 4 5 0 0 0 155 163 27 0 0 0 0 35 16 0 0
28 21 21 19 25 6 0 0 0 0 0 0 0 0 0 0 3 0 0 0 127 186 32 0 0 0 0 0 20 25 0 0
35 29 22 5 0 0 0 0 0 0 0 0 0 3 0 0 13 1 0 109 171 45 0 14 0 0 0 0 32 44 0 0
50 16 0 0 0 0 0 0 0 0 0 0 10 10 0 2 4 0 89 158 49 0 14 21 0 0 0 34 68 29 0 0
44 0 0 0 0 0 1 10 1 0 0 0 14 4 0 0 0 75 147 58 0 12 27 0 0 0 20 75 47 0 0 0
0 0 0 0 0 7 6 2 1 0 0 2 13 0 0 8 92 136 59 0 2 26 15 0 0 0 82 61 0 0 0 0
0 0 8 11 0 0 3 8 2 0 0 6 0 0 32 107 128 43 0 0 12 9 0 0 0 50 52 0 0 0 0 0
0 0 0 0 0 0 0 0 0 0 0 0 0 8 62 55 0 0 0 0 0 0 0 0 0 2 0 0 0 0 0 0
