61 105 95 96 98 98 98 97 97 98 98 98 98 98 99 98 98 97 98 100 100 96 93 96 97 97 97 95 96 95 97 46
1 0 0 0 0 0 0 0 0 0 0 0 0 0 0 0 0 0 0 0 0 0 0 0 0 0 0 0 0 0 0 0
0 0 1 1 2 2 2 1 0 1 1 2 2 1 0 0 0 1 1 0 0 1 0 0 0 0 0 0 1 1 0 0
0 0 1 1 2 1 1 1 2 1 1 0 0 0 0 0 0 0 0 0 0 0 0 0 0 0 0 0 0 0 0 0
0 0 2 2 1 1 1 1 2 2 2 2 2 2 2 3 3 3 2 0 1 2 3 2 1 0 0 0 1 1 0 0
0 0 0 0 0 0 0 0 0 0 0 0 0 0 1 2 1 1 2 2 1 0 0 0 1 2 2 2 3 2 0 0
0 0 0 0 0 0 0 0 0 14 37 46 51 54 54 53 53 50 39 15 7 11 6 1 1 0 1 1 0 0 0 0
0 0 1 0 0 0 0 6 2 18 28 24 18 12 9 6 0 0 2 4 13 13 0 0 0 0 0 0 0 0 0 0
0 1 0 0 0 0 0 0 0 0 0 0 0 0 0 0 0 0 0 0 0 0 0 20 20 7 2 0 0 0 0 0
0 4 0 1 1 0 1 0 0 0 0 0 0 0 0 0 0 0 0 0 0 16 32 34 30 19 5 1 0 0 0 0
16 23 25 8 0 0 0 0 0 0 0 0 0 1 0 0 0 0 0 0 0 0 0 0 0 0 0 12 13 19 14 0
0 0 20 2 0 0 0 0 0 0 0 0 0 0 0 0 0 0 0 0 0 0 0 0 0 0 0 28 37 41 28 14
0 0 0 0 0 18 11 35 11 10 4 0 0 0 0 0 3 11 15 0 0 11 2 0 5 0 0 0 0 0 0 0
0 0 0 0 24 54 10 0 0 0 0 0 3 1 0 0 0 0 1 0 0 0 0 0 0 0 0 0 0 0 0 0
0 0 0 0 0 0 0 0 0 0 0 1 0 0 0 0 0 0 0 0 0 8 5 0 0 0 0 0 0 0 0 0
0 0 0 0 0 0 0 0 0 0 0 0 0 0 0 0 0 3 6 0 11 16 0 0 13 16 29 34 53 57 46 9
8 13 32 50 62 61 45 38 7 1 0 0 0 0 0 0 0 0 0 8 15 0 0 1 0 18 16 24 21 0 0 0
0 0 0 0 0 0 0 0 0 0 0 0 0 0 0 0 0 0 0 0 0 0 0 0 0 0 0 0 0 0 0 0
0 2 14 20 18 11 0 0 0 0 0 0 0 4 7 4 6 7 0 14 12 18 0 0 0 0 0 0 0 0 0 0
0 0 0 0 0 0 0 0 0 0 0 0 6 9 10 4 0 0 0 0 0 0 0 13 24 0 0 0 0 0 0 0
0 0 0 0 14 32 41 25 0 0 0 0 0 0 0 0 0 0 0 0 0 0 0 0 0 0 6 0 0 0 0 0
6 28 40 38 29 9 0 0 0 0 1 0 0 0 0 2 5 0 0 0 10 4 0 0 0 17 0 0 2 2 1 0
0 0 0 0 0 0 0 0 0 8 5 4 5 0 0 0 0 6 23 8 11 0 0 0 22 18 0 0 0 0 0 0
0 0 0 0 0 0 0 0 0 0 0 21 25 21 33 28 16 15 28 26 13 0 0 0 16 0 0 3 0 0 0 0
0 0 0 0 0 0 0 0 13 29 12 0 0 0 2 4 15 18 1 0 0 0 7 19 0 0 0 0 0 6 0 0
0 0 0 0 11 28 48 52 31 0 0 0 0 0 0 0 0 0 0 0 0 0 15 0 0 0 1 4 15 0 0 0
0 0 1 12 12 0 0 0 0 0 0 1 9 6 8 11 5 3 9 5 22 24 0 0 0 0 0 0 0 0 0 0
0 13 13 0 0 0 0 0 7 10 7 8 14 12 11 10 6 6 0 0 18 0 0 0 0 0 0 0 0 0 0 0
4 2 0 0 0 0 4 2 0 0 0 1 0 0 0 0 0 0 0 11 0 0 3 0 0 0 0 8 19 13 1 0
0 0 0 0 5 5 0 0 0 1 1 0 0 0 0 0 0 2 19 5 0 5 6 0 0 0 0 0 0 0 0 0
0 5 20 18 9 5 6 7 7 7 9 10 9 1 0 3 35 53 25 14 21 24 5 0 0 6 30 35 25 16 2 0
15 18 14 12 12 13 14 15 14 15 15 18 29 52 83 89 70 37 30 41 42 33 14 19 19 32 17 0 0 6 19 28
