0 0 0 0 0 0 0 0 0 0 0 0 0 0 0 0 0 0 0 0 0 0 0 0 0 0 0 0 0 0 0 3
0 0 0 0 0 0 0 0 0 0 0 0 0 0 0 0 0 0 0 0 0 0 0 0 0 0 0 0 0 0 28 40
0 0 0 0 0 0 0 0 0 0 0 0 0 0 0 0 0 0 0 0 0 0 0 0 0 0 0 0 0 0 0 0
0 0 0 0 0 0 0 0 0 0 0 0 0 0 0 0 0 0 0 0 0 0 0 0 0 0 0 0 0 0 0 0
0 0 0 0 0 0 0 0 0 0 0 0 0 0 0 0 0 0 0 0 0 0 0 0 0 0 0 0 0 0 0 0
0 0 0 0 0 0 0 0 0 0 0 0 0 0 0 0 0 0 0 0 0 0 0 0 0 0 0 0 0 0 0 0
0 0 0 0 0 0 0 0 0 0 0 0 0 2 2 2 1 10 21 0 0 0 0 0 0 0 0 0 0 0 0 0
0 0 0 0 0 0 0 0 0 31 70 52 46 47 42 36 35 55 47 0 3 33 0 0 0 0 0 0 0 0 0 0
0 0 0 0 0 0 0 0 2 71 49 17 3 0 0 0 0 0 0 0 17 0 0 0 0 0 0 0 0 0 0 0
16 0 0 0 0 0 0 0 29 31 0 0 0 0 0 0 0 0 0 0 0 0 3 36 36 0 0 0 0 0 0 0
65 0 0 0 0 0 0 0 16 14 0 0 6 4 0 0 0 0 0 0 0 19 35 0 0 10 0 0 0 0 0 0
26 4 87 4 0 0 0 0 14 11 0 0 9 0 0 0 0 0 0 0 1 29 0 0 0 9 0 2 6 0 16 19
0 51 69 0 0 0 0 69 55 0 0 0 0 0 0 0 0 0 0 0 8 0 0 0 27 0 0 28 20 1 25 14
0 0 0 0 30 6 56 68 38 0 0 0 0 0 0 0 0 0 0 0 0 0 0 0 3 0 31 9 0 0 0 0
0 0 0 0 43 46 60 0 0 0 0 0 0 0 0 0 0 0 0 0 0 0 15 0 10 0 13 0 0 0 0 0
0 0 0 0 0 0 0 0 0 0 23 1 0 0 0 0 0 0 0 0 0 0 0 40 16 0 0 0 0 0 61 37
0 0 4 0 0 0 0 0 1 21 4 0 0 0 0 0 0 0 0 0 28 0 0 49 0 43 0 0 3 73 68 0
0 0 0 0 0 0 0 0 17 16 0 0 0 0 0 0 0 0 0 20 0 0 63 5 9 31 0 0 11 35 0 0
0 0 0 0 0 0 0 0 0 3 0 0 0 0 0 2 0 0 0 0 0 84 27 0 0 0 0 0 15 7 0 0
4 0 0 0 0 0 0 0 0 10 0 0 0 0 0 0 0 0 0 0 63 61 0 0 17 0 0 0 37 0 0 0
0 0 0 0 0 0 0 0 8 0 0 0 0 17 0 0 0 0 17 20 0 0 0 30 0 0 0 38 29 0 0 0
0 0 0 0 0 2 3 0 0 0 0 0 0 2 0 0 0 0 0 0 0 0 23 0 0 0 21 47 0 0 0 0
0 0 0 0 0 0 0 0 12 28 0 0 0 0 0 0 0 0 0 0 0 27 11 0 0 8 26 26 0 0 0 0
4 0 0 0 0 0 0 0 31 0 0 20 5 0 0 0 0 0 0 0 39 0 0 0 22 9 29 19 0 0 0 0
3 0 0 0 0 0 0 0 0 0 36 21 0 14 23 4 3 0 8 75 0 0 0 20 2 0 40 0 0 0 0 0
0 0 0 0 0 0 9 12 27 59 25 0 0 14 1 0 0 7 42 0 0 0 39 13 0 3 20 0 6 0 0 0
0 0 0 0 9 37 38 34 17 0 0 0 0 0 0 0 0 10 0 0 0 30 19 0 0 38 3 0 0 0 0 0
0 0 4 37 45 25 0 0 0 0 0 0 0 0 0 0 12 16 0 0 28 28 0 0 7 55 0 0 0 0 8 0
0 11 46 23 0 0 0 0 0 0 0 0 0 2 1 23 18 0 0 17 24 0 0 0 33 20 0 0 0 3 16 0
31 24 0 0 0 0 0 0 0 0 0 0 0 8 36 7 0 0 0 26 0 0 0 5 56 0 0 0 0 0 0 0
16 0 0 0 0 0 0 0 0 0 0 0 0 0 0 0 0 6 14 0 0 0 0 42 5 0 0 22 27 0 0 0
0 0 0 0 0 0 0 0 0 0 0 0 0 0 0 0 35 33 5 0 0 0 15 0 0 0 11 0 0 0 0 0
