0 0 0 0 0 0 0 0 0 0 0 0 0 0 0 0 0 0 0 0 0 0 0 0 0 0 0 0 0 0 0 0
1 18 1 1 2 1 0 2 3 0 0 0 0 0 3 2 0 0 1 1 5 1 0 0 4 2 1 2 5 4 5 0
0 14 0 0 1 0 0 0 0 1 0 0 0 0 0 0 1 0 0 0 0 4 0 0 0 0 0 0 0 0 0 0
0 11 0 0 0 0 0 0 0 0 0 0 0 0 0 0 0 1 0 0 0 0 7 3 0 0 0 0 0 0 0 0
0 12 0 0 0 0 0 0 0 0 0 0 0 0 0 0 0 0 0 0 0 0 0 0 0 0 0 0 0 0 0 0
0 13 0 0 0 0 0 0 0 0 0 0 0 0 0 0 0 0 1 2 0 0 0 0 0 0 0 0 0 0 0 0
0 12 0 0 0 0 0 0 0 0 0 0 0 0 0 0 0 0 0 0 0 0 0 0 0 0 0 0 0 0 0 0
0 5 0 1 0 0 0 0 0 31 18 5 7 15 14 7 11 21 22 0 0 0 0 0 0 0 0 0 0 0 0 0
0 13 0 0 0 0 0 0 0 5 39 45 45 50 55 50 40 49 65 54 15 19 14 0 0 0 0 1 0 0 0 0
0 1 0 0 0 0 0 0 0 0 0 0 0 0 0 0 0 0 0 0 38 46 21 17 1 0 0 1 0 0 0 0
35 0 0 0 5 0 0 0 0 0 0 0 1 0 0 0 0 0 11 0 0 21 40 30 78 43 0 0 0 0 0 0
64 78 30 0 0 0 0 0 0 0 0 2 14 12 12 3 0 0 0 16 0 0 2 13 8 62 21 15 0 9 0 0
0 63 107 39 0 0 5 46 0 0 0 0 0 0 3 5 10 3 0 0 0 0 0 12 0 12 21 32 30 20 12 5
0 1 40 119 38 0 0 37 53 0 0 8 3 0 0 0 0 19 22 0 0 18 0 0 21 11 17 4 42 31 3 23
0 0 0 40 91 68 11 0 77 47 0 0 0 14 4 3 0 0 17 16 0 10 18 0 0 0 0 0 0 10 2 0
0 0 0 0 0 25 48 0 0 53 28 0 0 0 4 4 24 0 0 6 2 0 12 28 0 0 10 0 0 0 0 0
0 6 0 0 0 0 0 0 0 0 14 14 0 2 0 0 11 26 21 0 0 0 0 26 35 0 12 1 0 0 0 1
0 11 0 0 6 12 13 5 0 0 2 5 0 0 21 0 0 0 11 3 5 6 0 1 16 37 19 29 2 10 0 2
0 12 15 9 0 0 0 0 0 0 0 18 3 0 0 14 0 0 0 37 0 0 0 0 14 14 17 27 0 0 0 0
7 1 0 0 6 3 5 13 0 8 0 4 21 0 0 0 0 11 0 0 37 41 10 0 0 0 0 14 20 11 0 0
0 21 14 1 3 5 0 0 0 0 13 0 23 19 0 0 0 0 7 0 0 45 6 11 0 0 0 0 0 0 12 0
0 0 0 0 0 0 0 11 0 0 1 3 11 29 21 6 0 0 0 19 5 0 2 0 0 0 3 9 10 0 0 0
0 10 0 1 9 11 2 16 14 0 0 0 0 0 18 11 22 26 0 0 39 16 35 0 0 0 0 2 4 19 0 0
0 18 17 11 0 0 2 0 0 0 20 4 0 0 0 0 0 0 32 0 0 0 13 39 0 0 0 2 0 0 0 0
0 0 0 6 0 0 0 0 18 5 0 0 30 32 0 11 18 0 0 10 0 0 0 0 0 0 4 0 7 0 0 0
0 10 0 0 0 10 19 1 0 0 0 0 0 18 22 0 27 19 0 0 0 8 2 0 0 0 19 20 0 0 1 0
0 2 0 2 2 0 4 15 26 20 6 0 0 0 0 0 0 0 0 0 0 0 0 0 0 1 0 21 62 12 0 0
0 5 8 0 1 1 8 12 0 0 0 1 0 0 0 0 0 0 0 0 0 0 0 0 0 18 0 0 0 44 0 0
0 0 0 1 5 4 0 0 0 0 0 0 1 4 0 0 0 0 0 0 0 0 0 0 5 8 37 15 0 0 0 0
8 0 4 6 0 0 0 0 0 0 0 0 0 2 0 0 0 0 0 3 0 0 0 0 3 0 9 5 0 5 3 0
0 4 0 0 0 0 0 0 0 0 0 0 0 0 0 0 0 0 0 0 0 0 0 2 5 0 0 28 0 0 0 6
13 1 2 0 0 0 0 3 0 0 0 0 0 15 10 0 0 13 2 0 0 0 0 0 12 15 0 0 55 33 9 0
