0 0 0 0 0 0 0 0 0 0 0 0 0 0 0 0 0 0 0 0 0 0 0 0 0 0 0 0 0 0 0 0
0 0 0 0 0 0 0 0 0 0 0 0 0 0 0 0 0 0 0 0 0 0 0 0 0 0 0 0 0 0 0 0
0 0 0 0 0 0 0 0 0 0 0 0 0 0 0 0 0 0 0 0 0 0 0 0 0 0 0 0 0 0 0 0
0 0 0 0 0 0 0 0 0 0 0 0 0 0 0 0 0 0 0 0 0 0 0 0 0 0 0 0 0 0 0 0
0 0 0 0 0 0 0 0 0 0 0 0 0 0 0 0 0 0 0 0 0 0 0 0 0 0 0 0 0 0 0 0
0 0 0 0 0 0 0 0 0 0 0 0 0 0 0 0 0 0 0 0 0 0 0 0 0 0 0 0 0 0 0 0
0 0 0 0 0 0 0 0 0 0 0 0 0 0 0 0 0 0 0 0 0 0 0 0 0 0 0 0 0 0 0 0
0 0 0 0 0 0 0 0 0 0 0 0 0 0 0 0 0 0 0 0 0 0 0 0 0 0 0 0 0 0 0 0
0 0 0 0 0 0 0 0 23 33 50 62 61 61 56 49 51 35 8 3 0 0 0 0 0 0 0 0 0 0 0 0
0 0 0 0 0 0 0 0 17 7 10 27 24 24 24 20 17 7 0 27 15 0 0 0 0 0 0 0 0 0 0 0
0 0 0 0 1 0 0 0 11 0 0 0 0 0 0 0 0 0 0 0 17 16 20 21 0 0 0 0 0 0 0 0
2 0 0 0 0 0 0 0 0 0 0 14 2 0 0 0 0 0 0 11 16 6 40 36 19 0 0 0 0 0 0 0
62 51 0 0 0 0 0 0 0 0 0 0 0 0 0 0 0 0 0 0 0 0 14 30 1 0 0 0 0 0 0 0
58 63 9 0 0 0 0 0 0 0 0 0 0 0 0 0 0 0 0 0 0 0 0 28 15 23 52 45 65 39 30 30
0 24 52 75 43 16 24 30 59 0 0 0 0 0 0 0 0 0 0 0 1 0 0 0 0 12 25 39 60 46 0 15
0 0 10 46 65 56 34 0 52 10 0 0 0 2 2 0 0 0 0 0 0 0 0 0 0 0 0 0 0 0 0 0
0 0 0 0 0 0 0 0 0 0 3 0 0 1 0 1 0 0 0 0 0 0 0 0 0 0 0 0 0 0 0 0
0 0 0 0 0 0 0 0 0 0 0 0 0 16 2 0 0 2 0 0 0 0 0 4 0 0 0 0 0 0 0 0
0 0 0 0 0 0 0 0 10 0 0 0 0 0 1 0 0 0 0 0 0 0 0 32 6 0 0 0 0 0 0 3
0 0 0 9 9 10 10 2 23 0 0 0 0 0 0 0 0 0 0 0 1 0 0 0 0 0 11 7 0 0 0 0
22 0 4 0 0 0 0 0 0 0 0 0 0 0 0 0 0 0 0 3 27 0 6 9 0 0 0 0 0 0 0 0
0 0 0 0 0 0 0 0 0 0 7 14 8 9 0 0 0 0 0 0 0 0 0 0 0 1 0 0 0 0 0 1
0 0 0 0 2 0 0 0 0 0 4 20 13 34 29 17 16 0 0 13 5 0 0 0 0 0 0 0 0 0 0 0
24 0 10 0 0 0 0 0 14 9 6 0 0 0 0 0 0 13 0 0 0 0 0 0 0 0 0 0 0 0 0 3
4 0 4 0 0 0 0 0 0 0 0 25 8 0 0 0 0 0 9 18 0 0 0 0 0 0 0 0 0 0 0 1
0 0 0 0 0 0 0 0 0 0 12 34 54 70 50 47 50 48 38 14 0 0 0 0 0 0 0 0 0 0 0 0
0 0 0 0 0 0 11 32 39 25 9 0 4 35 41 31 39 28 0 0 0 0 0 0 0 0 2 27 0 0 0 0
0 0 0 0 9 30 37 26 13 11 10 0 0 0 0 17 17 0 0 0 0 0 0 0 0 0 0 0 29 19 0 2
0 0 8 29 32 21 14 14 12 10 16 17 2 0 0 0 0 0 0 0 0 0 0 0 0 0 0 0 0 0 0 0
20 11 31 25 16 9 6 10 8 4 6 17 29 33 16 0 0 0 0 0 0 0 0 0 0 0 0 0 0 0 0 6
27 10 6 6 7 4 0 0 0 0 0 0 0 0 0 0 0 0 0 0 0 0 0 0 0 0 0 0 0 0 0 0
12 10 8 5 6 8 5 0 0 1 0 0 0 0 0 0 0 0 0 0 0 0 0 2 0 0 0 28 17 0 0 0
