0 0 0 0 0 0 0 0 0 0 0 0 0 0 0 0 0 0 0 0 0 0 0 0 0 0 0 0 0 0 5 0
0 1 0 0 0 0 0 0 0 0 0 0 0 0 0 0 0 0 0 0 7 0 0 2 0 0 0 0 0 0 51 0
0 0 0 0 0 0 0 0 0 0 0 0 0 0 0 0 0 0 0 0 0 0 0 0 0 0 0 0 0 0 40 0
0 0 0 0 0 0 0 0 0 0 0 0 0 0 0 0 0 0 0 0 0 0 0 0 0 0 0 0 0 0 41 0
0 0 0 0 0 0 0 0 0 0 0 0 0 0 0 0 0 0 0 0 0 0 0 0 0 0 0 0 0 0 43 0
0 0 0 0 0 0 0 0 0 0 0 0 0 0 0 0 0 0 0 0 0 0 0 0 0 0 0 0 0 0 42 0
0 0 0 0 0 0 0 0 0 0 4 6 9 7 10 9 6 5 18 0 0 0 0 0 0 0 0 0 0 0 41 0
0 0 0 0 0 0 0 8 0 22 34 24 26 22 20 21 9 5 43 0 0 25 0 0 0 0 0 0 0 0 41 0
0 6 0 0 0 0 0 16 0 1 0 0 0 0 0 0 0 0 16 0 0 34 0 0 1 0 0 0 0 0 41 0
0 24 0 0 0 0 0 6 0 2 0 0 0 0 0 0 0 0 7 0 0 42 0 0 25 1 0 0 0 0 33 0
0 30 0 0 0 0 0 0 0 44 43 0 0 0 0 1 0 0 48 0 0 37 0 0 2 16 0 0 0 0 26 0
0 0 43 0 0 0 0 10 0 47 51 0 0 0 0 6 0 0 49 0 0 31 0 0 0 30 0 16 0 29 21 0
0 0 47 0 0 0 0 65 0 56 51 0 15 0 0 7 0 0 45 0 0 78 0 0 0 70 0 36 0 25 0 0
0 0 44 0 0 39 0 108 0 43 31 0 25 0 0 12 0 0 43 0 0 105 0 0 13 58 0 5 0 0 0 0
0 0 23 0 0 0 0 53 0 12 7 0 21 0 0 7 0 0 42 0 0 74 0 0 41 10 0 0 0 0 0 0
0 0 0 0 0 0 0 0 0 8 0 0 11 1 0 0 0 0 56 0 0 43 0 0 60 0 0 0 0 0 26 0
0 0 0 0 0 0 0 0 0 52 0 0 0 0 0 0 1 0 61 0 0 14 0 0 42 0 67 0 0 0 54 0
0 0 0 0 0 0 2 0 0 58 7 0 0 0 0 0 0 0 46 0 0 0 0 0 0 10 53 0 0 0 42 0
0 0 0 0 0 0 6 0 0 58 0 15 0 0 0 0 0 0 29 0 0 0 0 0 0 38 4 0 0 20 22 0
0 0 0 0 0 0 0 0 0 61 0 19 8 0 0 21 0 0 21 15 0 0 0 0 23 62 0 0 0 33 6 0
0 0 0 0 0 0 0 3 0 65 4 4 22 0 0 23 0 0 6 0 0 37 0 0 45 33 0 0 0 15 0 0
0 0 0 0 0 0 0 4 0 53 20 0 21 0 0 22 0 0 10 0 0 59 0 0 14 0 0 0 36 0 10 0
0 0 0 0 0 0 0 0 0 43 24 0 26 0 0 8 0 0 27 0 0 44 0 0 0 0 0 0 35 0 14 0
0 0 0 0 0 0 0 0 0 24 10 0 56 0 0 21 0 0 24 0 33 25 0 0 0 0 0 19 8 0 2 0
0 0 0 0 0 0 0 0 0 25 9 0 57 0 0 29 5 0 19 0 36 24 0 0 0 0 0 31 0 0 0 0
0 0 0 0 0 0 0 10 0 19 0 0 25 0 0 0 0 0 0 0 31 0 0 0 0 0 12 19 4 0 5 0
0 0 0 0 1 0 0 0 0 0 0 0 7 0 0 0 0 0 0 0 0 0 0 0 0 0 24 0 22 0 20 0
0 0 0 0 0 0 0 0 0 0 0 0 17 0 0 5 0 0 14 0 0 0 0 0 0 0 19 0 0 0 15 0
0 0 0 0 0 0 0 0 0 0 1 0 16 0 0 17 0 0 0 0 0 0 0 0 0 12 22 0 0 0 27 0
0 0 0 0 0 0 0 0 0 0 0 0 5 0 0 11 0 0 0 0 0 0 0 0 0 12 9 0 0 0 34 0
0 0 0 0 0 5 0 0 0 0 1 0 0 0 0 0 0 0 0 0 0 0 0 0 29 0 0 15 0 0 27 0
0 0 2 1 2 13 12 4 4 6 12 2 1 12 1 0 0 0 0 7 0 0 0 0 48 0 0 21 0 0 12 0
