0 0 0 0 0 0 0 0 0 0 1 1 2 2 1 3 3 4 4 4 3 5 5 6 6 7 6 7 8 9 40 60
0 0 0 0 0 0 0 0 0 0 0 0 0 0 0 0 0 0 0 0 0 0 0 0 0 0 0 0 0 0 56 112
0 0 0 0 0 0 0 0 0 0 0 0 0 0 0 0 0 0 0 0 0 0 0 0 0 0 0 0 1 2 64 103
0 0 0 0 0 0 0 0 0 0 0 0 0 0 0 0 0 0 0 0 0 0 0 0 0 0 0 1 4 3 64 102
0 0 0 0 0 0 0 0 0 0 0 0 0 0 0 0 0 0 0 0 0 0 0 0 0 0 0 1 4 3 64 102
0 0 0 0 0 0 0 0 0 0 0 0 0 0 0 0 0 0 0 0 0 0 0 0 0 0 0 0 2 4 65 103
0 0 0 0 0 0 0 1 0 0 0 0 0 0 0 0 0 0 0 0 0 0 1 4 0 0 0 0 1 3 66 103
0 0 0 0 0 0 0 5 0 0 0 0 0 0 0 0 0 0 0 0 0 0 0 0 0 2 1 1 1 2 66 104
0 0 0 0 0 0 0 11 43 46 15 0 0 0 0 0 0 0 0 0 0 0 0 0 0 2 5 2 1 1 65 104
0 0 0 0 0 0 0 26 101 82 39 0 0 0 0 0 0 0 0 0 0 0 0 0 0 0 0 0 0 0 63 106
0 0 0 0 0 0 0 34 122 87 54 8 0 0 0 0 0 0 0 0 0 0 0 0 0 0 0 0 0 0 61 111
0 0 0 0 0 0 0 22 127 93 60 22 0 0 0 0 0 0 0 0 7 13 0 0 0 0 0 0 0 0 55 108
0 0 0 0 0 0 0 28 119 102 64 35 5 0 0 0 0 0 0 0 31 16 0 0 0 0 0 0 0 0 43 72
1 0 0 0 0 0 30 50 68 62 47 33 6 0 0 0 0 0 0 0 33 0 0 11 0 0 0 0 0 0 6 21
17 0 0 0 0 0 34 20 26 0 13 25 11 0 0 0 0 0 0 0 0 0 0 33 20 0 0 0 0 0 6 39
10 0 0 0 0 0 0 0 25 6 18 20 7 0 0 0 0 0 0 0 0 0 15 39 12 0 0 0 0 1 60 94
0 0 0 5 3 0 0 20 59 50 35 6 1 0 0 0 0 0 0 0 0 6 19 47 0 0 0 0 0 47 89 95
0 0 0 0 0 0 0 24 79 63 28 0 0 0 0 0 0 0 0 0 0 0 62 46 0 0 0 0 3 62 76 75
0 0 0 0 0 0 0 29 74 53 22 0 0 0 6 4 0 0 0 0 0 24 81 50 0 0 0 0 4 43 63 70
0 0 0 0 0 0 0 21 69 50 20 0 0 0 21 14 0 0 0 0 0 23 17 14 7 0 0 0 34 33 53 62
0 0 0 0 0 0 0 28 82 52 22 0 0 0 14 2 0 0 0 0 0 0 0 14 5 0 0 0 51 22 41 56
0 0 0 0 0 0 0 21 69 51 34 0 0 0 0 0 0 0 3 0 0 0 0 0 0 0 0 44 37 11 41 60
0 0 0 0 1 0 0 8 59 56 29 0 0 0 0 0 0 0 0 0 0 0 0 0 0 0 23 57 19 5 38 61
0 0 0 0 0 0 0 19 66 38 19 9 0 0 0 0 0 0 0 0 0 0 0 0 0 17 53 49 9 0 38 60
0 0 0 0 0 0 2 38 52 28 37 25 0 0 0 0 0 0 0 0 0 0 0 0 0 31 58 17 0 0 43 63
0 0 0 0 0 0 12 29 41 50 44 13 0 0 0 0 0 0 0 0 0 0 0 0 10 51 51 0 0 0 42 65
0 0 0 0 0 8 14 20 32 18 4 0 0 1 0 0 0 0 0 0 0 0 0 0 17 63 43 11 0 0 30 64
0 0 0 13 26 25 12 0 0 0 0 0 0 0 0 0 0 0 0 0 0 0 0 0 37 65 23 0 0 0 31 63
0 0 25 26 13 0 0 0 0 0 1 0 0 0 0 0 0 0 0 0 0 0 0 10 64 48 0 0 0 4 52 62
0 0 15 0 0 0 0 0 0 0 0 0 0 0 0 0 0 0 0 0 0 0 0 27 71 25 0 0 0 25 59 55
0 0 0 0 0 0 0 0 0 0 0 0 0 0 0 0 0 0 0 0 0 0 5 46 26 0 0 0 0 10 45 61
0 0 0 0 0 0 0 0 0 0 0 0 2 0 0 0 0 0 0 0 0 2 30 41 0 0 0 1 0 0 17 43
