0 53 0 0 0 0 0 0 0 0 0 0 0 0 0 0 0 0 0 1 0 0 6 0 0 0 0 1 0 0 2 57
18 8 0 0 0 0 0 0 0 0 0 0 0 0 0 0 0 0 0 0 0 0 0 0 0 0 0 0 0 0 0 0
18 21 4 1 0 2 3 2 1 1 0 0 0 3 0 1 0 1 0 1 0 7 2 0 3 0 0 5 0 0 17 9
17 22 4 1 0 2 4 0 0 0 0 0 0 3 0 1 1 0 0 3 0 1 0 0 4 0 0 5 0 0 15 10
16 25 4 1 0 3 5 0 0 0 0 0 0 3 0 1 0 0 2 2 0 0 0 1 1 0 2 1 0 1 16 11
17 25 4 0 0 4 3 0 0 2 1 0 0 2 0 0 0 1 1 0 0 0 0 0 0 0 1 0 0 1 16 11
17 25 5 0 1 2 3 0 0 8 0 0 0 0 0 0 0 10 0 0 14 0 0 1 0 0 0 0 0 1 15 11
18 26 1 0 1 1 1 0 52 12 0 0 0 0 0 0 0 1 0 19 32 0 0 19 0 0 0 0 0 1 15 10
29 11 0 4 0 0 0 0 120 0 0 0 0 0 0 0 5 0 0 53 7 0 21 40 0 0 0 0 0 0 14 11
35 0 16 7 0 0 0 9 124 0 0 9 0 0 0 0 11 0 0 37 9 0 40 19 0 0 9 5 1 0 14 12
0 0 40 0 3 0 0 14 114 0 0 25 1 0 0 0 14 7 0 43 60 0 8 0 0 0 24 14 0 0 23 4
0 29 0 0 19 0 2 17 103 0 0 38 0 0 0 0 14 1 0 67 70 0 0 23 16 0 82 2 0 0 38 0
0 72 0 8 54 0 66 0 84 0 0 42 0 0 4 0 16 0 0 67 53 0 13 73 0 0 146 0 9 0 44 0
0 45 0 37 61 2 103 0 97 0 0 44 0 5 0 0 22 0 0 47 15 0 87 68 0 0 139 0 14 0 55 1
0 22 0 32 28 7 47 0 123 0 16 23 0 1 0 0 13 8 0 11 19 0 62 65 0 0 71 0 34 0 68 5
0 24 0 0 0 0 0 0 116 0 10 0 0 0 2 0 0 23 0 11 71 0 44 50 0 33 0 0 53 19 24 0
0 35 4 0 0 0 0 13 88 0 0 0 0 0 4 3 0 17 0 66 17 0 97 0 0 32 0 70 59 13 0 0
10 23 0 0 0 0 0 12 71 0 0 0 0 13 12 1 0 10 0 35 0 79 29 0 10 0 0 104 58 0 0 18
15 12 0 3 1 0 0 8 77 0 1 0 0 49 8 0 0 6 0 0 68 49 0 14 6 0 0 122 43 0 2 12
23 9 0 0 0 0 0 8 92 0 0 0 0 57 0 0 0 8 0 12 84 0 0 95 0 0 68 124 0 0 32 1
11 3 0 3 0 6 6 5 78 0 4 0 0 42 0 0 8 35 0 3 37 0 88 31 0 0 109 83 0 0 46 0
8 20 0 10 3 0 0 0 72 0 0 10 0 15 0 0 16 33 0 21 18 0 90 0 0 62 77 20 0 7 31 0
29 8 0 2 0 0 0 18 70 0 0 47 0 5 12 0 13 7 0 78 0 0 0 0 58 34 50 0 0 29 13 0
34 0 0 0 1 0 16 32 10 0 26 34 0 36 18 0 9 0 0 97 0 0 0 79 29 21 36 0 0 16 20 0
26 0 7 0 3 0 20 1 0 0 23 0 0 52 0 0 3 9 15 42 0 0 98 56 0 55 0 0 22 0 30 0
17 0 10 0 10 12 12 2 14 0 0 0 0 24 0 0 0 28 0 0 0 91 78 0 1 74 0 0 1 2 28 0
12 0 14 11 18 7 0 0 0 0 1 0 0 17 0 0 1 25 0 0 37 86 0 0 65 31 0 0 0 43 16 0
16 21 21 9 0 0 0 0 1 0 2 0 0 25 0 0 14 0 0 41 66 0 0 6 88 0 0 0 0 57 0 0
45 21 0 0 0 0 0 5 3 1 0 0 0 22 0 0 0 0 13 79 0 0 0 45 56 0 0 17 36 24 0 0
53 0 0 0 0 0 0 0 2 2 0 0 3 18 0 0 0 21 58 8 0 0 4 75 0 0 2 28 34 0 0 2
22 0 0 10 5 0 0 0 2 0 0 0 8 0 0 0 24 39 5 0 0 4 31 43 0 0 42 2 15 0 0 14
2 0 3 0 0 0 0 0 0 0 0 0 0 0 0 9 23 0 0 0 5 6 26 0 0 48 21 0 4 0 12 0
