25 81 59 60 61 62 63 65 65 66 67 68 68 69 70 71 71 72 73 72 73 73 78 76 72 74 74 75 75 74 74 135
3 0 0 0 0 0 0 0 0 0 0 0 0 0 0 0 0 0 0 0 0 0 0 0 0 0 0 0 0 0 0 3
1 12 9 10 10 10 11 10 8 8 8 9 9 8 8 7 5 4 6 6 7 2 0 2 7 7 7 6 5 2 16 55
2 13 8 10 10 10 10 9 8 7 7 8 7 7 7 6 5 3 5 6 6 0 0 1 4 3 3 2 1 0 14 54
2 13 9 9 9 9 8 7 6 7 7 8 7 7 5 5 3 5 6 8 9 8 7 4 0 0 0 0 0 0 14 54
3 14 9 10 10 9 7 6 6 11 14 14 14 13 13 11 12 15 13 9 9 8 5 3 2 1 0 0 0 0 16 55
4 15 12 11 12 10 7 7 5 7 0 0 0 0 0 0 0 0 0 0 8 6 0 1 4 3 2 3 3 2 18 58
6 19 10 10 11 9 8 10 2 0 0 0 0 0 0 0 0 0 0 0 0 0 0 5 8 3 2 3 3 3 18 57
5 13 0 12 10 11 11 21 3 0 0 0 0 0 0 0 0 0 0 0 0 0 0 0 0 0 0 3 3 3 17 58
0 0 0 13 10 11 12 24 0 0 0 0 0 0 0 0 0 0 0 0 0 0 0 0 0 0 0 6 5 4 19 59
0 0 3 0 10 11 14 24 0 0 0 0 0 0 0 0 0 0 0 0 0 0 0 0 0 0 0 0 0 0 5 44
0 0 0 0 8 14 16 24 0 0 0 0 0 0 0 0 0 0 0 0 0 0 0 0 0 0 0 0 0 0 0 0
0 0 0 0 0 12 1 0 0 0 0 0 0 0 0 0 0 0 4 0 0 0 0 24 0 0 0 0 0 0 0 0
0 0 0 0 0 0 0 0 0 0 0 0 0 0 0 0 0 0 0 0 0 5 36 4 0 0 0 0 0 0 0 0
18 24 19 0 0 0 0 0 0 0 0 0 0 0 0 0 0 0 0 0 0 44 21 0 19 17 0 1 43 62 61 75
29 63 56 10 0 0 0 2 3 0 0 0 0 0 0 0 0 0 0 5 27 13 0 0 0 31 33 84 107 67 27 30
16 40 30 27 34 35 34 42 0 0 0 0 0 0 0 0 0 0 0 4 0 0 0 0 0 0 0 13 0 0 0 0
0 0 0 0 0 0 0 0 0 0 0 0 0 0 0 0 0 0 0 0 0 5 0 0 0 0 0 0 0 0 0 5
0 0 0 0 0 0 0 0 0 0 0 0 0 9 0 0 0 0 0 0 0 0 0 0 0 0 0 0 0 0 0 9
0 0 0 0 0 0 0 0 0 0 0 0 0 0 0 0 0 0 0 0 0 0 0 0 0 0 37 1 0 0 0 11
0 0 0 4 9 7 1 1 0 0 0 0 0 0 0 0 0 0 0 0 0 0 0 0 0 43 67 0 0 0 0 15
1 18 0 0 0 0 0 0 0 0 0 0 0 0 0 0 0 0 0 0 0 2 0 0 54 101 5 0 0 0 0 21
0 0 0 0 0 0 0 0 0 0 0 0 0 0 0 0 0 0 0 0 0 0 0 27 111 26 0 0 0 0 0 23
0 0 0 0 0 0 0 0 0 0 0 0 0 0 0 0 0 0 0 0 0 0 0 90 11 0 0 0 0 0 0 21
0 0 0 0 0 0 0 0 0 0 0 0 0 0 0 0 0 0 0 0 0 0 118 24 0 0 0 0 0 0 0 20
0 0 0 0 0 0 0 0 0 0 0 0 0 0 0 0 0 0 0 0 0 124 38 0 0 0 0 0 0 0 0 13
0 0 0 0 0 0 0 0 0 0 0 0 0 0 0 0 0 0 0 1 144 64 0 0 0 0 0 0 0 0 0 8
0 0 0 0 0 0 0 0 0 0 0 0 0 3 7 6 2 0 4 124 76 0 0 0 0 0 0 0 14 0 0 4
0 0 0 0 0 0 0 0 0 0 0 0 0 0 0 0 0 3 120 81 0 0 0 0 0 0 0 0 15 0 0 0
0 0 0 0 0 0 0 0 0 0 0 0 0 0 0 0 32 141 95 0 0 0 0 0 0 0 0 0 0 0 0 0
0 0 0 0 0 0 0 0 0 0 0 1 11 4 15 74 137 78 0 0 0 0 0 0 0 0 5 0 0 0 0 17
0 0 0 0 0 0 0 0 0 0 0 0 0 0 49 73 15 0 0 0 0 0 0 0 0 0 0 0 0 0 0 0
