0 0 0 0 0 0 0 0 0 0 0 0 0 0 0 0 0 0 0 0 0 0 0 0 0 0 0 0 0 0 0 0
0 0 0 0 0 0 0 0 0 0 0 0 0 0 0 0 0 0 0 0 0 0 0 0 0 0 0 0 0 0 0 31
0 0 0 0 0 0 0 0 0 0 0 0 0 0 0 0 0 0 0 0 0 0 0 0 0 0 0 0 0 0 0 0
0 0 0 0 0 0 0 0 0 0 0 0 0 0 0 0 0 0 0 0 0 0 1 0 0 0 0 0 0 0 0 0
0 0 0 0 0 0 0 0 0 0 0 0 0 0 0 0 0 0 0 0 0 0 0 0 0 0 0 0 0 0 0 0
0 0 0 0 0 0 0 0 2 8 11 14 17 16 16 16 18 16 7 0 0 0 0 0 0 0 0 0 0 0 0 0
0 0 0 0 0 0 0 4 14 0 0 0 0 0 0 0 0 0 0 0 0 0 0 0 0 0 0 0 0 0 0 0
0 0 0 0 0 0 0 6 0 0 0 0 0 0 0 0 0 0 0 0 0 0 0 0 0 0 0 0 0 0 0 0
0 0 0 0 0 0 0 0 0 0 44 76 81 82 81 82 80 81 66 12 16 43 7 0 0 0 0 0 0 0 0 0
0 0 2 0 0 0 0 0 0 33 39 46 43 38 36 36 29 17 10 14 17 0 0 0 0 0 0 0 0 0 4 0
0 0 0 0 0 0 0 0 0 11 0 0 0 0 0 0 0 0 3 0 0 0 0 36 31 0 0 0 0 0 0 0
16 0 0 0 0 2 10 1 0 7 0 0 4 13 9 5 2 12 19 0 0 29 64 53 0 12 0 0 0 0 0 0
10 0 67 54 0 6 0 0 0 0 0 0 7 5 0 0 0 0 0 0 0 30 18 0 0 0 0 0 0 0 0 0
35 39 62 0 0 0 0 0 0 18 5 0 0 0 0 0 0 0 0 0 4 49 0 0 11 0 0 35 51 77 77 54
15 2 0 0 0 15 46 92 59 55 0 0 1 2 0 0 0 0 2 23 38 7 0 0 0 27 49 104 104 96 46 0
0 0 13 42 79 94 109 71 5 0 0 0 5 0 0 0 0 0 13 15 0 0 0 0 3 0 1 3 0 0 0 0
0 0 0 0 0 0 0 0 0 0 0 14 0 0 3 0 0 0 9 0 0 19 0 0 0 0 0 0 0 0 0 14
0 0 0 0 2 0 0 0 0 9 0 0 13 15 3 0 0 0 0 3 53 0 0 0 0 14 32 0 0 17 27 0
4 0 0 0 0 0 0 0 0 12 0 19 15 0 0 0 0 0 2 0 0 0 24 36 20 38 14 0 0 2 0 0
0 0 0 10 32 47 51 38 1 10 0 0 0 0 0 0 0 0 0 0 0 43 37 0 0 44 0 0 0 15 0 0
31 41 52 35 14 0 0 0 0 2 0 0 0 0 0 9 0 0 0 1 37 67 0 0 86 25 0 0 11 30 6 0
5 0 0 0 0 0 0 9 0 0 0 0 0 0 10 0 0 0 20 11 0 0 0 54 35 0 0 0 13 0 0 0
0 0 0 0 13 28 26 0 0 0 15 0 17 35 26 17 13 16 20 0 0 0 14 15 0 0 0 0 15 0 0 0
8 10 22 19 13 5 0 0 16 72 4 0 0 0 0 0 0 0 0 0 0 42 43 0 0 0 0 0 1 0 2 1
11 0 4 7 10 3 0 23 18 0 0 0 0 0 0 0 0 0 0 0 68 49 0 0 0 0 0 28 2 0 0 0
7 0 0 0 0 0 0 0 0 0 24 21 6 20 47 34 27 26 36 84 78 0 0 0 1 0 0 0 0 0 0 0
8 0 0 0 0 0 0 19 70 74 29 7 17 16 13 11 9 9 45 38 0 0 0 10 0 0 2 13 36 3 0 0
0 0 0 0 0 34 66 58 24 0 0 0 0 0 0 0 0 5 25 0 0 0 4 0 0 0 26 31 26 1 0 0
0 0 0 33 62 49 18 0 0 2 0 0 0 0 0 0 14 41 0 0 0 7 0 0 0 19 30 0 0 0 0 0
0 17 63 48 14 0 0 0 0 0 0 0 0 0 0 37 41 0 0 0 0 0 0 0 0 41 18 0 0 0 2 4
36 53 21 0 0 0 3 0 0 0 0 0 0 33 79 47 0 0 0 0 0 0 0 0 25 6 0 0 0 0 1 0
5 0 0 0 0 0 0 0 0 0 0 0 0 0 0 0 0 0 0 0 0 0 0 16 16 0 0 12 36 24 0 0
