0 85 0 0 0 0 0 0 0 0 0 0 0 0 0 0 0 0 0 0 0 0 0 0 0 0 0 0 0 0 0 44
0 149 21 27 24 24 27 27 26 26 27 27 26 27 29 27 29 32 31 30 29 23 33 34 27 30 33 32 32 29 20 14
0 117 2 10 6 5 9 10 9 7 9 10 6 7 11 8 9 10 13 9 10 0 5 14 5 8 9 8 10 6 13 13
0 118 3 9 7 3 9 11 10 9 9 11 7 7 10 8 9 10 12 11 11 5 5 8 4 4 5 5 9 5 12 12
0 120 5 10 7 5 9 12 9 9 9 10 8 8 11 10 10 11 12 12 10 5 6 5 4 3 4 4 8 5 13 11
0 121 7 12 9 7 11 14 11 13 15 13 10 11 13 10 12 11 10 7 9 6 5 4 4 4 4 5 7 7 13 12
0 122 7 13 11 8 12 12 7 0 0 0 0 0 0 0 0 0 0 0 0 0 0 6 7 3 4 6 6 7 14 12
0 124 5 12 12 10 12 0 0 0 0 0 0 0 0 0 0 0 0 0 0 0 0 15 15 0 3 5 5 5 15 13
0 119 0 17 13 10 7 1 0 23 0 0 0 0 0 0 0 0 0 0 6 0 0 0 0 0 2 4 4 3 14 14
0 104 0 22 11 8 4 1 0 63 0 0 0 0 0 0 0 0 0 0 0 0 0 0 0 0 0 12 2 2 10 13
0 51 0 0 11 8 4 6 0 86 0 0 6 0 0 0 0 1 0 0 11 0 0 0 0 0 0 12 0 0 0 1
0 0 0 0 21 21 0 4 0 69 0 0 15 0 0 0 0 3 8 0 16 24 0 0 8 0 0 0 0 0 0 0
0 0 0 0 12 1 0 0 0 56 0 0 20 0 0 0 0 0 4 0 23 38 0 4 14 0 0 6 0 0 0 12
0 4 17 0 0 0 0 0 0 69 0 0 20 0 4 0 0 0 0 0 27 45 0 26 25 0 0 47 0 0 0 38
0 33 36 0 0 0 0 60 0 53 0 0 17 0 1 6 0 5 0 0 15 53 0 24 47 0 0 53 0 17 1 27
0 63 14 0 0 0 0 39 0 32 0 0 10 0 0 7 0 0 11 0 0 43 0 0 30 0 0 24 23 10 0 0
0 78 1 7 7 8 1 15 0 39 0 0 3 0 0 2 0 0 0 0 0 36 0 0 0 0 0 0 44 8 0 0
0 81 4 1 0 0 0 2 0 42 0 0 0 10 0 0 0 0 7 0 0 0 0 0 0 0 0 0 46 1 0 0
0 71 0 0 0 0 0 2 0 46 0 0 0 5 13 0 0 0 5 0 0 0 0 0 0 0 0 0 30 1 0 4
0 72 0 0 0 0 0 2 0 43 0 0 0 0 22 0 0 0 0 0 0 0 0 0 21 0 0 0 30 0 0 21
0 72 0 0 0 0 0 0 0 46 0 0 0 0 11 0 0 0 0 0 0 5 0 17 16 0 0 3 23 0 0 20
0 65 0 0 0 0 0 0 0 35 0 0 0 0 6 3 0 0 0 0 0 17 0 24 12 0 0 6 10 0 1 18
0 71 0 0 0 0 0 0 0 21 0 0 0 0 4 0 0 0 0 0 0 1 0 6 10 7 0 4 0 0 9 17
0 74 0 0 0 0 0 0 0 23 0 0 0 0 0 0 0 0 0 0 22 0 0 0 13 5 0 0 0 0 6 19
0 73 0 0 0 0 0 0 0 0 0 0 6 0 5 0 0 0 0 0 20 0 0 1 8 0 0 0 0 0 0 22
0 75 0 4 0 0 0 0 0 0 0 0 18 0 6 12 0 0 12 0 3 0 0 6 1 0 4 0 0 5 6 15
0 67 0 0 0 0 0 0 0 8 0 1 8 0 6 0 4 0 0 0 0 0 0 0 0 0 0 0 0 0 25 10
0 42 0 0 0 0 0 0 0 14 8 5 6 0 21 7 9 1 0 0 3 0 0 0 0 0 0 0 17 0 13 5
0 25 0 0 0 0 1 6 5 11 14 8 10 0 24 20 0 0 0 0 9 0 0 0 0 8 0 0 14 0 0 1
0 27 0 0 4 4 5 9 8 10 14 8 12 6 19 9 0 0 2 0 0 0 0 0 0 0 0 0 0 10 0 0
0 2 0 0 0 0 0 0 0 0 0 0 0 0 0 0 0 0 0 0 0 0 0 0 0 0 0 0 0 0 0 0
0 9 0 0 2 5 0 0 2 5 4 0 5 0 0 0 0 0 0 4 0 0 4 10 27 0 16 17 0 10 12 24
