0 40 0 0 0 0 0 0 0 0 0 0 0 0 0 0 0 0 0 0 0 0 0 0 0 0 0 0 0 0 0 64
0 0 0 0 0 0 0 0 0 0 0 0 0 0 0 0 0 0 0 0 0 0 0 0 0 0 0 0 0 0 0 0
0 0 0 0 0 0 0 0 0 0 0 0 0 0 0 0 0 0 0 0 3 0 0 0 0 0 0 0 0 0 0 0
0 0 0 0 0 0 0 0 0 0 0 0 0 0 0 0 0 0 0 0 0 0 0 0 0 0 0 0 0 0 0 0
0 0 0 0 0 0 0 0 0 0 0 0 0 0 0 0 0 0 0 0 0 0 0 0 0 0 0 0 0 0 0 0
0 0 0 0 0 0 0 0 0 0 0 0 0 0 0 0 0 0 0 0 0 0 0 0 0 0 0 0 0 0 0 0
0 0 0 0 0 0 0 0 0 0 0 0 0 0 0 0 0 0 0 0 5 0 0 0 0 0 0 0 0 0 0 0
0 0 0 0 0 0 0 0 23 21 0 0 0 0 0 0 0 0 0 0 0 0 0 0 0 0 0 0 0 0 0 0
0 0 0 0 0 0 0 0 25 94 7 0 0 0 0 0 0 6 0 0 0 0 0 0 0 0 0 0 0 0 0 0
0 0 0 0 0 0 0 0 0 117 28 0 2 3 5 0 0 27 0 0 11 0 0 0 0 0 0 2 0 0 0 0
0 0 0 0 3 0 0 0 0 114 29 0 0 0 0 0 0 26 0 0 27 57 0 0 0 0 0 0 0 0 0 0
0 0 0 0 0 4 0 0 0 106 32 0 13 0 0 0 0 15 8 0 0 74 0 0 48 0 0 0 0 0 0 0
54 19 0 0 0 0 31 0 0 92 25 0 25 0 2 0 0 0 0 0 5 36 0 17 54 0 0 7 0 0 0 0
6 61 104 0 0 0 0 43 0 30 19 5 30 0 3 0 0 21 0 0 6 44 0 26 90 0 0 45 0 0 0 0
0 15 101 21 0 0 0 62 0 0 0 3 30 0 0 3 0 20 2 0 0 59 0 0 92 0 0 15 19 0 0 0
0 0 15 40 8 0 0 0 23 44 0 0 17 7 0 11 0 0 7 0 0 32 0 0 53 3 0 0 10 20 0 0
0 0 0 0 0 0 0 0 0 88 2 0 0 9 0 8 7 0 1 0 0 4 0 6 37 0 0 0 0 23 0 0
0 0 0 0 0 0 0 0 0 72 22 0 0 11 11 0 7 15 24 0 0 0 0 35 59 2 0 0 0 21 0 0
0 0 0 0 0 0 0 0 0 64 23 6 0 0 39 4 0 7 31 0 0 0 0 39 89 12 0 0 0 17 0 0
0 0 0 0 0 0 0 0 0 74 11 33 0 0 33 24 0 15 17 0 0 0 0 10 81 4 0 0 0 7 0 0
0 0 0 0 0 0 0 0 0 91 9 23 0 0 0 21 0 19 21 0 0 0 0 0 54 0 0 0 22 6 0 0
0 0 0 0 0 0 0 0 0 75 18 14 15 0 0 8 0 0 24 0 0 7 0 0 33 0 0 0 22 0 0 0
0 0 0 0 0 0 0 0 0 44 11 15 19 0 9 10 0 0 0 0 35 0 0 0 0 0 0 16 24 0 0 0
0 0 0 0 0 0 0 0 0 33 15 11 12 0 16 11 0 23 0 0 48 0 0 0 0 0 6 19 2 0 0 0
0 0 0 0 0 0 0 0 0 14 11 29 40 0 0 20 0 0 11 0 18 0 0 0 0 0 20 15 0 0 0 0
0 0 0 0 0 0 0 0 0 2 0 20 50 0 0 25 0 0 3 0 12 0 0 0 0 0 47 8 0 0 0 0
0 0 0 0 0 0 0 0 0 7 0 0 5 8 21 8 21 0 0 0 0 0 0 0 0 0 32 32 0 0 0 0
0 0 0 0 0 0 0 0 0 7 7 3 0 0 18 7 6 19 0 0 0 0 0 0 0 27 0 0 30 0 0 0
0 0 0 0 3 0 0 0 0 0 11 18 8 0 0 1 0 20 0 0 0 0 0 0 0 48 0 0 0 7 0 0
0 0 0 0 8 1 0 0 0 0 1 11 17 0 0 0 0 0 0 0 0 0 0 0 0 25 33 0 0 10 0 0
0 0 0 0 0 7 0 0 0 0 0 0 8 2 0 6 0 0 0 3 0 0 0 0 11 0 37 0 0 0 0 0
0 0 0 0 0 0 0 0 0 0 0 0 1 9 0 0 0 0 0 0 0 0 0 0 19 0 0 26 0 0 0 0
