15 0 0 0 0 0 0 0 0 0 0 0 0 0 0 0 0 0 0 0 0 0 0 0 0 0 0 0 0 0 18 0
0 0 0 0 0 0 0 0 0 0 0 0 0 0 0 0 0 0 0 0 0 0 0 0 0 0 0 0 0 0 0 56
3 0 0 0 0 0 0 0 0 0 0 0 0 0 0 0 0 3 0 0 0 0 11 1 2 5 5 4 1 2 0 43
4 0 0 0 0 0 0 0 0 0 0 0 0 1 0 0 0 2 0 0 0 0 7 5 4 5 4 6 1 2 0 45
5 0 0 0 0 0 0 0 0 0 0 0 0 3 3 2 1 2 5 3 0 3 2 3 3 2 4 6 1 1 0 45
5 0 0 0 0 0 0 0 0 0 0 0 4 7 5 8 6 3 6 6 5 5 4 3 3 1 3 5 4 1 0 44
7 0 1 0 0 0 0 5 0 7 15 15 18 26 22 21 21 19 21 11 2 9 6 1 3 3 4 4 6 4 0 45
10 0 0 0 0 0 5 5 0 0 0 0 0 0 0 0 0 0 8 20 0 4 15 0 0 5 6 6 6 7 0 47
10 4 1 0 1 2 9 1 6 0 0 13 6 10 13 21 17 10 0 50 22 0 31 16 3 4 4 7 6 9 0 48
37 0 15 0 3 3 8 2 44 0 2 26 22 23 20 24 35 18 0 34 12 0 23 12 14 15 0 3 8 11 0 51
71 2 18 0 0 2 4 5 51 0 0 12 7 11 7 0 19 3 0 36 0 0 12 4 0 47 13 0 8 19 0 59
5 26 19 23 0 2 2 14 50 0 0 9 0 9 9 3 22 10 0 37 23 0 7 30 0 10 47 0 11 11 0 61
0 12 0 90 12 0 0 13 82 0 0 17 0 7 3 0 15 19 0 26 37 0 0 5 0 0 51 0 14 0 0 52
0 10 0 62 59 6 12 0 115 0 0 14 0 12 4 0 8 0 0 37 42 0 35 0 0 0 51 0 20 5 15 49
0 22 0 0 21 16 78 0 54 41 2 9 0 8 14 0 25 0 0 47 47 0 56 41 0 0 65 0 9 0 10 36
1 14 0 0 7 21 85 14 0 0 33 21 0 0 14 0 15 30 0 25 52 0 6 79 0 0 46 21 0 0 2 43
10 6 22 17 14 12 24 26 18 0 7 26 4 0 15 3 0 28 0 25 52 0 0 30 0 0 0 55 0 0 0 59
6 8 15 17 10 14 15 24 48 0 0 21 17 0 4 21 0 17 0 50 22 14 13 0 0 0 0 52 14 8 0 57
9 6 14 18 14 12 10 24 42 0 1 2 31 7 0 17 9 23 0 37 27 37 16 0 0 0 1 36 32 3 0 42
12 14 10 13 19 20 16 25 47 0 16 0 18 44 0 0 12 13 0 0 27 26 27 22 0 0 0 12 26 0 11 36
3 13 22 21 13 15 14 23 53 0 15 0 0 54 18 0 15 5 0 20 25 0 49 27 0 0 5 18 18 0 9 43
12 6 6 15 10 7 9 22 55 0 0 4 0 33 32 0 15 23 0 18 49 0 66 15 0 0 0 30 9 8 0 42
9 9 10 14 14 14 13 0 49 0 0 5 0 16 21 2 6 33 7 1 18 0 41 29 0 0 3 21 0 20 2 41
10 8 15 21 19 12 10 4 36 0 0 19 0 28 7 5 11 0 2 47 0 0 0 18 15 1 16 12 0 4 8 39
17 9 10 10 22 11 17 16 15 10 0 3 0 31 9 0 20 5 0 33 0 0 0 8 14 17 15 0 16 0 17 36
14 11 21 5 9 4 15 17 13 0 5 7 0 4 28 0 2 33 0 23 0 0 12 18 14 24 0 1 27 0 6 42
13 10 19 4 3 0 1 9 23 1 11 22 1 0 7 14 0 17 5 0 0 0 10 28 13 29 0 0 9 41 0 46
19 0 10 6 6 9 9 16 22 5 4 11 5 17 0 0 0 0 0 0 0 11 17 15 25 11 25 8 0 25 12 43
27 0 6 14 7 19 11 7 15 11 0 0 0 23 8 0 0 0 0 9 2 18 24 4 33 0 10 34 0 0 10 45
32 20 8 19 10 12 14 3 8 10 6 1 0 7 5 0 4 0 0 14 16 16 15 15 33 3 0 20 24 3 1 46
27 29 19 18 16 7 16 13 9 13 13 12 9 18 11 0 7 23 22 30 39 38 29 47 27 34 0 24 62 28 0 50
13 9 0 0 0 0 0 0 0 0 0 0 0 0 0 0 0 0 0 0 0 0 0 0 0 8 0 0 11 7 0 48
