0 0 0 0 0 0 0 0 0 0 0 0 0 0 0 0 
0 0 0 0 0 0 0 0 0 0 0 0 0 0 0 0 
0 0 0 0 0 0 0 0 0 34 47 0 0 0 0 0 
0 0 0 0 0 0 0 0 0 55 128 0 0 0 0 0 
0 0 0 0 0 0 0 0 0 24 76 0 0 0 0 0 
0 0 7 250 81 0 0 0 70 1 0 0 0 0 0 0 
0 0 0 66 158 237 151 0 34 0 0 0 0 0 0 0 
0 0 0 0 292 225 147 0 0 0 0 93 0 0 0 34 
0 0 0 317 428 79 36 0 0 0 0 145 140 0 0 94 
0 0 0 342 413 0 7 39 12 0 0 0 141 267 110 71 
0 0 0 186 186 0 0 0 0 0 0 0 212 335 169 47 
0 0 0 29 55 18 0 0 0 39 96 0 55 193 142 70 
0 0 0 0 0 0 0 0 0 65 110 26 28 106 80 108 
0 0 0 0 0 0 0 0 0 205 0 0 0 84 60 95 
0 0 0 0 0 0 0 0 0 0 0 60 39 0 0 118 
0 0 0 0 0 0 0 0 0 0 0 39 0 0 0 22 
