0 0 0 0 0 0 0 0 0 0 0 0 0 0 0 0 
0 0 0 0 0 0 0 0 0 0 0 0 0 0 0 0 
0 0 0 0 0 0 0 0 0 0 0 0 0 0 0 0 
0 0 0 0 0 0 1 65 17 0 0 0 0 0 0 0 
0 0 0 0 0 328 320 273 173 0 0 0 0 0 0 0 
0 0 0 0 0 70 246 209 0 0 159 359 66 0 0 0 
80 0 0 0 0 0 0 0 0 0 18 196 0 18 165 0 
0 0 0 0 0 0 0 0 0 0 0 0 0 0 0 0 
0 0 0 0 0 0 0 0 0 0 0 0 0 0 0 0 
0 0 0 0 0 0 13 0 0 0 0 0 0 0 0 0 
0 0 0 0 0 0 114 31 0 0 0 0 0 0 0 0 
0 0 0 0 0 0 195 61 0 0 0 0 0 0 0 0 
0 0 0 0 0 0 180 171 0 0 0 0 0 0 0 0 
0 0 0 0 0 0 106 81 0 0 0 0 0 0 0 0 
0 0 0 0 0 5 0 0 0 0 0 0 0 0 0 0 
0 0 0 0 0 0 0 0 0 0 0 0 0 0 0 0 
