0 35 0 0 0 0 0 0 0 0 0 0 0 0 0 0 
0 0 0 0 0 0 0 0 0 0 0 0 0 0 10 0 
0 0 0 0 0 124 142 152 77 0 0 0 0 0 0 0 
0 0 0 0 0 448 457 269 75 12 0 0 0 0 46 0 
0 0 0 0 0 43 337 283 0 0 25 0 0 0 73 0 
0 0 0 0 0 0 0 113 0 0 0 0 0 0 99 0 
0 34 0 0 0 0 0 0 0 0 0 0 0 0 96 16 
27 158 167 0 0 0 0 0 0 0 0 0 0 0 0 0 
0 247 277 0 0 0 0 0 27 0 0 0 0 0 0 0 
0 270 323 0 0 0 0 0 27 0 0 0 0 0 0 0 
0 305 195 11 0 0 0 0 0 0 0 0 0 0 0 0 
0 211 157 136 0 0 0 149 141 0 0 0 0 0 0 0 
0 108 119 127 0 0 0 125 0 0 0 0 0 0 0 0 
0 44 0 15 0 0 0 0 0 0 0 0 0 0 0 0 
0 0 0 0 31 37 0 0 0 0 0 0 0 0 0 0 
0 0 0 0 0 39 1 0 0 0 0 0 0 0 0 0 
