0 0 0 0 0 0 0 0 0 0 0 0 0 0 0 0 
0 0 0 0 0 0 0 0 0 0 0 0 0 0 0 0 
0 0 0 0 0 0 0 0 0 0 0 0 0 0 0 0 
0 0 0 0 0 0 0 0 0 25 0 0 0 0 0 0 
0 0 0 0 0 0 0 0 0 0 0 0 0 0 0 0 
0 0 0 61 2 190 134 64 0 0 0 13 0 0 0 0 
1 0 0 128 42 143 111 6 0 0 272 166 0 0 0 0 
0 0 0 0 0 0 0 0 0 0 0 0 0 0 0 0 
0 0 0 16 21 27 21 0 0 0 0 69 120 0 0 0 
0 0 0 0 0 12 20 0 0 0 206 393 174 112 50 0 
0 0 0 0 0 21 94 0 0 52 339 141 0 0 86 0 
0 0 0 0 0 127 143 0 0 349 247 0 0 7 84 0 
0 0 0 0 51 277 109 0 227 234 0 0 0 176 144 0 
0 0 0 0 9 124 123 177 87 0 0 0 91 301 0 0 
0 0 33 53 0 0 12 0 0 0 0 51 243 178 0 0 
0 0 34 0 0 0 0 0 0 0 0 131 153 0 0 0 
