0 0 0 0 0 0 0 0 0 0 0 0 0 0 0 0 
1 60 0 8 62 21 30 7 18 16 68 70 16 0 0 0 
0 0 0 0 164 36 45 27 27 33 50 0 0 0 0 0 
0 0 0 0 245 0 0 0 0 0 53 103 18 0 0 0 
0 67 0 0 217 0 0 0 0 0 0 65 93 41 0 0 
0 0 0 0 254 99 0 0 0 168 101 99 56 145 0 0 
0 0 0 0 74 1 0 0 0 50 314 319 337 476 0 44 
0 129 0 0 162 0 0 0 0 0 190 183 169 277 0 0 
0 0 0 0 316 0 0 0 0 0 0 47 0 22 0 0 
34 0 0 0 267 7 82 69 0 0 0 42 0 1 35 0 
4 0 0 0 194 69 209 106 0 0 0 0 0 0 89 0 
63 9 0 0 75 61 266 155 0 0 0 0 0 0 111 0 
59 0 0 0 6 1 202 0 0 0 0 0 0 1 126 0 
0 0 0 0 0 0 182 0 0 0 0 0 0 0 121 0 
0 0 0 0 0 42 94 0 0 0 0 0 6 139 201 0 
0 0 0 0 0 0 0 0 0 0 0 0 95 109 139 0 
