0 0 0 0 0 0 0 0 0 0 0 0 0 0 0 0 
0 0 0 0 0 0 0 0 0 0 0 0 0 0 0 0 
0 0 0 0 0 0 0 0 0 0 0 0 0 0 0 0 
0 0 0 0 0 0 0 0 0 0 0 0 0 0 0 0 
0 0 0 0 0 0 108 72 113 235 251 87 0 0 0 0 
81 0 0 0 0 0 99 111 150 256 287 330 191 25 0 0 
257 265 278 92 54 106 155 81 137 233 287 433 357 242 0 0 
189 9 141 91 89 103 51 0 52 188 260 470 409 288 9 0 
137 0 34 71 92 22 69 12 102 209 227 313 223 123 0 0 
38 0 0 0 26 0 54 32 154 272 304 411 314 138 15 0 
14 0 0 0 0 16 122 123 145 265 347 333 189 0 0 0 
0 0 0 0 2 131 268 247 222 288 321 77 63 0 0 0 
0 0 0 0 0 88 266 211 199 283 154 0 0 0 0 0 
0 0 0 0 0 61 195 132 157 109 0 0 0 47 43 0 
0 0 0 0 0 0 97 258 175 78 0 0 45 214 89 0 
0 0 0 0 0 0 38 75 112 0 0 0 151 189 19 0 
