431 0 0 0 0 0 0 0 0 0 0 0 0 0 0 0 
886 180 109 173 185 204 182 190 191 197 185 149 144 154 348 34 
709 0 0 0 0 0 0 0 0 0 0 0 0 0 8 0 
737 0 0 0 0 0 0 0 0 0 0 0 0 0 50 0 
334 0 0 150 359 426 266 89 196 123 55 0 0 0 0 0 
482 0 0 42 381 395 316 242 308 286 377 294 233 61 0 0 
550 59 0 0 0 0 0 0 221 273 238 149 279 119 119 0 
331 101 2 236 192 55 0 0 190 235 137 0 62 0 0 0 
233 0 0 138 293 252 0 0 114 123 45 0 10 32 47 31 
253 0 0 67 170 89 0 0 53 141 107 64 108 44 138 63 
301 0 0 95 66 0 0 0 0 126 189 45 74 0 159 0 
331 0 0 0 0 0 0 0 0 37 138 96 9 0 16 0 
229 0 0 0 0 0 0 12 191 210 137 0 0 0 0 0 
141 0 0 59 100 88 39 112 175 126 19 0 0 0 0 35 
195 0 0 43 11 0 0 0 0 0 0 0 0 0 0 0 
215 174 69 45 0 8 32 86 4 83 61 26 11 37 11 26 
