0 0 0 0 0 0 0 0 0 0 0 0 0 0 0 0 
0 0 0 0 0 0 0 0 0 0 0 0 0 0 0 0 
0 0 0 34 58 19 16 20 21 8 14 0 0 0 0 0 
0 0 0 0 68 143 237 211 195 103 9 0 0 0 0 0 
0 0 0 0 0 0 0 0 0 0 47 93 43 0 0 35 
102 0 0 0 0 0 0 0 0 0 0 0 0 0 0 9 
0 0 0 0 0 0 0 0 0 0 0 0 0 0 0 0 
0 0 0 0 0 0 0 0 0 0 0 0 0 0 0 0 
0 104 222 0 0 0 0 0 0 0 0 0 0 0 0 0 
0 145 258 0 0 0 0 0 0 0 0 0 0 0 0 0 
0 0 43 0 0 0 0 0 0 0 0 0 0 0 0 0 
0 0 0 0 0 0 0 0 0 0 0 0 0 0 0 0 
0 0 1 2 37 0 0 0 70 0 0 0 0 0 0 0 
0 90 270 237 158 0 0 0 0 0 0 0 0 0 0 0 
25 83 124 45 22 0 0 0 0 0 0 0 0 0 0 0 
10 0 33 0 0 0 0 0 0 0 0 0 0 0 0 39 
