0 0 0 0 0 0 0 0 0 0 0 0 0 0 82 0 
0 0 0 0 0 0 0 0 0 0 0 0 0 71 312 152 
0 0 0 0 0 0 0 0 0 0 0 0 0 0 137 21 
0 0 0 94 0 0 0 0 0 0 0 0 0 0 52 0 
0 0 0 426 0 0 0 0 97 0 0 0 0 0 0 0 
0 0 0 225 0 0 0 0 43 0 0 0 0 0 0 0 
0 0 0 72 0 0 0 0 0 0 0 0 0 0 0 0 
0 0 0 339 0 0 0 0 0 0 0 0 0 0 79 80 
0 0 0 587 59 0 0 0 0 0 0 0 0 0 168 0 
0 0 0 461 32 0 0 0 0 0 0 0 0 0 0 0 
0 0 0 367 0 0 0 0 0 0 0 0 0 0 0 0 
0 0 0 174 56 0 0 0 0 0 0 0 34 0 0 0 
0 0 0 18 77 87 0 0 0 0 0 0 271 0 0 0 
0 0 0 0 0 123 0 0 0 0 0 178 96 0 0 0 
0 0 0 0 4 93 0 0 0 0 0 0 0 0 0 0 
0 0 0 0 0 0 0 0 0 0 0 0 0 0 0 0 
