0 0 0 0 0 0 0 0 0 0 0 0 0 0 0 65 
0 0 0 0 0 0 0 0 0 0 0 0 0 0 0 0 
0 0 0 0 0 166 217 176 132 82 34 0 0 0 0 13 
0 0 0 0 144 482 389 207 173 199 223 155 36 0 0 51 
0 51 0 0 319 611 287 51 0 0 134 158 95 0 66 182 
0 175 58 111 315 342 0 0 0 0 121 108 0 7 311 276 
0 0 94 350 566 245 0 0 0 0 79 0 0 114 353 161 
0 0 15 64 225 222 1 0 0 0 44 0 116 151 137 162 
0 0 0 0 0 162 24 0 0 0 196 266 220 194 103 186 
0 29 0 0 0 61 13 0 0 21 391 400 300 50 124 122 
0 92 19 0 13 164 63 71 72 117 268 264 53 0 182 62 
0 0 3 68 200 166 34 128 105 71 192 23 0 102 112 33 
0 30 192 361 324 105 0 49 5 28 0 0 0 222 204 111 
0 352 426 316 76 0 0 0 0 0 0 0 120 299 131 96 
88 367 132 0 0 0 0 6 0 0 0 24 140 152 92 168 
88 77 0 0 0 0 0 0 0 0 15 94 16 60 47 55 
