52 209 6 39 27 26 27 33 26 27 52 47 39 48 172 76 
263 290 44 84 57 30 24 4 25 66 110 84 93 70 190 77 
302 272 102 180 89 0 100 72 63 69 63 74 141 128 192 80 
303 348 222 271 0 0 0 0 0 0 0 2 121 146 259 123 
99 201 278 355 0 0 0 0 0 0 0 0 0 109 234 150 
0 0 79 207 0 0 0 0 0 0 0 0 0 0 0 21 
0 0 0 0 0 0 0 0 0 0 0 0 0 0 0 0 
0 0 0 0 0 0 0 0 0 0 0 0 0 0 0 0 
0 0 0 0 0 0 0 0 0 0 0 0 0 0 0 0 
0 0 0 70 0 0 0 0 0 0 0 0 0 0 0 0 
0 0 0 10 0 0 0 0 0 0 0 0 0 138 0 0 
0 0 6 3 0 0 0 0 0 0 0 0 191 0 0 71 
87 36 7 0 0 0 0 0 0 0 0 207 82 0 0 33 
0 0 0 0 0 0 0 0 0 0 126 132 0 0 0 10 
0 0 0 0 0 0 0 0 0 52 136 0 0 0 0 0 
0 0 0 0 0 0 0 0 0 0 0 0 0 0 0 0 
