0 0 0 0 0 0 0 0 0 0 0 0 0 0 252 230 
0 67 0 0 0 0 0 0 0 0 0 0 0 0 586 277 
0 0 0 0 0 0 0 0 0 0 0 0 0 0 355 118 
0 0 0 16 138 0 0 0 0 0 0 0 0 0 327 124 
0 0 0 247 417 0 0 0 25 26 0 0 0 0 371 118 
0 41 93 431 222 0 0 0 0 0 0 0 0 4 334 52 
0 154 223 434 224 0 0 0 0 147 0 0 0 82 368 111 
0 129 301 448 336 0 0 0 0 240 290 0 0 65 266 83 
0 0 11 255 48 0 0 0 0 264 260 0 0 195 330 0 
0 0 48 208 0 0 0 0 0 105 58 0 0 371 0 0 
0 17 0 87 0 0 0 0 0 0 0 0 0 204 0 0 
0 0 0 66 0 0 0 0 0 0 0 0 274 92 0 0 
0 0 0 0 0 0 0 0 0 0 0 195 206 0 0 0 
0 0 0 0 0 0 0 0 0 0 58 185 0 0 0 0 
0 0 0 0 0 0 0 0 0 0 105 0 0 0 41 0 
0 0 0 0 0 0 0 0 79 105 0 0 0 0 0 0 
