0 0 0 0 0 0 0 0 0 0 0 0 0 0 0 0 
0 0 0 0 0 0 0 0 0 0 0 0 0 0 0 0 
0 0 0 0 23 0 0 0 0 4 89 79 0 0 0 0 
42 145 0 6 88 0 0 0 0 0 168 155 120 50 0 0 
79 225 111 53 33 0 0 0 0 0 205 186 166 136 0 0 
0 17 178 31 0 0 0 0 0 0 54 0 24 180 0 0 
0 0 0 0 0 67 157 42 0 0 0 0 62 42 0 0 
0 0 0 0 0 339 339 234 80 36 0 101 129 21 0 0 
0 0 0 0 52 417 263 213 112 64 81 165 43 0 0 0 
0 0 0 0 181 412 224 196 193 151 122 123 0 0 47 36 
0 0 0 0 185 325 230 168 137 123 161 124 0 0 184 120 
0 0 0 0 0 86 113 76 7 62 60 0 0 316 204 124 
0 0 0 0 0 0 0 0 0 19 0 0 135 347 85 107 
66 0 0 0 0 0 0 25 0 0 0 99 413 159 0 49 
12 0 0 0 0 0 0 0 0 0 0 293 231 0 0 20 
0 0 0 0 0 0 52 0 0 0 79 211 53 0 0 0 
