0 0 0 0 0 0 0 0 0 0 0 0 0 0 0 0 
0 0 0 0 0 0 0 0 0 0 0 0 0 0 0 0 
0 0 0 0 53 68 0 0 0 0 0 0 0 0 0 0 
0 0 0 0 169 227 0 0 0 0 0 0 0 0 0 0 
0 0 0 0 69 486 222 0 0 0 181 0 0 0 0 0 
50 0 0 0 0 112 395 233 17 34 241 141 95 0 0 0 
181 23 0 0 0 0 0 95 0 0 0 121 433 25 0 0 
0 79 0 0 0 44 0 0 0 0 0 0 85 0 0 0 
0 24 0 0 0 294 19 102 61 0 0 0 0 0 0 0 
0 0 0 0 0 47 76 112 155 0 0 0 0 0 0 0 
0 0 0 0 0 0 23 64 37 0 0 0 0 0 41 0 
0 0 0 0 0 0 50 191 0 0 0 0 0 0 0 0 
0 0 0 0 0 0 0 103 0 0 0 0 0 0 0 0 
0 0 0 0 0 0 0 46 62 0 0 0 0 0 44 18 
32 0 0 0 0 0 0 0 0 0 0 0 0 0 210 60 
0 0 0 0 0 0 0 0 0 0 0 0 0 0 30 0 
