11 248 174 164 163 161 168 169 160 146 152 159 174 152 73 0 
8 401 293 277 302 263 250 237 274 263 276 271 260 220 164 73 
45 385 126 2 0 0 0 0 0 0 89 150 180 145 93 0 
70 419 169 0 0 0 0 0 0 0 0 43 124 169 176 0 
0 165 54 0 0 0 0 16 11 0 0 0 0 14 75 0 
0 0 0 0 0 0 0 0 0 0 0 0 0 0 0 0 
0 0 0 0 0 0 0 0 0 0 0 0 0 0 0 0 
15 137 0 0 0 0 0 0 0 0 0 0 0 0 0 0 
0 200 81 0 0 0 0 0 0 0 0 0 0 0 0 0 
0 52 0 0 0 0 0 0 0 0 0 0 0 0 0 0 
0 114 45 0 0 0 0 0 0 0 0 0 0 0 4 0 
0 108 0 0 0 0 0 0 0 0 0 0 0 0 1 0 
0 0 0 0 0 0 0 0 0 0 0 0 0 0 0 0 
0 0 0 39 51 0 0 0 0 31 145 0 0 0 0 0 
0 0 22 50 3 0 0 0 0 0 0 0 0 0 0 0 
103 229 190 161 177 168 120 189 324 363 253 137 179 130 137 47 
