0 0 0 0 0 0 0 0 0 0 0 0 0 0 0 0 
0 0 0 0 0 0 0 0 0 0 0 0 0 0 0 0 
0 0 0 0 0 0 0 0 0 0 0 0 0 0 0 0 
0 0 0 0 0 0 0 0 0 0 0 0 0 0 0 0 
0 0 0 0 0 0 0 0 0 0 0 0 0 0 0 0 
0 0 0 0 30 0 0 0 0 0 0 0 0 0 0 0 
231 151 0 72 199 0 0 0 0 18 224 54 0 0 7 0 
105 314 227 308 48 0 0 0 0 64 62 0 0 89 84 0 
0 0 0 0 0 0 0 0 0 0 0 0 0 0 0 0 
0 0 0 0 0 0 0 0 0 0 30 207 211 0 1 0 
0 0 0 0 0 0 0 0 0 0 195 292 28 0 0 0 
0 0 0 0 0 0 0 0 0 0 152 0 0 0 0 0 
0 0 0 0 0 0 35 9 0 159 0 0 0 0 0 0 
0 0 0 0 0 0 0 3 0 0 0 0 0 168 232 0 
0 0 0 0 0 0 58 224 0 0 0 0 0 0 0 0 
91 59 0 0 0 0 74 0 0 0 0 91 231 177 51 0 
