0 135 177 122 127 131 129 121 113 111 104 100 104 119 161 0 
0 283 330 234 227 208 194 184 189 204 251 283 314 356 484 220 
0 108 102 0 0 0 0 0 0 0 0 0 25 157 241 34 
0 0 0 0 0 0 0 0 0 0 0 0 0 0 78 0 
0 0 0 0 0 0 64 72 0 0 0 0 0 0 0 0 
0 0 0 0 0 6 122 199 3 0 0 0 0 0 0 0 
0 0 0 0 0 0 123 130 0 0 0 0 0 0 0 0 
34 56 122 0 0 0 0 0 0 0 0 75 0 0 0 0 
45 352 369 0 0 0 0 0 0 0 0 23 101 127 73 21 
0 218 212 0 0 0 0 0 0 0 0 0 0 0 0 19 
0 27 9 0 0 0 0 0 0 0 0 0 0 0 0 0 
0 69 0 0 0 0 0 0 0 0 0 0 0 0 0 0 
0 26 0 0 0 0 0 0 0 0 0 0 0 0 0 0 
0 0 0 30 0 35 69 70 0 0 0 0 0 0 0 0 
0 0 0 41 58 49 135 182 0 0 0 0 0 0 0 0 
0 0 0 0 0 0 113 151 0 0 0 0 0 0 0 0 
