0 0 0 0 0 0 0 0 0 0 0 0 0 0 0 0 
0 0 0 0 0 0 0 0 0 0 0 0 0 0 0 0 
0 0 0 0 0 0 0 0 0 0 0 0 0 0 0 0 
0 0 0 0 0 0 0 0 0 0 0 0 0 0 0 0 
0 0 0 8 61 0 0 0 0 0 0 0 0 0 0 0 
0 0 0 149 193 0 0 0 136 325 293 45 0 0 0 0 
0 0 0 52 79 49 97 145 182 302 379 313 234 177 19 0 
83 0 0 0 94 105 133 187 210 241 320 211 137 188 26 0 
0 0 0 0 30 94 128 191 252 259 246 211 132 147 0 0 
0 0 0 0 1 188 263 234 239 174 194 164 118 106 74 0 
0 0 0 0 15 108 193 192 216 232 190 150 40 29 159 0 
0 0 0 0 0 42 141 185 169 108 22 28 0 84 129 0 
0 0 0 0 0 0 0 0 0 0 0 0 0 64 109 0 
0 0 0 0 0 0 0 0 0 0 14 0 0 155 165 0 
0 0 0 0 0 0 0 0 42 158 0 0 174 277 241 5 
0 0 0 0 0 0 0 139 193 52 0 0 117 55 0 0 
