0 0 0 0 0 0 0 0 0 0 0 0 0 0 36 17 
0 0 0 0 0 0 0 0 0 0 0 0 0 0 0 0 
0 0 0 0 0 0 0 0 0 0 0 0 0 0 0 0 
0 0 0 0 0 0 0 0 0 0 0 0 0 0 0 0 
0 0 0 0 212 0 0 0 0 0 0 0 0 0 0 0 
0 0 0 0 180 193 0 0 0 0 67 0 0 0 0 0 
194 0 0 0 27 192 60 0 44 129 160 75 35 0 0 0 
194 15 0 0 49 0 0 34 30 73 49 152 146 0 0 0 
0 0 0 2 241 0 0 7 0 0 0 77 74 0 0 0 
0 0 0 0 231 51 0 0 0 0 0 62 0 0 0 0 
0 0 0 0 151 137 0 0 0 0 0 0 0 0 0 0 
0 0 0 0 26 174 32 0 0 10 29 0 0 0 0 0 
0 0 0 0 8 144 119 0 0 0 0 0 0 0 0 0 
0 0 0 0 0 0 62 0 0 0 0 0 0 57 79 0 
0 0 0 0 0 0 31 0 0 0 0 0 0 0 0 0 
0 0 0 0 0 0 0 0 0 0 0 0 0 123 58 0 
