0 0 0 0 0 0 0 0 0 0 0 0 0 0 0 0 
0 0 0 0 0 0 0 0 0 0 0 0 0 0 0 0 
0 0 0 0 0 0 0 0 0 0 0 0 0 0 0 0 
0 0 0 0 0 0 0 0 0 0 0 0 0 0 0 0 
0 0 0 3 0 0 0 0 0 0 0 0 0 0 0 0 
0 0 0 0 0 0 0 0 0 70 0 0 0 17 0 0 
0 0 0 0 0 0 0 46 77 203 65 0 36 111 0 0 
0 0 0 0 0 0 0 47 34 173 164 164 31 0 0 0 
0 0 0 0 2 0 0 14 0 192 288 212 0 0 0 0 
0 0 0 72 125 0 0 17 34 209 353 447 0 0 0 0 
0 0 65 105 120 76 20 38 167 204 425 320 0 77 0 0 
0 1 91 168 124 38 0 17 163 401 217 0 0 118 0 0 
0 60 76 120 5 0 0 0 220 170 0 0 118 10 0 0 
0 100 2 0 0 0 40 214 140 0 0 30 224 22 0 46 
0 0 0 0 0 0 129 40 0 0 0 91 162 18 0 0 
0 0 0 0 0 0 0 0 0 0 0 57 80 61 0 0 
