0 0 0 0 0 0 0 0 0 0 0 0 0 0 0 0 
0 0 0 0 0 0 0 0 0 0 0 0 0 0 0 0 
0 0 0 0 0 0 0 0 0 0 0 0 0 0 0 0 
0 0 0 0 0 0 0 0 0 0 0 0 0 0 0 0 
0 0 0 0 0 0 0 0 0 46 0 0 0 0 0 0 
0 0 0 0 0 0 0 67 223 233 0 0 35 0 0 0 
0 0 0 0 0 0 49 190 335 457 174 0 19 0 0 0 
134 17 0 0 49 0 0 140 338 492 138 0 23 0 0 0 
101 0 0 0 208 0 0 47 236 432 42 0 0 149 0 0 
0 0 0 0 167 0 16 42 154 300 64 0 0 299 0 0 
0 0 0 0 0 0 120 57 72 217 306 158 0 181 44 0 
0 0 0 0 0 0 104 0 0 231 415 271 41 0 16 65 
0 0 0 0 0 0 117 0 116 350 264 167 0 0 114 60 
0 0 0 0 0 0 48 3 53 161 256 0 0 0 121 0 
0 0 0 0 0 0 117 77 0 149 0 0 0 3 93 0 
0 0 0 0 0 0 0 0 64 55 0 0 49 61 43 0 
