227 255 127 176 164 162 168 159 146 157 175 156 141 109 171 80 
212 124 155 196 175 164 181 169 164 175 159 151 171 133 124 4 
75 0 0 0 46 55 31 0 0 0 0 0 0 0 0 0 
16 0 0 0 62 0 0 0 0 0 0 23 0 0 0 0 
0 0 0 0 0 0 0 0 0 6 7 0 0 0 0 0 
0 0 0 0 0 0 0 0 40 0 0 0 0 0 0 0 
60 0 0 0 0 0 0 53 68 0 0 0 0 0 0 93 
167 106 0 0 0 0 0 0 0 32 36 0 0 74 175 103 
65 32 0 0 0 0 0 0 0 0 35 101 85 168 28 33 
0 0 0 0 0 51 0 0 0 0 82 160 288 377 7 32 
0 0 0 0 0 12 0 0 0 23 38 476 846 521 174 37 
0 0 0 11 36 0 0 0 0 0 282 1004 665 268 137 0 
0 23 116 103 30 0 0 0 0 451 1282 859 82 32 0 0 
4 170 36 55 68 7 0 0 528 1378 1068 96 0 46 0 0 
74 180 174 126 0 0 0 415 1257 1132 275 0 48 92 0 0 
119 140 58 37 0 0 239 706 601 80 0 18 138 0 0 0 
