0 20 0 0 0 0 0 0 0 0 0 0 0 0 0 73 
0 0 0 0 0 0 0 0 0 0 0 0 0 0 0 80 
0 0 0 0 0 0 0 0 0 0 0 0 0 0 0 0 
0 0 0 0 0 246 288 236 243 187 90 0 0 0 0 0 
119 0 0 0 0 0 227 174 205 235 318 432 214 0 0 31 
560 498 0 0 0 0 0 0 0 0 0 230 366 137 57 155 
74 614 326 0 0 0 0 0 0 0 0 0 0 104 50 85 
0 0 224 0 0 47 0 0 0 0 0 0 0 13 0 0 
0 0 0 0 0 0 0 0 0 0 0 0 0 57 0 21 
0 5 0 0 0 0 0 0 0 0 23 0 0 0 0 0 
0 0 0 0 0 0 20 54 0 0 76 0 0 0 0 0 
0 0 0 0 0 0 10 147 0 0 0 0 0 0 0 0 
0 0 0 2 0 0 0 92 111 33 0 0 0 2 0 0 
0 0 0 6 0 0 0 0 0 0 0 0 0 9 69 0 
82 49 0 0 0 0 0 0 0 0 0 0 0 14 61 0 
0 0 0 0 0 0 0 0 29 129 59 0 0 55 213 96 
