309 742 590 515 519 510 503 491 493 486 469 480 488 603 236 492 
0 0 0 0 0 0 0 0 0 0 0 0 0 0 0 0 
144 606 320 155 80 157 169 157 181 218 215 258 302 484 0 495 
94 487 255 0 0 0 0 0 0 0 0 4 79 335 0 338 
0 293 257 0 0 0 0 0 0 0 0 0 0 268 0 317 
0 68 107 0 0 0 0 0 0 0 0 0 0 11 0 282 
0 0 0 0 0 0 0 88 0 0 0 0 0 0 0 72 
0 0 0 0 0 0 0 0 0 0 0 0 0 0 0 91 
0 78 0 0 0 0 0 0 0 0 0 0 0 0 0 164 
39 371 235 0 0 0 0 0 0 0 0 0 0 0 0 282 
0 229 239 0 0 0 0 0 0 0 0 0 0 0 0 197 
0 216 142 0 0 0 0 0 0 0 0 0 0 0 0 208 
72 258 81 0 0 0 0 0 0 0 0 0 37 30 0 259 
67 127 0 0 0 0 0 0 0 0 0 68 29 0 0 276 
0 0 0 0 0 0 0 0 0 0 0 66 0 0 0 203 
0 0 15 50 95 0 0 0 0 85 163 0 0 0 0 215 
