225 315 135 110 92 85 81 84 90 103 114 119 124 61 31 64 
145 388 114 139 104 79 58 49 61 94 106 121 112 54 0 0 
139 188 0 22 47 20 0 0 0 81 63 35 0 0 0 0 
148 291 32 59 105 72 0 0 0 76 184 259 228 83 0 0 
102 444 198 0 0 0 0 0 0 0 53 268 380 348 33 0 
0 324 434 94 0 0 0 0 0 0 0 57 190 366 126 29 
0 0 60 7 0 0 15 3 0 0 0 0 0 68 50 68 
0 0 0 0 0 0 57 0 0 0 0 0 0 59 17 37 
0 0 0 0 0 0 163 28 0 0 0 0 0 164 0 0 
9 78 0 0 0 38 153 62 0 0 0 0 62 88 0 0 
2 101 0 0 0 40 119 44 0 0 0 0 0 0 0 0 
0 41 0 0 0 0 48 0 0 0 0 0 0 42 0 0 
0 0 0 0 0 0 0 0 0 0 0 0 0 52 24 0 
0 0 0 0 0 0 0 0 0 0 0 0 6 80 0 0 
0 0 0 0 0 0 0 0 31 29 118 0 57 132 38 0 
0 0 21 56 0 0 0 65 51 76 0 0 0 0 0 0 
