546 61 76 65 68 46 36 31 26 13 3 23 23 0 0 0 
548 0 0 0 0 0 0 0 0 0 0 0 0 0 0 0 
402 0 0 0 0 30 0 0 0 0 0 0 0 0 0 0 
339 0 0 0 0 161 0 0 0 0 0 12 0 0 0 0 
90 0 0 0 0 251 0 0 0 0 0 73 0 0 0 0 
0 0 0 0 0 58 0 0 0 0 0 0 0 0 0 0 
0 0 0 0 0 0 0 0 0 0 0 0 0 179 130 0 
0 0 0 0 0 49 0 0 0 0 0 0 0 330 73 0 
143 0 0 0 0 92 0 0 0 0 0 0 0 378 118 0 
258 0 0 0 0 0 0 0 0 0 15 0 0 0 0 79 
222 0 0 0 0 0 0 0 0 0 0 0 0 0 0 12 
181 0 0 0 0 0 0 0 0 0 0 32 0 0 0 38 
67 0 0 0 0 0 0 0 0 0 0 97 0 0 0 17 
0 0 0 0 0 0 0 0 0 0 39 0 0 0 0 50 
147 109 0 0 0 0 0 0 0 92 0 0 0 0 0 27 
125 39 0 0 0 0 0 0 99 47 0 0 0 0 15 0 
