0 180 251 237 235 236 240 238 235 259 261 214 229 299 438 224 
0 0 0 0 0 0 0 0 0 0 0 0 0 0 0 0 
0 0 0 111 0 0 52 45 85 94 62 0 0 9 21 0 
0 0 0 347 0 0 0 50 100 100 80 0 0 0 0 0 
0 0 59 543 0 0 0 149 174 12 0 0 0 0 0 0 
0 0 95 466 0 0 0 0 55 0 0 0 3 0 0 0 
26 0 0 277 0 0 0 0 123 44 0 0 0 0 0 0 
0 0 0 30 0 0 0 0 44 14 0 0 57 0 0 2 
0 0 0 164 0 0 0 0 0 0 0 0 142 0 0 0 
0 0 0 395 48 0 0 0 0 0 0 0 140 0 0 0 
0 0 0 322 95 0 0 0 0 0 0 0 0 0 0 0 
0 0 0 123 0 0 0 0 0 56 30 0 0 0 0 0 
0 0 0 0 0 70 0 0 0 262 0 0 0 0 0 0 
0 0 0 0 32 112 0 0 142 115 0 0 72 7 0 0 
0 0 0 0 0 0 0 14 258 0 0 61 258 0 0 0 
0 0 0 0 0 46 33 0 0 0 0 203 14 0 0 0 
