0 0 0 0 0 0 0 0 0 0 0 0 0 0 0 0 
0 0 0 0 0 0 0 0 0 0 0 0 0 0 0 0 
0 0 0 0 0 0 0 0 0 0 0 0 0 0 0 0 
0 0 0 0 0 0 0 0 0 0 0 0 0 0 0 0 
0 0 0 0 0 0 0 0 0 0 0 0 0 0 19 0 
0 0 0 0 0 0 0 0 0 0 0 0 0 0 0 0 
0 0 0 6 0 0 129 43 0 0 0 14 27 0 0 0 
78 0 0 9 0 0 113 6 0 0 62 71 0 0 0 0 
151 0 0 0 0 0 70 4 0 43 91 26 0 0 0 0 
85 0 0 0 0 0 38 31 58 60 0 0 0 0 0 0 
68 0 0 0 0 0 23 10 38 0 0 0 0 0 0 2 
35 0 0 101 41 0 34 0 0 0 0 0 0 0 0 25 
69 0 0 0 0 0 0 0 0 0 0 0 0 0 25 0 
70 0 0 0 0 0 0 0 0 0 0 0 0 0 101 27 
0 0 0 0 0 0 0 0 0 0 0 0 0 0 68 0 
0 0 0 0 0 0 0 0 0 0 0 0 0 50 43 0 
