0 0 0 0 0 0 0 0 0 0 0 0 0 0 0 0 
0 0 0 0 0 0 0 0 0 0 0 0 0 0 0 0 
0 0 0 0 0 0 0 0 0 0 0 0 0 0 43 0 
0 0 0 0 0 0 0 0 0 0 0 0 0 0 40 0 
0 0 0 107 153 0 0 0 0 0 0 0 0 0 28 0 
0 0 0 282 424 288 84 0 0 0 0 0 0 0 0 0 
0 0 0 0 0 232 312 195 17 0 0 0 0 0 0 0 
0 0 0 0 0 26 217 190 0 0 0 1 18 0 0 0 
0 0 0 0 0 103 114 140 39 0 0 74 134 0 0 0 
0 0 0 0 41 191 111 145 140 0 0 0 0 53 101 7 
0 0 0 0 0 178 152 102 78 35 0 0 0 0 18 22 
0 0 0 0 0 0 0 0 0 0 0 0 0 169 95 96 
0 0 0 0 0 0 0 0 0 0 0 0 181 261 98 102 
0 0 0 0 0 0 0 0 0 0 0 156 222 135 0 0 
0 0 0 0 0 0 0 0 0 0 43 9 16 26 0 0 
0 0 0 0 0 0 0 0 0 45 0 0 0 40 0 0 
