0 0 0 0 0 0 0 0 0 0 0 0 0 0 0 0 
0 0 0 0 0 0 0 0 0 0 0 0 0 0 0 0 
0 0 0 0 0 0 0 0 0 0 0 0 0 0 0 0 
0 0 0 0 0 0 0 0 0 0 0 0 0 0 0 0 
0 0 0 0 0 0 142 295 178 12 0 0 0 0 0 0 
0 0 0 0 0 0 268 399 201 86 109 9 0 0 0 0 
12 0 0 0 0 0 0 0 0 0 27 109 111 1 0 0 
138 46 0 0 0 0 0 0 0 0 0 0 0 90 131 9 
0 0 78 0 0 0 0 0 0 0 0 0 0 0 0 0 
0 0 33 0 0 0 0 0 0 0 0 0 0 0 0 0 
0 0 50 0 0 0 0 0 0 0 0 0 0 0 0 0 
0 0 27 0 0 13 147 59 46 0 0 20 0 0 0 0 
0 0 0 0 37 148 252 138 104 180 273 3 0 0 0 0 
0 0 3 189 291 207 162 99 224 257 6 0 0 0 0 0 
0 0 213 171 104 0 0 0 63 0 0 0 0 0 0 0 
52 3 0 0 0 14 123 97 0 0 0 0 63 0 0 0 
