0 0 0 0 0 0 2 3 7 23 15 0 0 120 224 0 
0 0 0 0 0 0 0 0 0 0 0 0 0 48 144 0 
0 0 29 39 0 0 0 0 0 0 0 0 0 80 237 0 
0 0 59 224 0 0 22 113 79 1 0 0 0 0 166 0 
0 0 19 248 7 0 53 133 168 83 0 18 0 0 108 0 
262 0 0 133 38 0 0 0 116 76 0 0 108 0 9 0 
189 141 0 0 0 0 0 0 89 7 0 0 0 0 0 0 
145 150 36 63 0 0 0 66 161 3 0 0 0 0 0 0 
0 0 109 220 67 0 0 96 174 72 0 0 0 0 0 0 
0 0 0 85 0 0 0 63 83 101 0 0 0 0 0 0 
0 0 0 0 0 0 19 69 29 63 0 0 0 0 0 0 
0 0 0 0 0 0 0 19 0 0 0 0 0 0 0 0 
0 0 0 0 0 0 70 85 0 0 0 0 0 0 0 0 
0 0 0 0 0 0 0 0 0 0 0 0 0 0 0 0 
0 0 0 0 17 56 0 0 0 0 0 0 0 0 0 0 
0 0 0 0 0 4 0 0 0 0 0 0 0 0 21 0 
